user_id,age,income_bracket,device_type,user_type,region,tech_savviness,filed_2023,time_to_complete_2023,sessions_2023,support_tickets_2023,early_login_2024,used_smart_assistant,filed_2024,time_to_complete_2024,sessions_2024,support_tickets_2024,satisfaction_2024,time_improvement,session_improvement
user_000000,41,50k-75k,tablet,returning,Midwest,41,True,51,1,0,False,False,True,35,4,0,8.132241441573104,16,-3
user_000001,37,<30k,desktop,returning,Midwest,43,False,0,0,0,False,False,False,0,0,0,,0,0
user_000002,19,30k-50k,mobile,new,East,61,False,0,0,0,True,True,True,113,2,1,8.340395485960947,-113,-2
user_000003,66,75k-100k,mobile,new,East,31,False,0,0,0,True,False,True,90,1,0,9.369171008941954,-90,-1
user_000004,27,30k-50k,desktop,returning,West,85,True,78,1,0,True,True,False,0,0,0,,78,1
user_000005,35,<30k,desktop,returning,South,30,True,129,2,0,False,True,True,93,2,0,9.169773838289691,36,0
user_000006,57,75k-100k,mobile,new,East,16,True,120,6,0,False,False,True,146,9,0,7.050762505857081,-26,-3
user_000007,56,30k-50k,desktop,returning,West,47,True,87,2,0,True,False,True,122,5,0,6.083082695053862,-35,-3
user_000008,22,<30k,mobile,new,East,49,False,0,0,0,False,True,False,0,0,0,,0,0
user_000009,49,100k-150k,mobile,new,East,59,True,80,3,0,True,True,True,80,1,0,6.315980923079661,0,2
user_000010,60,<30k,tablet,returning,West,48,False,0,0,0,False,False,True,121,1,0,7.0134830141470434,-121,-1
user_000011,49,75k-100k,mobile,returning,West,74,True,30,4,0,True,True,True,20,4,0,6.706400733983163,10,0
user_000012,57,30k-50k,mobile,new,East,55,False,0,0,0,True,True,True,115,1,0,8.445262431122675,-115,-1
user_000013,50,100k-150k,desktop,new,Midwest,83,True,89,3,0,True,True,True,27,4,0,10.0,62,-1
user_000014,46,75k-100k,desktop,returning,East,45,True,49,4,0,False,False,True,57,3,0,4.610619971113351,-8,1
user_000015,67,30k-50k,desktop,returning,West,37,True,42,5,0,False,True,True,28,3,0,7.214788333429139,14,2
user_000016,58,30k-50k,mobile,new,West,49,True,78,4,1,False,True,True,51,6,0,8.282285359979797,27,-2
user_000017,34,100k-150k,mobile,returning,East,80,True,58,4,0,True,True,True,52,4,0,8.988482047572072,6,0
user_000018,45,30k-50k,mobile,returning,South,41,False,0,0,0,False,True,True,89,2,0,6.283505364157246,-89,-2
user_000019,42,50k-75k,mobile,new,East,56,True,112,3,0,True,False,True,95,1,0,6.52540373631953,17,2
user_000020,18,50k-75k,desktop,returning,South,64,True,65,3,0,False,True,True,50,3,0,7.228468158226963,15,0
user_000021,42,30k-50k,mobile,returning,East,54,False,0,0,0,False,False,True,124,1,0,8.049557306538638,-124,-1
user_000022,62,<30k,desktop,returning,West,46,True,92,6,0,False,False,True,115,3,0,6.922561058566221,-23,3
user_000023,53,30k-50k,desktop,returning,Midwest,77,False,0,0,0,False,False,True,135,1,0,8.788286581960241,-135,-1
user_000024,46,<30k,desktop,new,West,42,True,120,3,0,False,False,False,0,0,0,,120,3
user_000025,29,75k-100k,mobile,returning,West,87,True,87,4,0,True,True,True,67,3,0,7.160888762130389,20,1
user_000026,33,75k-100k,mobile,returning,West,75,True,30,3,0,True,True,True,20,3,0,8.102753357264508,10,0
user_000027,48,100k-150k,desktop,new,Midwest,79,True,158,5,1,False,True,True,127,3,0,7.993452049723941,31,2
user_000028,48,50k-75k,mobile,new,South,56,True,164,1,2,True,False,False,0,0,0,,164,1
user_000029,48,30k-50k,mobile,returning,South,50,True,76,2,0,True,True,True,61,1,1,6.67581577281237,15,1
user_000030,49,75k-100k,mobile,new,South,34,True,198,8,1,True,True,True,178,10,0,8.450843312523372,20,-2
user_000031,27,<30k,mobile,returning,Midwest,64,False,0,0,0,True,True,True,75,1,0,7.4194194231595265,-75,-1
user_000032,59,75k-100k,mobile,new,Midwest,36,True,136,2,0,False,False,True,128,2,0,7.610526145528994,8,0
user_000033,31,75k-100k,desktop,new,East,57,True,134,1,0,True,True,True,122,1,0,7.519748715691222,12,0
user_000034,45,>150k,mobile,returning,Midwest,81,True,41,3,0,True,True,True,40,2,0,5.996755303049261,1,1
user_000035,28,50k-75k,desktop,new,Midwest,72,True,161,1,0,True,True,True,162,1,0,6.956831276361756,-1,0
user_000036,52,100k-150k,tablet,returning,East,63,True,36,6,0,True,True,True,38,5,0,10.0,-2,1
user_000037,38,>150k,desktop,new,East,77,True,86,2,0,False,True,True,117,3,0,7.645052688431465,-31,-1
user_000038,31,30k-50k,desktop,returning,Midwest,67,True,56,5,1,True,True,True,44,4,0,8.456414984528093,12,1
user_000039,50,75k-100k,tablet,new,East,58,True,137,2,0,True,True,True,160,1,0,8.71602021923976,-23,1
user_000040,52,75k-100k,desktop,returning,East,57,True,106,3,0,True,False,True,117,1,0,7.428816794681637,-11,2
user_000041,53,100k-150k,desktop,returning,East,82,True,41,1,0,True,True,True,43,1,0,7.067289445559034,-2,0
user_000042,33,75k-100k,desktop,returning,East,66,True,103,3,0,True,True,True,67,1,0,8.281842395019055,36,2
user_000043,55,50k-75k,mobile,returning,East,25,True,146,5,0,True,True,True,138,3,0,9.535942155112771,8,2
user_000044,45,<30k,mobile,returning,East,23,True,132,3,0,False,False,True,135,2,0,8.279829135471424,-3,1
user_000045,45,75k-100k,mobile,returning,West,50,True,86,3,1,False,False,True,111,1,0,6.643478675338202,-25,2
user_000046,18,50k-75k,desktop,returning,South,67,True,92,1,0,True,True,True,88,1,0,7.618217276068834,4,0
user_000047,52,75k-100k,mobile,returning,West,72,True,121,3,0,False,False,True,123,1,0,8.53794456999205,-2,2
user_000048,71,50k-75k,mobile,new,East,41,True,154,2,0,False,True,True,102,3,0,9.492518783395566,52,-1
user_000049,76,75k-100k,mobile,returning,Midwest,45,True,88,3,0,True,False,False,0,0,0,,88,3
user_000050,51,50k-75k,mobile,returning,South,56,True,58,2,1,True,True,True,27,1,0,5.873704962969349,31,1
user_000051,41,50k-75k,mobile,returning,East,31,True,113,5,0,False,True,True,117,5,0,7.626342553451609,-4,0
user_000052,66,50k-75k,desktop,returning,West,23,False,0,0,0,True,False,True,117,1,0,7.132447846747648,-117,-1
user_000053,47,50k-75k,desktop,returning,West,50,True,42,1,0,True,False,True,69,1,1,7.360570495229145,-27,0
user_000054,68,<30k,desktop,returning,Midwest,1,True,91,6,0,True,False,True,77,9,0,6.424798412416787,14,-3
user_000055,49,50k-75k,desktop,returning,East,40,True,128,2,0,True,False,True,127,3,0,7.454984536928433,1,-1
user_000056,36,<30k,mobile,returning,West,62,False,0,0,0,False,False,True,141,1,1,10.0,-141,-1
user_000057,57,<30k,desktop,returning,South,29,True,157,5,0,True,False,False,0,0,0,,157,5
user_000058,44,30k-50k,mobile,returning,South,46,True,132,1,2,True,True,True,124,2,0,7.51711565912019,8,-1
user_000059,41,50k-75k,desktop,new,South,61,True,127,2,0,True,False,True,99,1,0,8.54672543796595,28,1
user_000060,64,75k-100k,desktop,new,South,30,True,133,2,0,False,True,True,99,4,0,8.511276833857087,34,-2
user_000061,49,30k-50k,desktop,returning,West,58,True,92,2,0,False,False,True,95,1,0,7.873470783779311,-3,1
user_000062,29,>150k,desktop,returning,East,66,True,87,2,0,False,True,True,35,1,0,6.2815919801881686,52,1
user_000063,44,75k-100k,desktop,returning,South,31,True,95,4,0,True,False,True,118,4,0,4.552761281747716,-23,0
user_000064,32,<30k,desktop,returning,South,50,False,0,0,0,False,True,True,97,1,0,7.724236852363421,-97,-1
user_000065,48,<30k,desktop,returning,West,42,True,120,2,0,False,False,True,115,1,0,8.1433066647693,5,1
user_000066,23,<30k,desktop,returning,West,48,False,0,0,0,False,False,True,138,1,0,5.450163287146698,-138,-1
user_000067,34,100k-150k,desktop,returning,South,76,True,86,1,1,True,True,True,69,1,0,6.183189813673997,17,0
user_000068,44,75k-100k,desktop,returning,South,29,True,116,4,0,False,False,True,106,4,0,5.832234000938134,10,0
user_000069,49,<30k,desktop,new,West,37,False,0,0,0,False,True,True,117,1,0,8.40715925561238,-117,-1
user_000070,55,75k-100k,desktop,returning,East,43,True,81,1,0,False,False,True,76,1,0,7.188254555354276,5,0
user_000071,48,30k-50k,tablet,new,South,45,True,76,1,0,False,True,True,20,1,0,7.157389876152881,56,0
user_000072,66,<30k,desktop,returning,East,39,True,163,4,0,True,False,False,0,0,0,,163,4
user_000073,77,50k-75k,desktop,returning,South,17,True,153,7,0,True,True,True,156,1,0,9.009789453937234,-3,6
user_000074,33,30k-50k,mobile,returning,East,72,True,123,1,0,False,True,True,112,2,0,8.2973171879939,11,-1
user_000075,59,>150k,tablet,returning,East,41,True,62,1,0,False,False,True,43,2,1,6.154247056048515,19,-1
user_000076,25,75k-100k,mobile,returning,South,92,True,62,1,0,False,True,True,63,1,0,9.791977991959016,-1,0
user_000077,62,100k-150k,desktop,new,West,52,True,64,1,0,False,True,True,67,2,0,8.141433225100085,-3,-1
user_000078,43,>150k,mobile,returning,East,83,True,92,4,0,False,True,True,36,3,0,7.5617174427191225,56,1
user_000079,45,50k-75k,mobile,new,South,45,True,129,3,0,False,False,True,176,1,0,8.17732709014666,-47,2
user_000080,28,75k-100k,desktop,returning,West,77,True,62,1,0,True,True,True,33,2,0,8.760525428730174,29,-1
user_000081,21,>150k,desktop,new,Midwest,99,True,86,2,1,True,True,True,50,2,0,7.525836848534316,36,0
user_000082,62,<30k,desktop,returning,South,21,True,129,8,0,True,False,True,145,9,0,7.1343352253679635,-16,-1
user_000083,54,50k-75k,desktop,returning,East,70,True,116,3,0,True,False,True,113,1,0,6.6021481128987825,3,2
user_000084,60,75k-100k,mobile,new,West,18,True,198,6,0,False,False,True,183,8,0,5.875419696315939,15,-2
user_000085,67,50k-75k,mobile,returning,East,36,True,80,3,0,True,True,True,61,4,0,7.4560083536550215,19,-1
user_000086,19,50k-75k,desktop,returning,South,64,True,106,5,0,False,False,True,96,6,0,5.404341974323308,10,-1
user_000087,25,50k-75k,tablet,returning,East,80,True,62,1,0,True,True,True,48,1,0,6.531507025253077,14,0
user_000088,50,<30k,mobile,new,West,35,False,0,0,0,True,True,True,131,1,0,10.0,-131,-1
user_000089,30,30k-50k,mobile,returning,East,77,True,54,1,1,True,True,True,42,1,0,7.985561239867031,12,0
user_000090,43,30k-50k,mobile,new,East,34,True,68,5,0,False,False,True,69,5,0,6.1769686985308345,-1,0
user_000091,34,30k-50k,mobile,returning,Midwest,68,True,120,5,0,True,True,True,129,3,0,6.63222191412112,-9,2
user_000092,54,100k-150k,desktop,new,East,76,True,92,2,0,False,True,True,77,3,0,7.7087754160076045,15,-1
user_000093,22,30k-50k,mobile,returning,East,90,True,70,3,0,False,True,True,78,2,0,8.488434071663033,-8,1
user_000094,53,50k-75k,desktop,new,East,54,True,92,1,1,True,True,True,73,1,0,7.583593739180214,19,0
user_000095,20,50k-75k,desktop,new,East,73,False,0,0,0,False,False,True,121,2,0,6.9540967416236015,-121,-2
user_000096,35,30k-50k,mobile,new,East,33,True,151,2,0,False,True,True,113,2,0,8.22965931402616,38,0
user_000097,44,<30k,desktop,returning,Midwest,57,False,0,0,0,False,True,False,0,0,0,,0,0
user_000098,29,<30k,desktop,returning,Midwest,52,True,87,1,1,True,True,True,66,1,0,7.4952682895557015,21,0
user_000099,24,30k-50k,mobile,returning,Midwest,73,True,84,1,0,True,True,True,50,2,0,9.760066499430554,34,-1
user_000100,36,<30k,mobile,new,West,37,True,96,3,0,False,False,True,83,6,0,5.857744683867727,13,-3
user_000101,49,30k-50k,desktop,new,East,49,True,138,2,0,True,True,False,0,0,0,,138,2
user_000102,36,<30k,mobile,returning,South,46,True,114,5,0,False,True,True,99,3,0,9.559485597812545,15,2
user_000103,19,30k-50k,desktop,returning,Midwest,73,False,0,0,0,True,True,False,0,0,0,,0,0
user_000104,20,75k-100k,mobile,new,East,70,True,151,1,0,True,True,True,144,1,0,8.118386965021186,7,0
user_000105,44,<30k,desktop,new,Midwest,16,False,0,0,0,True,True,True,101,1,0,8.060212660259234,-101,-1
user_000106,60,50k-75k,mobile,new,West,36,True,57,4,0,True,False,False,0,0,0,,57,4
user_000107,18,30k-50k,desktop,returning,Midwest,53,True,51,5,0,True,True,True,49,8,0,6.891913381039072,2,-3
user_000108,50,30k-50k,desktop,returning,South,35,True,121,2,0,False,True,False,0,0,0,,121,2
user_000109,62,100k-150k,mobile,new,Midwest,48,True,103,5,0,False,True,True,74,3,0,8.321411681766156,29,2
user_000110,50,<30k,desktop,new,West,43,True,157,1,0,True,True,True,170,1,0,8.802134195878189,-13,0
user_000111,63,75k-100k,desktop,returning,South,23,True,168,3,0,False,True,True,91,1,0,6.347396680238893,77,2
user_000112,45,50k-75k,mobile,returning,East,75,True,64,2,1,False,False,True,61,1,0,8.100420653987804,3,1
user_000113,48,30k-50k,desktop,returning,East,61,True,128,2,0,True,True,True,97,1,0,8.030885259149592,31,1
user_000114,50,<30k,desktop,returning,East,33,True,129,2,0,False,True,True,75,1,0,10.0,54,1
user_000115,38,75k-100k,desktop,returning,South,32,True,84,2,0,False,False,True,77,1,1,8.554139130655633,7,1
user_000116,52,30k-50k,desktop,new,Midwest,50,True,137,2,0,False,False,True,130,3,0,5.833575188294131,7,-1
user_000117,40,30k-50k,desktop,new,South,30,True,88,3,0,True,False,True,65,3,0,8.843487646422968,23,0
user_000118,58,75k-100k,mobile,new,Midwest,50,False,0,0,0,False,True,True,136,1,0,8.692736659178678,-136,-1
user_000119,18,75k-100k,desktop,new,East,92,True,73,3,0,False,True,True,49,3,0,7.618285230976094,24,0
user_000120,80,50k-75k,desktop,new,Midwest,31,True,182,6,1,False,False,True,212,4,0,6.490023991929501,-30,2
user_000121,52,<30k,desktop,returning,Midwest,38,True,124,3,1,False,True,True,109,3,0,7.698818088190447,15,0
user_000122,68,75k-100k,mobile,returning,Midwest,22,True,103,7,0,True,False,True,99,8,0,6.556250018246488,4,-1
user_000123,45,100k-150k,desktop,returning,West,91,True,32,1,0,False,True,True,25,2,0,7.17869428210498,7,-1
user_000124,29,50k-75k,mobile,new,East,45,False,0,0,0,False,False,False,0,0,0,,0,0
user_000125,39,50k-75k,desktop,new,East,75,True,107,4,0,False,False,True,112,4,0,6.572958023749842,-5,0
user_000126,18,30k-50k,desktop,new,West,79,True,59,2,0,True,True,True,49,1,0,7.554901382101579,10,1
user_000127,40,100k-150k,mobile,returning,Midwest,43,True,101,4,0,False,True,True,88,3,0,6.927843288868471,13,1
user_000128,45,<30k,tablet,returning,Midwest,34,True,51,1,0,True,True,True,53,1,0,8.968862123317457,-2,0
user_000129,44,30k-50k,desktop,new,West,51,False,0,0,0,False,False,True,79,1,0,5.359724095513039,-79,-1
user_000130,18,50k-75k,mobile,returning,East,86,False,0,0,0,False,True,True,102,1,0,8.80604388456332,-102,-1
user_000131,23,50k-75k,desktop,new,West,68,True,135,2,0,False,True,True,73,2,0,7.509671541532906,62,0
user_000132,59,75k-100k,mobile,new,West,64,True,149,2,1,False,False,True,164,1,2,5.606268444734892,-15,1
user_000133,37,<30k,mobile,new,Midwest,42,True,119,3,0,False,False,True,129,4,0,7.71803289000932,-10,-1
user_000134,55,75k-100k,mobile,new,West,66,True,121,1,0,False,False,True,101,1,0,6.339644564494586,20,0
user_000135,53,100k-150k,mobile,returning,West,70,True,64,2,0,True,True,True,52,2,0,7.876880574313461,12,0
user_000136,49,<30k,mobile,new,West,31,False,0,0,0,False,False,False,0,0,0,,0,0
user_000137,34,50k-75k,desktop,returning,East,48,True,111,2,0,True,False,True,112,1,0,7.7625898364210935,-1,1
user_000138,18,50k-75k,mobile,returning,East,95,True,90,3,0,False,False,False,0,0,0,,90,3
user_000139,44,30k-50k,desktop,returning,West,76,True,62,4,0,True,True,True,53,6,0,7.804289438415624,9,-2
user_000140,49,100k-150k,desktop,returning,West,49,True,72,4,0,False,False,True,90,4,0,7.2830723508358775,-18,0
user_000141,45,75k-100k,mobile,new,South,50,True,125,5,0,False,False,True,130,4,0,7.0066613273718525,-5,1
user_000142,47,30k-50k,mobile,new,South,30,False,0,0,0,False,False,False,0,0,0,,0,0
user_000143,48,30k-50k,desktop,returning,South,59,True,88,2,1,False,False,True,91,1,0,6.44881878768585,-3,1
user_000144,18,75k-100k,desktop,new,South,45,True,136,1,0,False,True,True,116,1,0,9.812072892847382,20,0
user_000145,47,50k-75k,mobile,new,Midwest,33,True,146,2,0,False,False,True,117,1,0,6.8452301372438304,29,1
user_000146,30,30k-50k,mobile,new,East,85,True,130,8,0,True,True,True,81,8,0,9.429181594661104,49,0
user_000147,32,50k-75k,desktop,returning,South,75,True,56,6,1,False,True,True,34,7,0,8.568293031985277,22,-1
user_000148,80,<30k,mobile,returning,West,33,False,0,0,0,True,False,True,113,2,0,6.905199131832013,-113,-2
user_000149,44,30k-50k,desktop,new,West,86,True,105,2,0,False,True,True,93,5,0,8.985570610851203,12,-3
user_000150,54,75k-100k,mobile,new,South,59,True,150,4,0,False,False,True,131,4,0,6.263577263056819,19,0
user_000151,43,30k-50k,desktop,returning,West,69,False,0,0,0,True,False,True,118,1,0,7.022253224789872,-118,-1
user_000152,53,30k-50k,desktop,returning,Midwest,61,True,94,5,0,True,True,True,59,3,0,9.546528672220386,35,2
user_000153,51,75k-100k,desktop,new,East,53,True,132,1,0,True,False,True,125,1,0,8.209300720452138,7,0
user_000154,28,30k-50k,desktop,returning,West,95,True,107,5,0,False,True,True,42,4,0,7.2254339346045064,65,1
user_000155,45,100k-150k,tablet,returning,East,65,True,80,3,0,True,True,True,66,2,0,9.29766882422242,14,1
user_000156,38,30k-50k,desktop,new,Midwest,40,False,0,0,0,True,False,True,133,1,0,7.656796108826595,-133,-1
user_000157,42,<30k,desktop,new,Midwest,28,False,0,0,0,True,False,True,137,1,2,6.052982556586834,-137,-1
user_000158,49,50k-75k,desktop,new,Midwest,58,True,162,3,0,False,False,True,141,1,0,6.25212626514634,21,2
user_000159,46,30k-50k,mobile,returning,West,75,True,30,3,0,True,True,False,0,0,0,,30,3
user_000160,37,100k-150k,desktop,returning,East,86,True,70,1,1,False,True,True,56,1,1,7.981359111751664,14,0
user_000161,38,50k-75k,desktop,returning,South,66,True,128,2,0,True,False,True,109,4,0,8.754148678107303,19,-2
user_000162,24,50k-75k,desktop,new,West,66,True,150,7,0,False,True,True,93,4,0,7.157989097871379,57,3
user_000163,44,30k-50k,mobile,new,West,63,True,53,3,0,False,True,True,83,4,0,8.411196216460773,-30,-1
user_000164,59,50k-75k,desktop,new,South,26,True,174,4,0,True,False,True,211,6,0,7.1408792683857385,-37,-2
user_000165,47,100k-150k,desktop,returning,West,82,True,98,6,1,False,True,True,88,5,0,7.467214598644157,10,1
user_000166,35,75k-100k,desktop,new,West,51,True,89,2,0,True,True,True,70,4,0,9.865034530656766,19,-2
user_000167,66,75k-100k,mobile,new,South,21,True,131,4,1,True,False,True,112,5,0,3.741502089755872,19,-1
user_000168,48,75k-100k,mobile,returning,West,37,True,67,5,0,False,False,True,70,4,0,7.628799632132997,-3,1
user_000169,35,50k-75k,desktop,new,South,39,True,137,3,1,False,False,False,0,0,0,,137,3
user_000170,54,100k-150k,tablet,returning,South,90,True,30,3,0,False,False,True,88,4,0,10.0,-58,-1
user_000171,44,<30k,mobile,returning,East,66,False,0,0,0,True,False,True,142,1,0,7.415129787953813,-142,-1
user_000172,44,<30k,mobile,returning,West,67,True,121,5,0,False,False,False,0,0,0,,121,5
user_000173,55,50k-75k,desktop,returning,East,77,True,62,2,0,False,False,True,50,1,0,7.010641723711697,12,1
user_000174,57,30k-50k,desktop,returning,Midwest,37,True,92,1,0,True,True,True,69,1,0,7.522569205481977,23,0
user_000175,42,75k-100k,desktop,returning,South,47,True,110,3,0,True,True,True,125,3,0,6.32951975014571,-15,0
user_000176,45,30k-50k,desktop,new,South,64,True,160,2,0,False,True,True,112,2,0,10.0,48,0
user_000177,24,<30k,mobile,returning,South,66,True,119,4,0,False,False,True,118,5,0,6.780539433769935,1,-1
user_000178,48,75k-100k,desktop,returning,West,83,True,144,5,0,True,True,True,137,3,0,6.340440208955517,7,2
user_000179,38,>150k,mobile,returning,South,62,True,99,3,0,True,True,True,70,4,0,9.445317172906421,29,-1
user_000180,62,30k-50k,desktop,new,Midwest,7,True,190,2,1,False,False,True,204,4,0,5.965776803606206,-14,-2
user_000181,36,<30k,desktop,returning,South,40,True,88,2,0,False,False,True,101,1,0,8.661711459158232,-13,1
user_000182,68,75k-100k,mobile,new,East,34,True,164,8,0,False,False,True,183,8,0,7.916363853186168,-19,0
user_000183,23,75k-100k,mobile,new,South,32,True,108,5,0,False,True,True,69,4,0,7.073048933930233,39,1
user_000184,48,30k-50k,desktop,returning,West,51,True,92,1,0,False,True,True,78,1,0,6.620006437285788,14,0
user_000185,54,75k-100k,mobile,returning,West,58,True,37,8,0,True,True,True,41,7,0,10.0,-4,1
user_000186,44,50k-75k,desktop,returning,East,53,True,59,2,2,False,False,True,61,6,0,5.658907696487227,-2,-4
user_000187,26,100k-150k,mobile,new,West,100,True,54,1,0,True,True,True,63,1,0,8.122590440935147,-9,0
user_000188,50,100k-150k,desktop,returning,West,81,True,64,2,0,False,True,True,47,1,0,8.139613455526085,17,1
user_000189,47,75k-100k,desktop,returning,Midwest,55,True,67,3,1,True,True,True,74,1,0,9.299330274574276,-7,2
user_000190,34,75k-100k,desktop,new,West,100,True,135,1,1,True,True,True,113,1,0,8.124664595502727,22,0
user_000191,57,30k-50k,desktop,new,Midwest,20,False,0,0,0,False,False,False,0,0,0,,0,0
user_000192,38,30k-50k,desktop,new,West,23,True,174,1,0,True,False,False,0,0,0,,174,1
user_000193,30,75k-100k,mobile,returning,South,64,True,80,5,0,True,True,True,64,5,0,8.717873957315932,16,0
user_000194,67,30k-50k,tablet,new,East,48,True,176,1,1,False,True,True,201,3,0,7.893717099356588,-25,-2
user_000195,41,50k-75k,mobile,new,East,39,True,127,3,0,False,False,True,119,3,0,8.555006354292429,8,0
user_000196,71,<30k,mobile,returning,West,44,True,66,1,0,False,False,True,109,1,0,5.734585574687993,-43,0
user_000197,65,100k-150k,mobile,new,West,73,True,59,5,0,True,True,True,37,9,0,9.233492979709018,22,-4
user_000198,55,<30k,desktop,new,East,45,False,0,0,0,True,True,False,0,0,0,,0,0
user_000199,64,75k-100k,desktop,new,South,32,False,0,0,0,True,True,True,103,1,0,9.728884421246882,-103,-1
user_000200,35,50k-75k,desktop,returning,Midwest,37,True,30,4,0,True,True,True,25,2,0,9.00969132786197,5,2
user_000201,52,100k-150k,mobile,returning,East,56,True,77,3,0,False,False,True,113,2,0,4.883259734164942,-36,1
user_000202,45,75k-100k,desktop,returning,Midwest,46,True,115,2,0,True,True,True,83,1,0,5.948985353555839,32,1
user_000203,41,30k-50k,desktop,new,West,34,True,82,3,0,False,False,True,42,3,0,6.81283203213258,40,0
user_000204,26,100k-150k,desktop,returning,East,63,True,95,1,0,True,True,True,85,1,0,7.838151955501699,10,0
user_000205,70,>150k,mobile,returning,Midwest,38,True,60,2,0,True,False,True,63,3,0,9.049881874061496,-3,-1
user_000206,54,50k-75k,desktop,returning,East,26,True,76,4,1,False,False,True,80,7,1,5.4855374900788645,-4,-3
user_000207,35,100k-150k,mobile,returning,Midwest,65,True,116,4,0,False,True,True,98,5,1,8.189328149808508,18,-1
user_000208,44,75k-100k,desktop,new,West,77,True,151,1,0,False,True,True,96,1,0,8.937297360968936,55,0
user_000209,62,30k-50k,desktop,returning,East,8,False,0,0,0,False,False,True,98,1,0,6.383893627298299,-98,-1
user_000210,25,30k-50k,mobile,returning,East,87,True,30,3,0,False,True,True,20,2,0,7.23520228192471,10,1
user_000211,46,75k-100k,mobile,returning,East,30,False,0,0,0,False,True,True,113,1,1,9.121731291046057,-113,-1
user_000212,67,30k-50k,desktop,returning,West,57,False,0,0,0,True,True,True,81,1,0,8.389839811918343,-81,-1
user_000213,40,30k-50k,mobile,new,Midwest,76,True,127,6,1,False,True,True,87,4,0,6.492639201462326,40,2
user_000214,41,100k-150k,desktop,returning,South,57,True,30,2,0,False,True,True,61,1,0,8.831296323628248,-31,1
user_000215,55,30k-50k,mobile,returning,South,43,True,105,2,0,True,True,True,58,1,0,7.732382765395157,47,1
user_000216,58,30k-50k,desktop,new,West,50,True,61,1,0,False,False,True,41,1,0,7.995785534313381,20,0
user_000217,61,50k-75k,desktop,returning,Midwest,14,True,96,3,1,True,True,True,68,1,0,7.130474747510948,28,2
user_000218,35,30k-50k,desktop,returning,West,88,True,32,1,0,True,True,True,43,1,0,8.377492256431204,-11,0
user_000219,47,100k-150k,mobile,returning,South,65,True,115,2,0,False,True,True,61,1,0,8.551924080677036,54,1
user_000220,61,50k-75k,desktop,returning,Midwest,47,True,146,1,2,True,True,True,122,1,1,6.960823584326633,24,0
user_000221,49,30k-50k,desktop,returning,Midwest,33,True,135,7,0,True,True,True,97,3,0,8.57301107161444,38,4
user_000222,49,>150k,mobile,returning,East,71,True,85,3,0,True,True,True,48,4,1,6.8297792088213685,37,-1
user_000223,62,50k-75k,desktop,returning,East,16,False,0,0,0,False,True,True,77,1,0,8.515733546989866,-77,-1
user_000224,42,100k-150k,desktop,returning,East,66,True,103,1,0,True,True,True,85,2,0,8.956990088826984,18,-1
user_000225,68,50k-75k,mobile,new,East,22,False,0,0,0,False,False,True,105,1,0,6.947301478730057,-105,-1
user_000226,69,50k-75k,mobile,new,East,50,True,137,1,0,False,False,True,119,2,0,7.275981356837629,18,-1
user_000227,18,75k-100k,desktop,returning,South,99,True,52,1,1,True,True,True,40,1,0,6.2326824779134755,12,0
user_000228,60,<30k,mobile,returning,East,61,True,90,2,0,True,True,True,54,4,0,8.771406910734093,36,-2
user_000229,56,75k-100k,desktop,returning,Midwest,34,True,78,1,0,False,False,True,83,3,0,5.537509609086983,-5,-2
user_000230,33,30k-50k,desktop,new,South,60,True,74,1,0,True,True,True,26,1,0,5.892497899906834,48,0
user_000231,47,50k-75k,mobile,new,East,70,True,127,5,0,False,False,True,122,3,0,7.057013918490398,5,2
user_000232,30,30k-50k,desktop,returning,East,66,True,104,7,0,False,False,True,81,8,0,5.0693831424064655,23,-1
user_000233,35,30k-50k,desktop,new,East,54,False,0,0,0,False,True,False,0,0,0,,0,0
user_000234,48,50k-75k,mobile,returning,East,70,True,62,2,0,True,True,True,60,2,0,9.761554435549378,2,0
user_000235,45,<30k,desktop,returning,Midwest,35,True,31,5,0,False,False,True,62,6,0,6.803372651194893,-31,-1
user_000236,26,30k-50k,mobile,returning,East,59,True,52,3,0,True,True,True,20,1,0,9.85521230384905,32,2
user_000237,34,75k-100k,mobile,returning,East,74,True,90,2,0,False,True,True,94,1,0,10.0,-4,1
user_000238,54,75k-100k,desktop,returning,West,66,True,71,3,0,True,True,True,38,1,0,7.995394956510475,33,2
user_000239,59,30k-50k,mobile,new,Midwest,63,True,97,5,0,True,True,True,89,4,1,9.260609973810316,8,1
user_000240,32,30k-50k,mobile,returning,East,94,True,30,3,0,True,True,True,20,2,1,7.686682982265986,10,1
user_000241,53,50k-75k,desktop,returning,South,69,True,30,4,1,True,False,True,34,4,0,7.686239223008946,-4,0
user_000242,36,30k-50k,mobile,new,South,29,True,155,5,0,True,False,True,95,1,0,5.781484012919883,60,4
user_000243,48,30k-50k,mobile,new,East,26,True,138,5,1,False,False,True,126,10,0,8.295774085028556,12,-5
user_000244,63,100k-150k,desktop,returning,East,31,True,65,2,0,False,True,False,0,0,0,,65,2
user_000245,34,>150k,desktop,returning,Midwest,79,True,95,1,0,False,True,True,62,1,0,10.0,33,0
user_000246,47,50k-75k,tablet,new,Midwest,23,True,86,4,0,True,False,True,77,2,0,6.242263974688436,9,2
user_000247,61,<30k,desktop,returning,East,34,True,66,7,0,False,False,True,65,8,0,9.209132937000414,1,-1
user_000248,63,100k-150k,mobile,returning,West,62,True,82,4,0,True,False,True,86,8,0,7.744209173578395,-4,-4
user_000249,47,50k-75k,desktop,new,South,42,True,161,3,1,True,True,True,115,3,0,9.395334835874218,46,0
user_000250,33,75k-100k,desktop,new,East,50,True,143,1,0,False,True,True,120,1,0,7.188286714535406,23,0
user_000251,28,<30k,desktop,returning,East,27,False,0,0,0,False,False,True,139,1,0,7.373678683488488,-139,-1
user_000252,46,75k-100k,desktop,returning,East,48,True,96,5,0,False,False,True,119,7,0,5.888288170890744,-23,-2
user_000253,34,50k-75k,desktop,returning,South,79,True,56,2,0,True,True,False,0,0,0,,56,2
user_000254,45,<30k,mobile,new,Midwest,34,False,0,0,0,False,False,True,179,1,0,7.19501692204311,-179,-1
user_000255,44,75k-100k,desktop,new,South,57,True,129,3,0,False,True,True,122,2,0,7.441322740546563,7,1
user_000256,29,75k-100k,desktop,new,East,65,True,100,2,0,True,True,True,85,2,0,9.582106108487382,15,0
user_000257,45,50k-75k,mobile,new,West,67,True,92,3,0,False,False,True,102,3,0,6.736249076124698,-10,0
user_000258,30,>150k,mobile,new,East,82,True,81,2,0,False,False,True,68,1,0,8.122038576295381,13,1
user_000259,41,75k-100k,mobile,returning,Midwest,67,True,131,4,0,False,True,True,95,4,0,10.0,36,0
user_000260,35,<30k,tablet,new,Midwest,30,True,68,5,0,True,False,True,80,6,1,7.557336197967115,-12,-1
user_000261,51,75k-100k,mobile,returning,South,62,True,106,5,0,True,True,True,91,5,0,8.693010914560281,15,0
user_000262,24,30k-50k,desktop,returning,East,66,True,79,2,0,True,True,True,79,2,0,9.726697354216487,0,0
user_000263,36,50k-75k,mobile,returning,Midwest,6,True,86,1,0,True,True,True,47,2,0,8.240715543591557,39,-1
user_000264,22,<30k,mobile,returning,West,72,False,0,0,0,True,True,True,96,1,0,7.9658600328840565,-96,-1
user_000265,44,<30k,mobile,returning,South,43,False,0,0,0,False,True,True,79,1,0,8.426448840482085,-79,-1
user_000266,44,<30k,desktop,returning,South,21,True,115,2,0,False,False,False,0,0,0,,115,2
user_000267,24,30k-50k,mobile,returning,East,45,True,71,6,0,True,True,False,0,0,0,,71,6
user_000268,34,50k-75k,desktop,returning,South,80,True,91,2,0,True,True,True,58,1,0,8.333925619279011,33,1
user_000269,77,75k-100k,mobile,new,South,20,False,0,0,0,False,False,False,0,0,0,,0,0
user_000270,45,75k-100k,desktop,returning,Midwest,33,True,65,1,0,False,False,True,78,1,1,6.07653983517831,-13,0
user_000271,39,30k-50k,desktop,returning,Midwest,47,True,104,4,0,True,True,True,104,1,0,5.692238881513334,0,3
user_000272,24,<30k,mobile,returning,Midwest,40,True,61,1,0,True,False,True,36,1,0,8.912510185503358,25,0
user_000273,62,30k-50k,desktop,returning,West,55,True,117,2,0,False,True,True,109,2,0,7.114948562448332,8,0
user_000274,59,30k-50k,mobile,new,South,18,True,163,5,1,False,False,True,133,4,0,7.531594058513622,30,1
user_000275,64,75k-100k,mobile,new,West,53,True,147,4,0,True,True,True,154,1,0,8.284248369526816,-7,3
user_000276,35,75k-100k,desktop,new,South,58,True,169,3,0,False,False,True,162,2,0,7.254573197676765,7,1
user_000277,53,>150k,desktop,returning,Midwest,76,True,54,4,0,True,True,True,39,5,0,6.800759043092142,15,-1
user_000278,29,<30k,mobile,returning,West,40,False,0,0,0,True,True,True,114,1,0,7.93697880847694,-114,-1
user_000279,41,50k-75k,desktop,returning,West,55,True,101,1,0,False,False,True,105,1,1,7.400564389454158,-4,0
user_000280,42,100k-150k,desktop,new,South,64,True,89,4,0,False,True,True,53,5,0,9.034622483186574,36,-1
user_000281,54,75k-100k,desktop,returning,Midwest,62,True,130,3,0,False,True,True,118,2,0,8.312664300470452,12,1
user_000282,50,30k-50k,desktop,returning,South,35,True,37,4,1,False,False,True,39,8,0,8.204881377999438,-2,-4
user_000283,49,100k-150k,mobile,returning,South,85,True,79,1,0,True,True,True,53,1,0,8.824581583925456,26,0
user_000284,56,50k-75k,desktop,new,Midwest,35,True,90,2,0,False,False,False,0,0,0,,90,2
user_000285,41,75k-100k,desktop,new,East,37,True,105,3,0,False,True,True,67,3,1,6.228694937674394,38,0
user_000286,27,100k-150k,mobile,returning,Midwest,86,True,62,4,0,True,True,True,31,2,0,8.257890912338013,31,2
user_000287,33,50k-75k,desktop,returning,West,89,True,44,2,0,True,True,False,0,0,0,,44,2
user_000288,55,>150k,mobile,new,West,69,True,135,1,0,True,False,True,141,2,0,7.476922710098033,-6,-1
user_000289,48,>150k,mobile,returning,Midwest,73,True,85,3,0,False,True,True,98,1,0,7.271618801828747,-13,2
user_000290,22,50k-75k,mobile,returning,West,98,True,44,7,1,False,True,True,33,6,0,7.835201077767191,11,1
user_000291,36,75k-100k,mobile,returning,East,52,True,111,1,0,True,True,True,78,1,0,8.691362117925728,33,0
user_000292,60,50k-75k,desktop,returning,Midwest,38,True,113,4,0,True,False,True,114,6,0,7.071723582921725,-1,-2
user_000293,42,30k-50k,desktop,returning,West,53,True,49,7,0,False,False,True,99,5,0,8.769012002082471,-50,2
user_000294,27,75k-100k,desktop,returning,East,67,True,142,5,0,False,False,True,125,5,0,7.108606874762298,17,0
user_000295,67,30k-50k,mobile,new,West,54,True,30,7,1,True,False,True,40,8,0,7.459465261381504,-10,-1
user_000296,63,>150k,desktop,returning,East,58,True,102,1,0,True,True,True,99,1,0,5.751668121187759,3,0
user_000297,73,<30k,mobile,returning,East,48,True,90,2,1,True,False,True,128,1,0,5.715995107037254,-38,1
user_000298,47,30k-50k,mobile,new,West,33,True,151,4,0,False,False,True,152,7,0,7.494256272219578,-1,-3
user_000299,52,30k-50k,desktop,new,East,42,True,132,3,0,True,True,True,90,3,0,10.0,42,0
user_000300,44,50k-75k,desktop,new,West,86,False,0,0,0,False,True,True,104,1,0,7.856353704824488,-104,-1
user_000301,30,50k-75k,desktop,returning,West,84,True,111,3,0,True,False,True,108,5,0,6.629320261233579,3,-2
user_000302,43,75k-100k,desktop,returning,West,56,True,55,3,0,True,True,True,23,3,0,7.498215063754725,32,0
user_000303,58,30k-50k,mobile,returning,West,32,True,87,6,1,False,False,True,122,10,1,7.768418545240882,-35,-4
user_000304,18,50k-75k,desktop,new,East,83,True,102,2,0,True,True,True,70,3,0,10.0,32,-1
user_000305,46,30k-50k,desktop,new,Midwest,52,True,107,3,0,False,False,True,90,2,0,6.20877042596348,17,1
user_000306,56,100k-150k,mobile,returning,East,31,True,90,3,0,False,False,True,119,5,0,7.497554006722202,-29,-2
user_000307,20,30k-50k,desktop,returning,South,82,True,83,3,0,False,True,True,37,1,0,8.2389029475844,46,2
user_000308,48,<30k,mobile,new,East,57,True,156,3,0,True,True,True,104,1,0,8.34352461626874,52,2
user_000309,47,50k-75k,mobile,returning,Midwest,39,True,112,6,0,True,True,True,95,1,0,9.583808060856217,17,5
user_000310,51,50k-75k,mobile,returning,East,63,True,34,1,0,False,False,True,20,3,0,8.174545014431263,14,-2
user_000311,45,50k-75k,mobile,returning,East,39,True,110,1,0,False,False,True,106,1,0,5.013906010844108,4,0
user_000312,35,100k-150k,desktop,new,South,48,True,93,6,0,False,True,True,43,6,0,8.143960290342713,50,0
user_000313,49,30k-50k,mobile,returning,East,46,True,133,3,0,False,False,True,125,5,0,7.620649989627412,8,-2
user_000314,58,100k-150k,desktop,new,East,48,True,154,3,0,True,False,True,149,3,0,7.374484114011581,5,0
user_000315,38,50k-75k,desktop,new,Midwest,62,True,130,2,0,False,True,True,104,1,0,9.7197593155225,26,1
user_000316,58,75k-100k,tablet,new,East,24,True,117,4,0,False,False,True,121,6,0,7.6077939595455435,-4,-2
user_000317,46,50k-75k,desktop,returning,East,62,True,111,3,0,True,True,True,101,1,0,7.9968133802048404,10,2
user_000318,39,30k-50k,desktop,returning,East,43,True,172,1,0,True,True,True,152,1,0,7.3081474509537125,20,0
user_000319,75,30k-50k,desktop,returning,West,28,True,150,2,0,False,False,True,148,1,0,6.1311710292827275,2,1
user_000320,43,<30k,desktop,returning,East,46,True,92,7,0,False,False,True,95,7,0,8.301672011956766,-3,0
user_000321,42,>150k,desktop,returning,West,89,True,122,3,0,True,True,True,106,1,0,8.612132466573273,16,2
user_000322,53,30k-50k,mobile,returning,East,54,True,109,5,0,False,True,True,103,2,0,7.028979569818921,6,3
user_000323,47,<30k,desktop,new,South,54,True,75,1,0,True,False,True,63,2,0,7.901480813819277,12,-1
user_000324,18,75k-100k,mobile,returning,South,55,True,134,3,1,True,True,True,125,2,0,8.881751896705882,9,1
user_000325,57,50k-75k,desktop,new,West,53,True,111,1,0,False,True,True,120,2,0,8.573913590379188,-9,-1
user_000326,69,<30k,mobile,new,East,20,False,0,0,0,False,False,True,123,1,0,8.103264750610041,-123,-1
user_000327,51,75k-100k,desktop,returning,South,44,True,112,4,0,False,False,True,123,5,0,7.9957749504890785,-11,-1
user_000328,38,75k-100k,mobile,returning,East,53,True,59,3,0,True,True,True,63,2,0,10.0,-4,1
user_000329,58,30k-50k,desktop,new,South,9,True,151,5,0,False,False,True,158,6,1,8.082170352236757,-7,-1
user_000330,52,75k-100k,desktop,new,West,62,True,103,1,0,False,False,True,79,1,0,8.097846826495884,24,0
user_000331,51,100k-150k,desktop,returning,Midwest,56,True,56,3,1,True,True,True,20,2,0,5.181127648511005,36,1
user_000332,61,75k-100k,desktop,new,East,33,True,96,5,0,True,True,True,106,3,0,7.382069417063923,-10,2
user_000333,36,50k-75k,mobile,returning,West,58,True,91,3,0,False,False,True,91,2,0,6.703376715533334,0,1
user_000334,52,75k-100k,desktop,new,South,41,True,85,2,0,False,False,True,117,3,0,6.242625785050201,-32,-1
user_000335,30,75k-100k,desktop,new,South,81,True,114,2,0,True,True,True,83,1,0,7.040466999635634,31,1
user_000336,50,100k-150k,mobile,returning,West,100,False,0,0,0,True,True,True,67,1,0,10.0,-67,-1
user_000337,56,<30k,mobile,new,East,0,True,185,7,0,True,False,False,0,0,0,,185,7
user_000338,59,30k-50k,mobile,returning,West,70,True,89,1,0,True,False,True,66,1,0,9.130088096123913,23,0
user_000339,46,100k-150k,mobile,new,West,92,True,110,2,0,True,True,True,68,1,1,10.0,42,1
user_000340,59,<30k,desktop,returning,West,42,True,80,3,0,False,False,True,89,3,0,7.849362162856944,-9,0
user_000341,35,100k-150k,desktop,returning,East,37,True,97,1,0,False,True,True,110,1,0,8.337066622867567,-13,0
user_000342,69,75k-100k,desktop,returning,East,54,True,117,2,0,True,False,True,114,1,0,6.948891192844476,3,1
user_000343,41,50k-75k,desktop,new,East,37,True,137,3,0,False,False,False,0,0,0,,137,3
user_000344,45,50k-75k,desktop,returning,Midwest,70,False,0,0,0,False,True,True,124,1,0,9.11836896266582,-124,-1
user_000345,35,75k-100k,mobile,new,East,49,True,67,8,1,False,True,False,0,0,0,,67,8
user_000346,23,<30k,mobile,returning,East,58,True,81,1,0,True,True,True,62,1,0,5.992356683390903,19,0
user_000347,40,75k-100k,mobile,new,East,38,True,132,5,0,True,True,True,85,2,0,7.354433332063952,47,3
user_000348,42,100k-150k,desktop,returning,East,75,True,57,2,0,False,True,True,23,1,0,6.354332780549867,34,1
user_000349,61,<30k,desktop,new,East,25,True,135,2,0,False,False,False,0,0,0,,135,2
user_000350,34,50k-75k,desktop,returning,West,57,True,90,2,1,True,True,True,71,1,1,5.051967823948093,19,1
user_000351,21,50k-75k,mobile,returning,Midwest,78,True,87,2,0,False,True,True,103,3,0,8.058141275334465,-16,-1
user_000352,37,100k-150k,tablet,returning,West,77,True,122,2,0,False,True,True,84,3,0,8.503934006884377,38,-1
user_000353,40,30k-50k,mobile,returning,Midwest,31,False,0,0,0,True,True,True,98,1,0,8.391264625384858,-98,-1
user_000354,43,50k-75k,mobile,new,East,51,True,121,5,0,True,True,True,29,2,0,8.940499866237076,92,3
user_000355,28,<30k,mobile,returning,Midwest,76,False,0,0,0,True,True,False,0,0,0,,0,0
user_000356,59,50k-75k,mobile,returning,South,34,False,0,0,0,True,False,True,108,1,0,5.940103696500376,-108,-1
user_000357,27,75k-100k,mobile,returning,West,81,True,30,4,0,False,True,True,54,1,0,7.423351987018697,-24,3
user_000358,36,<30k,mobile,new,East,41,False,0,0,0,True,True,False,0,0,0,,0,0
user_000359,59,<30k,desktop,new,Midwest,26,True,203,1,0,False,False,False,0,0,0,,203,1
user_000360,60,75k-100k,mobile,returning,East,24,True,114,1,0,True,False,True,117,2,0,7.490536227641842,-3,-1
user_000361,42,50k-75k,desktop,returning,South,57,True,123,1,0,False,True,True,81,1,0,9.422426668727347,42,0
user_000362,60,30k-50k,desktop,returning,Midwest,46,True,109,4,1,False,True,True,99,4,0,6.237577698505405,10,0
user_000363,40,50k-75k,mobile,returning,West,71,True,67,1,0,True,True,True,53,1,0,7.8750038075521145,14,0
user_000364,36,30k-50k,mobile,returning,Midwest,41,False,0,0,0,False,False,True,161,1,0,7.301289032891983,-161,-1
user_000365,26,50k-75k,mobile,returning,Midwest,56,True,141,2,0,False,True,True,106,1,0,7.709545689857675,35,1
user_000366,37,>150k,desktop,returning,West,74,True,84,3,0,True,True,True,68,1,0,8.872935958301579,16,2
user_000367,43,50k-75k,tablet,returning,West,54,True,120,1,0,True,True,True,45,1,0,8.708938055336247,75,0
user_000368,53,30k-50k,mobile,returning,East,45,True,49,3,0,False,False,True,30,3,0,6.80464387262969,19,0
user_000369,62,<30k,tablet,new,South,25,False,0,0,0,False,False,True,144,2,0,6.466542649396487,-144,-2
user_000370,21,>150k,mobile,returning,East,68,True,109,2,0,False,True,True,65,2,0,7.317393581479619,44,0
user_000371,54,50k-75k,mobile,returning,East,57,True,96,1,0,False,False,True,93,2,0,6.685916628226026,3,-1
user_000372,42,50k-75k,mobile,new,West,52,True,126,4,0,True,False,True,98,2,0,6.7250094585729965,28,2
user_000373,28,30k-50k,tablet,returning,East,73,True,120,1,0,False,False,True,153,2,0,6.273368556666518,-33,-1
user_000374,61,50k-75k,desktop,returning,East,64,True,59,3,0,True,True,True,40,4,0,10.0,19,-1
user_000375,80,75k-100k,mobile,returning,West,22,True,131,3,0,False,False,True,151,2,0,5.884020535404087,-20,1
user_000376,61,30k-50k,tablet,returning,Midwest,31,True,33,1,0,True,True,True,65,1,0,5.443189709808128,-32,0
user_000377,54,<30k,desktop,new,South,29,True,140,4,1,False,False,False,0,0,0,,140,4
user_000378,61,100k-150k,mobile,returning,South,44,False,0,0,0,True,True,True,113,1,0,8.766525752924922,-113,-1
user_000379,36,50k-75k,mobile,new,West,80,True,30,1,0,False,True,False,0,0,0,,30,1
user_000380,44,50k-75k,desktop,returning,South,49,True,143,3,0,True,True,True,121,2,0,6.6939728267935665,22,1
user_000381,42,100k-150k,desktop,returning,South,57,True,87,1,0,False,False,True,111,1,0,6.188894292251971,-24,0
user_000382,53,100k-150k,mobile,returning,South,15,True,108,5,1,False,True,True,91,4,0,7.7382475011127765,17,1
user_000383,61,75k-100k,desktop,new,East,49,True,165,7,0,False,True,True,142,8,0,8.715961342559005,23,-1
user_000384,35,75k-100k,mobile,new,East,62,True,71,2,0,False,True,True,77,3,0,7.253147963867068,-6,-1
user_000385,59,30k-50k,tablet,new,South,37,True,52,2,0,False,False,True,60,1,1,7.30580429345997,-8,1
user_000386,35,30k-50k,mobile,returning,South,51,True,61,3,0,False,False,True,57,4,0,6.305181899490566,4,-1
user_000387,50,75k-100k,desktop,returning,South,61,True,94,5,0,True,False,True,125,8,0,7.602287594712836,-31,-3
user_000388,34,<30k,desktop,new,East,57,True,155,1,1,True,True,False,0,0,0,,155,1
user_000389,18,30k-50k,mobile,returning,South,68,True,58,6,0,True,True,True,42,8,0,9.15057176545068,16,-2
user_000390,20,<30k,desktop,returning,Midwest,43,True,30,4,0,True,False,True,36,4,0,8.562509711152517,-6,0
user_000391,57,30k-50k,mobile,returning,South,27,True,132,5,0,True,False,True,135,2,0,7.75095443764712,-3,3
user_000392,45,30k-50k,desktop,new,Midwest,49,True,137,5,0,False,False,True,105,3,0,9.047911029729848,32,2
user_000393,18,50k-75k,desktop,new,South,67,True,94,1,0,False,False,False,0,0,0,,94,1
user_000394,57,50k-75k,desktop,new,Midwest,15,True,134,4,1,False,True,True,82,5,0,3.719271946322809,52,-1
user_000395,50,100k-150k,desktop,returning,East,57,True,123,4,0,False,False,True,178,3,0,6.347373610217099,-55,1
user_000396,37,30k-50k,desktop,new,West,62,True,94,5,0,True,True,True,69,7,0,7.890050389051668,25,-2
user_000397,40,75k-100k,mobile,new,East,52,True,116,2,0,False,True,True,87,1,0,8.695314871334704,29,1
user_000398,35,100k-150k,mobile,new,Midwest,55,True,133,1,0,False,False,True,148,1,0,6.254842348274116,-15,0
user_000399,48,50k-75k,mobile,returning,East,52,True,51,3,0,False,False,True,64,4,0,6.6031874610330465,-13,-1
user_000400,48,50k-75k,desktop,returning,South,36,True,71,4,0,False,False,True,26,3,0,6.393182036819508,45,1
user_000401,59,50k-75k,mobile,returning,Midwest,48,True,113,2,0,False,False,True,153,1,1,8.084115540738281,-40,1
user_000402,35,>150k,desktop,returning,Midwest,55,True,46,3,0,True,True,False,0,0,0,,46,3
user_000403,45,75k-100k,desktop,new,East,59,True,49,2,0,False,False,True,47,3,1,7.193557545661891,2,-1
user_000404,37,50k-75k,desktop,new,East,47,False,0,0,0,False,False,False,0,0,0,,0,0
user_000405,54,75k-100k,mobile,returning,South,27,True,97,1,0,False,False,True,91,1,1,8.077479102621906,6,0
user_000406,21,50k-75k,desktop,new,Midwest,77,True,113,4,1,False,True,True,82,3,0,9.52183187439027,31,1
user_000407,27,<30k,desktop,returning,East,84,True,61,3,1,False,False,False,0,0,0,,61,3
user_000408,36,75k-100k,mobile,returning,East,47,True,51,3,1,False,False,True,36,3,0,5.229597028627549,15,0
user_000409,41,<30k,desktop,new,South,20,False,0,0,0,False,False,False,0,0,0,,0,0
user_000410,44,50k-75k,mobile,returning,Midwest,41,True,54,1,0,False,True,True,52,1,0,6.996691217150608,2,0
user_000411,55,>150k,desktop,returning,East,75,True,100,2,0,False,True,False,0,0,0,,100,2
user_000412,55,50k-75k,tablet,new,West,68,True,128,4,0,False,True,True,113,7,0,8.824824140681914,15,-3
user_000413,46,<30k,mobile,new,East,63,False,0,0,0,False,True,True,81,1,0,8.2397743347025,-81,-1
user_000414,47,30k-50k,mobile,new,East,50,False,0,0,0,True,False,True,137,1,0,6.9370798210273374,-137,-1
user_000415,41,100k-150k,mobile,returning,South,82,True,79,1,0,True,True,True,61,1,0,8.471334091041081,18,0
user_000416,43,50k-75k,mobile,new,West,35,True,127,4,0,False,True,True,93,4,0,7.180756694264341,34,0
user_000417,45,75k-100k,desktop,new,South,48,True,101,1,0,False,True,True,89,2,0,7.450107103954444,12,-1
user_000418,39,>150k,mobile,returning,West,70,False,0,0,0,False,True,True,75,4,0,7.833850840950955,-75,-4
user_000419,52,75k-100k,desktop,returning,West,77,True,64,5,0,True,True,True,41,3,0,8.35630346521124,23,2
user_000420,41,50k-75k,desktop,new,East,56,True,139,4,0,False,True,True,75,5,0,8.481426190947603,64,-1
user_000421,32,50k-75k,desktop,returning,West,100,True,82,2,1,True,False,True,119,4,0,6.20846641543366,-37,-2
user_000422,75,<30k,tablet,returning,West,35,False,0,0,0,False,False,True,116,1,0,8.701963177864808,-116,-1
user_000423,18,<30k,mobile,returning,East,83,True,64,3,0,False,True,True,27,5,0,8.090238840749091,37,-2
user_000424,38,<30k,mobile,returning,West,58,True,94,3,0,False,False,True,120,4,0,8.248438065212587,-26,-1
user_000425,21,>150k,mobile,returning,South,86,False,0,0,0,True,True,True,64,1,0,9.054682286812248,-64,-1
user_000426,51,50k-75k,desktop,new,Midwest,45,True,142,2,0,False,False,False,0,0,0,,142,2
user_000427,55,75k-100k,mobile,returning,Midwest,25,True,137,5,0,True,False,True,133,8,0,5.984539287267959,4,-3
user_000428,40,75k-100k,mobile,returning,South,44,True,127,2,0,True,True,True,122,2,0,7.654794627539656,5,0
user_000429,26,<30k,mobile,returning,West,79,False,0,0,0,True,True,False,0,0,0,,0,0
user_000430,38,30k-50k,desktop,returning,West,59,True,157,3,0,True,True,True,141,1,0,7.12629344473587,16,2
user_000431,56,50k-75k,desktop,new,East,32,False,0,0,0,True,False,True,109,1,1,7.775711865505128,-109,-1
user_000432,66,>150k,mobile,returning,East,40,True,75,1,0,True,False,False,0,0,0,,75,1
user_000433,34,100k-150k,tablet,returning,East,96,True,30,1,0,True,True,True,24,2,0,8.392797720322339,6,-1
user_000434,45,50k-75k,mobile,returning,West,45,True,128,2,1,False,False,True,135,2,2,8.050085301258061,-7,0
user_000435,38,30k-50k,mobile,new,West,70,True,144,3,1,True,True,True,104,1,0,8.593723232399263,40,2
user_000436,69,>150k,desktop,returning,Midwest,46,True,30,6,0,False,True,True,38,5,0,7.304702640982109,-8,1
user_000437,42,30k-50k,mobile,returning,South,58,False,0,0,0,False,False,False,0,0,0,,0,0
user_000438,26,75k-100k,desktop,returning,West,85,True,40,5,0,False,True,True,73,4,0,8.681843094857836,-33,1
user_000439,18,30k-50k,desktop,new,West,82,True,87,3,0,False,True,True,74,5,0,7.957139899996215,13,-2
user_000440,55,100k-150k,desktop,new,Midwest,77,True,143,3,0,False,False,True,124,5,0,6.941482198286939,19,-2
user_000441,37,30k-50k,desktop,returning,East,48,True,69,1,0,False,True,True,89,2,0,9.562446938246815,-20,-1
user_000442,34,<30k,desktop,new,East,60,True,163,1,0,False,False,True,144,1,0,6.320253352405578,19,0
user_000443,55,>150k,mobile,new,East,47,True,88,2,0,True,True,True,61,1,0,6.767886358379481,27,1
user_000444,62,75k-100k,desktop,returning,East,20,True,112,6,0,False,False,False,0,0,0,,112,6
user_000445,36,100k-150k,mobile,returning,South,81,True,41,5,1,True,True,True,31,1,0,5.998534151761756,10,4
user_000446,32,50k-75k,desktop,new,East,77,True,123,2,0,False,True,True,117,1,0,9.367612867676842,6,1
user_000447,54,75k-100k,desktop,returning,West,37,True,95,4,0,False,True,True,38,2,0,6.36642369126173,57,2
user_000448,74,30k-50k,desktop,returning,West,91,True,70,5,0,True,False,True,47,5,0,7.259144521505006,23,0
user_000449,40,50k-75k,desktop,returning,Midwest,71,True,35,4,0,False,True,False,0,0,0,,35,4
user_000450,57,100k-150k,desktop,returning,South,35,True,71,4,0,False,False,True,21,5,0,8.509884407521762,50,-1
user_000451,51,30k-50k,mobile,new,South,56,True,112,3,0,True,False,True,105,3,0,5.965737202247054,7,0
user_000452,28,75k-100k,desktop,returning,East,64,True,81,2,0,False,True,True,20,3,0,8.084062250008236,61,-1
user_000453,22,75k-100k,desktop,returning,West,74,True,100,1,0,True,True,True,78,1,0,7.932989735862445,22,0
user_000454,45,75k-100k,desktop,returning,South,35,True,88,3,0,False,False,True,91,2,0,8.121319445347824,-3,1
user_000455,18,75k-100k,desktop,new,South,81,True,87,2,0,False,True,True,117,3,0,6.219615482900538,-30,-1
user_000456,55,<30k,desktop,new,East,34,False,0,0,0,False,False,False,0,0,0,,0,0
user_000457,63,75k-100k,desktop,new,Midwest,33,True,65,6,0,False,False,True,48,5,0,5.543886489731306,17,1
user_000458,18,100k-150k,mobile,returning,West,100,True,30,1,0,True,True,True,20,1,0,8.870218279109068,10,0
user_000459,35,30k-50k,mobile,returning,East,73,True,109,3,0,False,True,True,96,6,0,8.460837551112533,13,-3
user_000460,28,<30k,desktop,new,East,78,False,0,0,0,False,True,True,84,1,0,8.76234339456235,-84,-1
user_000461,61,<30k,mobile,returning,Midwest,41,True,80,2,0,False,True,True,70,1,0,7.912282049993152,10,1
user_000462,30,30k-50k,mobile,returning,West,65,True,135,1,0,False,True,True,121,2,1,10.0,14,-1
user_000463,41,50k-75k,tablet,new,East,36,True,100,6,0,False,True,True,74,4,0,7.660553741655891,26,2
user_000464,22,75k-100k,desktop,returning,East,60,True,92,2,0,False,True,True,88,1,0,7.870868508111982,4,1
user_000465,48,30k-50k,desktop,new,East,51,True,166,3,1,False,True,True,114,2,0,6.98794007743849,52,1
user_000466,36,75k-100k,mobile,new,South,40,False,0,0,0,False,False,True,108,1,0,6.958878181174783,-108,-1
user_000467,57,50k-75k,desktop,returning,East,17,True,133,2,0,False,False,True,118,1,0,6.942276023722348,15,1
user_000468,60,75k-100k,desktop,new,East,39,True,137,5,0,False,False,True,97,10,0,7.552909785328297,40,-5
user_000469,53,100k-150k,mobile,new,South,65,True,187,3,0,True,True,True,128,1,0,6.953178129482772,59,2
user_000470,41,30k-50k,desktop,returning,Midwest,44,True,74,6,0,False,False,True,76,8,0,7.139646327859815,-2,-2
user_000471,61,50k-75k,mobile,returning,South,24,True,171,3,1,True,True,True,145,2,0,8.399276458810876,26,1
user_000472,44,30k-50k,desktop,returning,West,57,True,110,1,0,True,False,True,107,1,0,5.441170703764722,3,0
user_000473,38,<30k,desktop,returning,East,15,True,53,2,1,False,True,True,73,1,0,6.251006712579391,-20,1
user_000474,25,75k-100k,mobile,returning,Midwest,75,True,34,1,1,False,True,True,49,1,0,8.493627846868373,-15,0
user_000475,33,75k-100k,mobile,new,South,54,True,114,3,0,False,True,True,116,1,0,8.103316948956998,-2,2
user_000476,55,30k-50k,mobile,new,East,72,False,0,0,0,False,True,True,76,1,1,8.674593527949558,-76,-1
user_000477,52,75k-100k,mobile,returning,South,52,True,64,1,0,False,False,True,72,1,0,8.255796561340377,-8,0
user_000478,58,100k-150k,desktop,new,Midwest,58,True,136,1,1,False,False,True,98,3,0,4.849967193609559,38,-2
user_000479,61,50k-75k,mobile,returning,South,65,True,74,6,0,True,True,True,20,2,0,7.476640199919352,54,4
user_000480,41,30k-50k,mobile,returning,Midwest,66,True,67,6,0,True,True,True,78,5,0,8.619223056660667,-11,1
user_000481,74,75k-100k,mobile,returning,East,23,True,95,2,0,True,True,True,91,2,0,6.7639179867586785,4,0
user_000482,39,100k-150k,mobile,returning,East,64,True,111,1,0,False,True,False,0,0,0,,111,1
user_000483,37,30k-50k,desktop,new,East,71,True,180,3,0,False,True,True,138,1,0,8.272931820721443,42,2
user_000484,56,75k-100k,mobile,new,West,50,True,110,4,0,True,False,True,87,2,0,6.1094479547848275,23,2
user_000485,28,100k-150k,desktop,new,East,72,False,0,0,0,True,True,True,78,1,0,6.957742594932105,-78,-1
user_000486,52,50k-75k,desktop,returning,East,58,True,77,1,1,False,True,False,0,0,0,,77,1
user_000487,46,30k-50k,desktop,returning,East,16,True,150,3,2,False,False,True,134,5,0,7.664842470154624,16,-2
user_000488,47,100k-150k,desktop,new,East,100,True,78,4,0,True,True,True,76,3,0,8.586274677126562,2,1
user_000489,51,30k-50k,desktop,returning,South,54,True,104,3,0,False,False,True,105,2,0,6.3855838784399825,-1,1
user_000490,53,50k-75k,desktop,new,Midwest,31,True,154,7,0,True,False,True,175,8,0,8.1750800642494,-21,-1
user_000491,59,30k-50k,mobile,new,West,58,True,158,6,0,False,True,True,139,8,0,7.91488409820135,19,-2
user_000492,34,50k-75k,mobile,new,West,61,True,138,3,0,False,True,True,148,6,0,7.595980245510497,-10,-3
user_000493,24,<30k,mobile,returning,Midwest,46,False,0,0,0,True,True,True,83,1,0,7.2124563959766155,-83,-1
user_000494,21,30k-50k,tablet,returning,Midwest,36,True,61,1,0,True,False,True,86,1,0,8.220329650885292,-25,0
user_000495,18,50k-75k,desktop,returning,West,80,False,0,0,0,False,True,True,129,3,0,7.3795357389179905,-129,-3
user_000496,31,100k-150k,desktop,returning,West,98,False,0,0,0,False,True,True,103,1,0,8.034489308562755,-103,-1
user_000497,57,30k-50k,mobile,returning,West,41,True,120,2,0,True,True,False,0,0,0,,120,2
user_000498,80,30k-50k,desktop,returning,West,28,True,130,1,1,True,False,True,153,2,0,7.46385398244023,-23,-1
user_000499,49,75k-100k,desktop,new,West,86,True,109,2,0,True,True,True,55,1,0,9.036221139471841,54,1
user_000500,61,100k-150k,desktop,returning,East,40,True,66,1,1,False,False,True,55,2,0,8.17247925182518,11,-1
user_000501,32,50k-75k,mobile,returning,South,64,True,118,2,0,True,True,True,45,2,0,6.4936364957136545,73,0
user_000502,57,50k-75k,desktop,returning,West,11,True,89,3,0,False,False,True,65,1,0,9.568298138315768,24,2
user_000503,63,>150k,mobile,returning,West,52,True,41,1,0,False,False,True,23,2,0,8.225231415280572,18,-1
user_000504,35,50k-75k,tablet,returning,East,32,True,66,4,0,False,False,True,81,1,0,8.200148102850063,-15,3
user_000505,58,50k-75k,mobile,returning,East,54,True,106,5,0,False,True,True,88,6,0,6.3703496323767554,18,-1
user_000506,41,75k-100k,mobile,new,Midwest,44,True,124,3,0,False,False,True,103,1,0,5.435653544305849,21,2
user_000507,51,100k-150k,desktop,returning,West,96,True,98,1,0,True,True,True,49,1,0,6.975683733426562,49,0
user_000508,51,75k-100k,desktop,returning,East,37,True,132,4,0,False,False,True,104,2,0,5.862978898844444,28,2
user_000509,49,75k-100k,desktop,new,West,66,True,160,3,0,False,False,True,152,2,1,7.420026713633097,8,1
user_000510,47,100k-150k,desktop,returning,Midwest,74,True,30,3,0,False,True,True,24,2,0,6.43005490890928,6,1
user_000511,32,75k-100k,mobile,returning,Midwest,55,True,84,5,1,True,True,True,43,3,0,7.219324234448867,41,2
user_000512,45,30k-50k,mobile,new,East,63,False,0,0,0,False,True,False,0,0,0,,0,0
user_000513,52,30k-50k,mobile,returning,East,65,True,87,3,0,True,True,True,20,5,0,6.646858017950164,67,-2
user_000514,47,75k-100k,mobile,returning,East,58,True,135,4,1,False,True,True,115,2,0,8.109054320592488,20,2
user_000515,51,30k-50k,mobile,new,Midwest,24,False,0,0,0,False,True,True,126,1,0,10.0,-126,-1
user_000516,34,30k-50k,desktop,returning,South,73,True,65,2,0,False,False,True,69,1,0,6.8597269724781045,-4,1
user_000517,50,<30k,desktop,returning,East,16,False,0,0,0,True,False,True,123,1,0,7.578850249687732,-123,-1
user_000518,40,<30k,desktop,new,South,45,True,145,3,0,True,True,True,128,3,0,7.903310403648002,17,0
user_000519,52,100k-150k,tablet,returning,South,36,True,103,2,0,True,True,True,111,4,0,8.18718490181318,-8,-2
user_000520,56,<30k,mobile,returning,East,34,True,76,2,0,True,False,True,76,2,0,6.691645343792596,0,0
user_000521,29,100k-150k,tablet,new,West,91,True,83,4,0,False,True,True,70,4,0,10.0,13,0
user_000522,61,<30k,mobile,returning,Midwest,0,True,145,6,0,False,True,True,102,1,0,5.92932551471569,43,5
user_000523,50,30k-50k,mobile,returning,Midwest,61,True,97,1,0,True,True,True,70,1,0,10.0,27,0
user_000524,47,50k-75k,desktop,returning,Midwest,45,True,84,2,0,True,False,True,73,2,0,7.339605900590628,11,0
user_000525,52,75k-100k,mobile,returning,East,29,True,102,2,0,False,False,True,115,4,0,6.161272147423123,-13,-2
user_000526,54,100k-150k,desktop,new,East,78,True,60,5,0,True,True,True,40,7,0,9.937850720845175,20,-2
user_000527,29,50k-75k,mobile,returning,Midwest,87,True,88,1,0,True,True,True,67,1,0,8.809005765878974,21,0
user_000528,60,100k-150k,mobile,returning,Midwest,65,False,0,0,0,False,True,True,112,1,0,8.721076023398426,-112,-1
user_000529,53,30k-50k,mobile,returning,Midwest,31,True,93,1,1,False,False,True,84,1,1,7.29148276822768,9,0
user_000530,68,50k-75k,desktop,returning,West,57,True,42,2,1,False,True,True,36,2,0,6.5853910555628925,6,0
user_000531,18,100k-150k,desktop,returning,East,80,True,119,4,0,True,True,True,116,6,0,8.569380600933673,3,-2
user_000532,71,30k-50k,desktop,new,South,53,False,0,0,0,False,False,True,84,3,1,6.521495542317131,-84,-3
user_000533,47,50k-75k,mobile,new,East,38,True,105,2,0,False,False,True,101,2,0,5.831707215920537,4,0
user_000534,54,100k-150k,desktop,returning,West,62,True,90,2,0,True,True,True,40,1,0,9.440149049283615,50,1
user_000535,48,30k-50k,desktop,returning,West,72,False,0,0,0,False,True,True,72,1,0,9.273476614169576,-72,-1
user_000536,37,>150k,desktop,returning,West,72,True,80,4,0,True,True,True,110,1,0,7.39121951665949,-30,3
user_000537,41,>150k,desktop,returning,South,48,True,72,2,0,False,False,True,70,1,0,6.920018486007228,2,1
user_000538,37,<30k,mobile,new,East,35,True,173,2,0,False,False,True,180,3,0,7.14915423183488,-7,-1
user_000539,44,30k-50k,mobile,returning,South,52,True,97,4,0,True,True,True,115,2,0,10.0,-18,2
user_000540,37,30k-50k,desktop,new,East,44,True,73,5,0,True,True,True,52,4,0,8.777152802915069,21,1
user_000541,53,30k-50k,mobile,returning,West,51,True,108,4,0,False,True,True,99,1,0,8.490158454346254,9,3
user_000542,44,<30k,mobile,returning,West,37,True,93,6,0,False,True,True,108,4,1,7.418485455326898,-15,2
user_000543,47,30k-50k,desktop,returning,West,100,False,0,0,0,True,False,True,138,1,1,10.0,-138,-1
user_000544,43,<30k,desktop,new,East,27,True,190,2,0,True,True,True,132,1,0,7.654190333538574,58,1
user_000545,71,30k-50k,desktop,new,East,30,True,97,5,0,False,False,True,100,5,1,7.404212885630152,-3,0
user_000546,50,50k-75k,desktop,returning,South,16,True,146,4,0,False,True,True,102,6,0,6.246749143002666,44,-2
user_000547,44,100k-150k,tablet,returning,East,43,True,76,2,0,True,True,True,99,2,0,8.580022605371417,-23,0
user_000548,59,75k-100k,desktop,returning,South,24,True,132,4,0,False,True,True,103,5,0,7.277171016479376,29,-1
user_000549,41,50k-75k,mobile,returning,South,40,True,108,5,0,False,True,True,90,5,0,10.0,18,0
user_000550,78,>150k,mobile,returning,Midwest,42,True,113,4,1,False,False,True,113,1,0,4.137759338997079,0,3
user_000551,48,30k-50k,desktop,returning,Midwest,28,True,147,5,1,False,True,True,81,3,2,7.8384279048058385,66,2
user_000552,36,30k-50k,mobile,new,West,72,True,114,4,0,True,True,True,97,1,0,8.309900094153813,17,3
user_000553,63,100k-150k,tablet,returning,West,52,True,67,2,0,True,True,True,47,1,1,4.196056369513479,20,1
user_000554,37,50k-75k,mobile,returning,South,52,True,141,4,1,False,False,True,96,3,1,7.234798190383417,45,1
user_000555,32,75k-100k,mobile,new,South,51,False,0,0,0,False,False,True,112,1,0,8.005411722003242,-112,-1
user_000556,35,<30k,desktop,returning,Midwest,41,True,65,5,0,True,True,True,28,4,0,6.789529637065104,37,1
user_000557,30,50k-75k,mobile,new,East,59,True,140,5,0,False,True,False,0,0,0,,140,5
user_000558,35,30k-50k,desktop,returning,East,56,True,105,1,1,False,True,False,0,0,0,,105,1
user_000559,37,50k-75k,mobile,returning,South,65,False,0,0,0,False,True,True,78,1,0,10.0,-78,-1
user_000560,47,100k-150k,mobile,new,West,43,True,139,4,0,False,True,True,130,4,0,7.8579588513991006,9,0
user_000561,18,75k-100k,desktop,returning,East,95,True,95,2,0,False,True,True,79,1,0,8.087242907097568,16,1
user_000562,36,100k-150k,mobile,new,East,69,True,148,2,0,False,True,True,96,1,1,8.348318700471625,52,1
user_000563,38,75k-100k,mobile,new,East,68,True,150,4,0,False,False,True,127,3,1,5.74171364217455,23,1
user_000564,55,75k-100k,mobile,returning,West,87,True,36,2,0,True,False,True,51,1,0,5.976177416386116,-15,1
user_000565,46,100k-150k,mobile,new,West,94,True,129,1,0,True,True,True,119,1,0,6.961935640920631,10,0
user_000566,46,75k-100k,mobile,new,West,63,True,100,2,0,True,False,True,90,1,0,5.791368969860103,10,1
user_000567,58,100k-150k,mobile,returning,Midwest,38,True,71,3,0,True,True,True,32,4,0,6.911207468616364,39,-1
user_000568,58,100k-150k,desktop,returning,East,72,True,75,4,0,True,True,True,53,1,0,8.47745351176298,22,3
user_000569,20,>150k,mobile,new,West,89,False,0,0,0,False,True,True,93,1,0,9.078351453553442,-93,-1
user_000570,54,30k-50k,desktop,returning,West,57,True,42,6,0,True,False,True,50,6,0,7.298412487074599,-8,0
user_000571,46,<30k,mobile,new,Midwest,0,False,0,0,0,False,False,True,148,1,1,6.517637326535145,-148,-1
user_000572,52,30k-50k,desktop,returning,South,67,True,80,4,0,False,True,True,101,1,0,7.523818499729447,-21,3
user_000573,30,100k-150k,desktop,returning,West,100,True,77,6,0,False,True,True,63,7,0,7.157500466142907,14,-1
user_000574,62,50k-75k,desktop,returning,South,13,False,0,0,0,True,True,True,92,1,0,6.6081239653070964,-92,-1
user_000575,63,30k-50k,mobile,new,East,31,False,0,0,0,False,False,True,114,2,2,7.5694732037941295,-114,-2
user_000576,18,<30k,desktop,returning,East,58,True,101,4,0,True,True,True,87,2,0,10.0,14,2
user_000577,58,50k-75k,mobile,new,West,46,True,103,2,0,False,False,False,0,0,0,,103,2
user_000578,48,30k-50k,desktop,returning,South,64,True,72,2,0,False,False,True,83,3,0,7.293588659723391,-11,-1
user_000579,43,75k-100k,desktop,returning,East,51,True,107,3,0,False,False,True,76,4,0,7.9574636599543895,31,-1
user_000580,67,50k-75k,desktop,new,South,39,True,148,8,1,True,True,True,134,4,0,4.881686082648253,14,4
user_000581,48,<30k,desktop,returning,West,31,True,98,3,0,False,False,True,80,2,0,7.8263721177050725,18,1
user_000582,18,30k-50k,desktop,returning,South,52,True,133,3,0,False,True,True,94,3,0,8.026348757237638,39,0
user_000583,53,<30k,mobile,returning,East,19,False,0,0,0,False,False,False,0,0,0,,0,0
user_000584,43,30k-50k,desktop,returning,South,64,True,101,3,0,False,True,True,87,4,0,5.977272248565908,14,-1
user_000585,22,50k-75k,mobile,returning,East,27,True,121,7,0,False,True,True,84,12,0,7.407883130677104,37,-5
user_000586,38,100k-150k,mobile,returning,South,77,True,43,4,0,False,False,True,54,5,1,6.4823445765163985,-11,-1
user_000587,47,50k-75k,mobile,returning,West,66,True,83,3,0,True,False,True,63,4,0,7.86763306838927,20,-1
user_000588,51,50k-75k,mobile,returning,East,35,True,37,2,0,False,False,True,20,6,0,6.675144015034168,17,-4
user_000589,30,>150k,desktop,returning,West,91,True,38,2,1,True,True,True,35,1,0,6.808318281489364,3,1
user_000590,55,75k-100k,desktop,returning,West,29,True,119,7,0,True,False,True,117,8,0,7.591740096540133,2,-1
user_000591,24,50k-75k,desktop,returning,Midwest,54,True,113,1,0,True,True,True,87,1,0,7.7371662857506,26,0
user_000592,36,<30k,mobile,returning,Midwest,38,False,0,0,0,False,False,True,105,1,0,6.803946675278824,-105,-1
user_000593,43,50k-75k,mobile,new,South,37,True,100,1,0,False,False,True,105,1,0,6.87395397285693,-5,0
user_000594,71,30k-50k,desktop,returning,West,45,True,105,4,0,False,False,True,103,4,0,6.367194669991846,2,0
user_000595,48,>150k,mobile,returning,South,70,True,128,6,0,False,False,True,98,3,0,5.675454891020025,30,3
user_000596,34,75k-100k,mobile,returning,East,97,True,78,5,0,True,True,False,0,0,0,,78,5
user_000597,63,75k-100k,desktop,new,South,32,False,0,0,0,False,False,True,132,2,0,6.277885364764501,-132,-2
user_000598,44,50k-75k,mobile,returning,East,68,True,111,3,0,True,False,True,117,2,0,6.285576198144324,-6,1
user_000599,43,50k-75k,mobile,returning,East,56,True,140,2,0,False,True,True,158,2,0,7.739917908507643,-18,0
user_000600,43,75k-100k,mobile,returning,South,53,True,68,4,0,False,True,True,65,2,0,8.24170209714899,3,2
user_000601,69,75k-100k,mobile,returning,West,61,True,85,2,0,False,False,True,94,5,0,7.989543195258735,-9,-3
user_000602,25,75k-100k,mobile,returning,West,88,True,108,7,1,False,True,True,64,5,0,7.451381522668772,44,2
user_000603,40,30k-50k,desktop,returning,West,41,True,90,2,0,False,True,True,92,1,0,8.750899186602242,-2,1
user_000604,60,75k-100k,desktop,new,East,59,True,132,2,0,True,False,True,122,1,1,6.554497915824164,10,1
user_000605,52,30k-50k,mobile,new,South,39,True,128,2,1,True,True,True,91,1,0,7.431204240339501,37,1
user_000606,18,100k-150k,mobile,new,West,100,True,113,5,1,False,True,True,72,8,0,6.488687758174017,41,-3
user_000607,43,<30k,desktop,new,South,34,True,137,3,1,False,False,True,104,1,0,6.7307141033930895,33,2
user_000608,59,50k-75k,mobile,returning,East,19,True,115,9,0,False,False,False,0,0,0,,115,9
user_000609,43,30k-50k,desktop,returning,East,40,True,103,2,0,True,True,True,77,2,0,7.93073813171218,26,0
user_000610,43,100k-150k,desktop,new,West,61,True,131,1,0,True,True,True,96,2,0,10.0,35,-1
user_000611,18,30k-50k,desktop,new,West,74,True,41,1,0,False,True,True,35,1,0,8.86297243349752,6,0
user_000612,64,30k-50k,mobile,returning,West,49,True,117,3,1,False,True,True,63,2,0,6.047081622809616,54,1
user_000613,27,75k-100k,mobile,new,East,43,True,159,4,0,False,False,True,133,1,0,6.600553034811043,26,3
user_000614,30,75k-100k,mobile,new,East,79,True,180,4,1,False,False,True,166,1,1,5.26006094767367,14,3
user_000615,29,75k-100k,mobile,returning,South,53,True,63,4,0,False,True,True,60,2,0,8.476726255906087,3,2
user_000616,59,50k-75k,mobile,returning,South,37,True,70,4,0,False,False,True,63,6,0,7.684383318015908,7,-2
user_000617,27,50k-75k,mobile,returning,East,83,True,33,1,0,False,True,True,62,1,0,7.702862448931406,-29,0
user_000618,58,<30k,tablet,new,South,47,False,0,0,0,True,False,False,0,0,0,,0,0
user_000619,21,100k-150k,mobile,returning,Midwest,51,True,60,4,0,False,True,False,0,0,0,,60,4
user_000620,47,30k-50k,desktop,returning,West,66,True,30,2,1,True,False,True,41,1,1,8.357325528312098,-11,1
user_000621,30,100k-150k,desktop,returning,West,84,True,58,1,0,True,True,True,27,1,0,8.613395204791551,31,0
user_000622,58,75k-100k,mobile,returning,West,51,True,53,2,0,True,True,False,0,0,0,,53,2
user_000623,56,30k-50k,desktop,returning,Midwest,56,True,95,3,0,False,True,True,80,1,0,7.3173239365031355,15,2
user_000624,29,50k-75k,mobile,returning,West,91,True,66,5,0,True,True,True,56,4,0,8.774319123680275,10,1
user_000625,49,75k-100k,desktop,new,West,45,True,132,1,0,False,False,True,155,2,0,6.100082937526828,-23,-1
user_000626,56,100k-150k,mobile,returning,East,49,True,86,2,0,False,True,True,74,1,0,7.077768199763174,12,1
user_000627,28,30k-50k,desktop,new,West,100,False,0,0,0,False,True,True,47,1,0,5.72735848364877,-47,-1
user_000628,47,50k-75k,mobile,new,Midwest,59,True,115,1,1,False,False,True,109,1,0,5.976868500036118,6,0
user_000629,19,50k-75k,desktop,new,West,95,True,85,1,0,True,False,True,93,2,0,6.129782290335909,-8,-1
user_000630,48,100k-150k,mobile,new,Midwest,32,True,167,3,2,True,True,True,133,3,0,7.736844523681372,34,0
user_000631,50,75k-100k,desktop,returning,Midwest,47,True,74,1,0,False,True,True,40,1,0,8.151516804711523,34,0
user_000632,62,30k-50k,mobile,new,West,66,False,0,0,0,False,False,True,96,1,0,6.532251499836279,-96,-1
user_000633,54,50k-75k,mobile,returning,East,79,True,90,2,0,False,True,True,85,2,0,8.763489011504678,5,0
user_000634,48,30k-50k,mobile,new,South,54,True,165,4,0,True,True,True,97,5,0,10.0,68,-1
user_000635,31,<30k,mobile,returning,South,75,True,68,2,0,False,True,False,0,0,0,,68,2
user_000636,46,30k-50k,mobile,returning,South,53,True,73,3,1,True,True,True,24,2,0,5.411516435338488,49,1
user_000637,21,50k-75k,mobile,returning,East,92,True,82,1,0,True,False,True,112,5,0,9.692808675824095,-30,-4
user_000638,66,30k-50k,mobile,new,West,7,True,157,4,0,False,False,True,148,6,0,8.121715869953128,9,-2
user_000639,26,100k-150k,tablet,returning,South,63,True,55,4,0,False,True,True,68,2,0,9.165561660269923,-13,2
user_000640,50,50k-75k,desktop,returning,East,35,False,0,0,0,True,True,True,85,1,0,6.660739633581769,-85,-1
user_000641,52,<30k,desktop,returning,Midwest,40,False,0,0,0,False,True,False,0,0,0,,0,0
user_000642,76,50k-75k,desktop,returning,West,29,False,0,0,0,True,False,True,115,2,0,7.133621439151806,-115,-2
user_000643,44,100k-150k,mobile,new,South,45,True,181,3,0,False,True,True,132,3,0,7.213052771750636,49,0
user_000644,47,50k-75k,desktop,new,West,46,False,0,0,0,False,False,True,130,1,1,7.386538966461358,-130,-1
user_000645,44,50k-75k,mobile,returning,South,36,True,82,5,0,False,True,True,45,3,0,9.493826000083505,37,2
user_000646,68,75k-100k,mobile,new,Midwest,38,True,116,5,0,False,False,True,104,8,0,6.219578065491157,12,-3
user_000647,52,50k-75k,desktop,returning,West,86,True,30,3,0,True,True,True,20,3,0,10.0,10,0
user_000648,29,50k-75k,desktop,new,East,88,True,84,2,0,True,True,True,30,3,0,9.818011636763856,54,-1
user_000649,55,75k-100k,mobile,returning,East,47,True,75,1,0,True,True,True,43,1,0,6.919014493972273,32,0
user_000650,36,30k-50k,mobile,returning,South,42,True,138,2,0,True,False,True,110,4,0,8.103130384956792,28,-2
user_000651,27,30k-50k,desktop,new,Midwest,39,True,48,3,0,True,True,True,55,4,0,9.757645956494038,-7,-1
user_000652,34,<30k,desktop,returning,East,89,False,0,0,0,False,True,True,78,1,0,8.858472194764698,-78,-1
user_000653,51,75k-100k,mobile,returning,South,46,True,126,3,0,True,True,False,0,0,0,,126,3
user_000654,19,30k-50k,desktop,returning,Midwest,49,True,139,5,0,False,False,True,163,3,0,9.282327760869487,-24,2
user_000655,77,<30k,mobile,new,Midwest,37,True,112,1,2,True,True,False,0,0,0,,112,1
user_000656,32,100k-150k,desktop,new,South,81,True,85,5,0,True,True,True,70,3,0,7.754291315501991,15,2
user_000657,43,50k-75k,desktop,returning,East,48,True,111,1,0,False,True,True,64,1,0,7.996656817575359,47,0
user_000658,52,50k-75k,desktop,new,South,67,True,108,2,0,True,False,True,109,2,0,10.0,-1,0
user_000659,52,100k-150k,mobile,returning,Midwest,68,True,80,3,0,False,True,True,104,2,0,6.679526016501652,-24,1
user_000660,51,30k-50k,desktop,new,South,7,True,171,1,0,False,False,True,162,1,0,6.814131136857461,9,0
user_000661,34,50k-75k,desktop,returning,East,63,False,0,0,0,False,True,True,144,1,0,6.76800808613164,-144,-1
user_000662,57,50k-75k,desktop,returning,West,48,True,85,2,0,True,False,False,0,0,0,,85,2
user_000663,51,50k-75k,mobile,returning,West,66,True,103,2,0,False,False,True,91,2,0,8.507223002917023,12,0
user_000664,51,50k-75k,mobile,returning,Midwest,61,True,57,1,0,False,False,True,36,1,0,8.425706404765982,21,0
user_000665,79,75k-100k,desktop,returning,South,43,True,94,4,0,False,False,True,96,6,0,7.789751616181963,-2,-2
user_000666,47,30k-50k,desktop,returning,West,50,True,94,2,0,False,False,True,93,1,0,6.986884257966442,1,1
user_000667,43,75k-100k,desktop,new,Midwest,32,True,105,1,0,False,False,True,140,1,0,7.009961128202393,-35,0
user_000668,43,30k-50k,mobile,new,East,41,True,55,1,0,False,False,True,72,2,0,8.733484387753258,-17,-1
user_000669,45,50k-75k,desktop,returning,South,27,True,130,3,0,False,False,True,130,1,0,8.636805832873357,0,2
user_000670,47,<30k,mobile,returning,Midwest,50,True,82,2,0,True,True,True,101,1,0,8.086341462361677,-19,1
user_000671,47,>150k,mobile,new,West,54,True,59,1,0,True,True,True,76,1,0,9.015300312687957,-17,0
user_000672,38,75k-100k,mobile,returning,South,41,True,99,1,0,False,False,True,126,1,0,6.276619929580032,-27,0
user_000673,34,30k-50k,mobile,new,East,50,True,122,1,0,True,False,True,105,3,0,5.876063215141254,17,-2
user_000674,59,>150k,desktop,returning,West,28,True,162,1,0,True,True,True,140,1,0,8.482619509899253,22,0
user_000675,40,<30k,mobile,returning,Midwest,0,True,161,5,1,True,True,True,92,1,0,7.295447344912782,69,4
user_000676,67,50k-75k,mobile,new,West,54,True,107,3,0,False,True,True,92,1,1,8.024596189455222,15,2
user_000677,52,30k-50k,mobile,new,West,51,False,0,0,0,False,True,True,100,1,0,7.4833407026781416,-100,-1
user_000678,42,75k-100k,desktop,returning,South,39,True,134,2,0,True,True,True,101,1,0,6.493044202006175,33,1
user_000679,45,30k-50k,desktop,returning,West,60,True,94,4,1,True,True,True,81,4,0,7.979636764381612,13,0
user_000680,52,30k-50k,mobile,returning,South,36,True,128,2,0,False,True,True,115,1,0,9.516357595116816,13,1
user_000681,51,30k-50k,desktop,returning,Midwest,52,True,95,3,0,False,True,True,89,2,1,6.254689468310123,6,1
user_000682,64,100k-150k,mobile,returning,West,26,True,122,2,1,False,False,True,144,1,0,7.082635729871551,-22,1
user_000683,30,50k-75k,desktop,returning,West,100,True,126,2,0,True,True,True,108,4,0,8.54930537147986,18,-2
user_000684,36,<30k,mobile,returning,South,17,False,0,0,0,False,True,True,95,2,0,8.931752076780722,-95,-2
user_000685,67,75k-100k,desktop,returning,East,62,False,0,0,0,True,False,True,113,1,1,9.272478743864651,-113,-1
user_000686,55,30k-50k,desktop,returning,Midwest,32,True,59,5,0,True,False,True,57,6,0,6.710921374748262,2,-1
user_000687,58,<30k,mobile,returning,Midwest,3,True,117,4,0,False,False,True,132,8,0,7.759652138405938,-15,-4
user_000688,28,50k-75k,desktop,returning,Midwest,64,True,82,2,1,False,True,True,92,2,0,8.266303351913267,-10,0
user_000689,18,30k-50k,mobile,returning,East,69,True,120,5,0,False,True,True,95,9,0,9.718649082989462,25,-4
user_000690,43,75k-100k,mobile,returning,South,25,True,82,3,1,True,True,False,0,0,0,,82,3
user_000691,59,<30k,desktop,returning,East,25,False,0,0,0,True,False,True,156,1,0,6.86827054668186,-156,-1
user_000692,48,30k-50k,mobile,returning,Midwest,58,True,91,6,1,True,False,False,0,0,0,,91,6
user_000693,25,100k-150k,mobile,returning,South,84,True,120,2,0,False,True,True,84,2,0,8.09015196180361,36,0
user_000694,76,30k-50k,mobile,new,East,54,True,116,5,0,False,True,True,52,3,0,8.022110637950973,64,2
user_000695,46,50k-75k,desktop,new,West,40,True,112,2,0,True,True,True,95,2,0,9.346173623432806,17,0
user_000696,61,30k-50k,mobile,returning,South,39,True,68,3,0,True,False,True,79,7,0,5.7784618398455025,-11,-4
user_000697,79,100k-150k,mobile,new,South,22,True,145,4,0,False,False,True,125,3,0,5.514690586065905,20,1
user_000698,30,75k-100k,desktop,returning,South,80,True,70,2,0,True,True,True,45,1,0,7.715014541720215,25,1
user_000699,32,100k-150k,mobile,new,South,69,True,76,5,0,False,True,True,56,4,0,7.74032030387125,20,1
user_000700,56,<30k,desktop,returning,Midwest,8,True,139,4,0,True,True,True,162,4,0,8.301871448990651,-23,0
user_000701,45,75k-100k,mobile,returning,West,61,True,102,2,0,False,False,True,108,4,0,10.0,-6,-2
user_000702,30,100k-150k,mobile,returning,South,75,True,74,3,0,True,True,True,63,3,0,7.739677805036052,11,0
user_000703,18,75k-100k,desktop,returning,West,80,True,109,2,0,True,True,True,100,3,0,8.53505159142863,9,-1
user_000704,21,50k-75k,desktop,returning,West,70,True,49,1,0,True,True,True,44,1,0,10.0,5,0
user_000705,51,30k-50k,desktop,returning,East,54,True,34,1,0,True,True,False,0,0,0,,34,1
user_000706,37,100k-150k,mobile,returning,East,62,True,67,3,0,True,True,True,86,2,0,7.447023276071494,-19,1
user_000707,48,50k-75k,mobile,new,East,53,True,181,7,0,True,True,True,148,7,0,9.26021613541454,33,0
user_000708,51,30k-50k,desktop,returning,South,32,True,75,3,0,True,False,True,67,4,0,7.925058801577265,8,-1
user_000709,47,100k-150k,desktop,new,East,98,True,30,3,0,True,True,True,53,5,0,7.744531274188928,-23,-2
user_000710,62,<30k,mobile,returning,South,1,True,123,5,0,False,False,True,113,3,0,10.0,10,2
user_000711,60,75k-100k,desktop,returning,East,48,True,80,2,0,True,False,True,104,3,0,7.851931794334494,-24,-1
user_000712,46,75k-100k,mobile,returning,West,57,True,99,2,0,True,True,True,52,2,0,8.435556853486267,47,0
user_000713,47,50k-75k,desktop,returning,West,78,True,40,5,2,False,False,True,56,5,0,6.691939732438874,-16,0
user_000714,64,30k-50k,desktop,returning,Midwest,27,True,160,8,0,False,False,True,164,5,0,6.489934707660411,-4,3
user_000715,63,100k-150k,desktop,new,South,60,True,134,3,0,False,False,True,105,1,0,8.314617926859874,29,2
user_000716,58,50k-75k,desktop,returning,West,41,False,0,0,0,False,True,True,94,1,0,6.932535057314314,-94,-1
user_000717,31,<30k,tablet,returning,Midwest,42,True,113,1,0,True,False,True,115,1,0,6.106917608804534,-2,0
user_000718,51,100k-150k,mobile,returning,East,65,True,119,7,1,True,False,True,111,4,0,6.606133061879583,8,3
user_000719,60,50k-75k,mobile,new,East,32,False,0,0,0,True,True,True,136,1,0,6.992924905749466,-136,-1
user_000720,42,50k-75k,desktop,new,South,43,False,0,0,0,False,False,True,126,1,0,7.853484472010485,-126,-1
user_000721,35,75k-100k,desktop,returning,East,58,True,72,2,1,False,True,True,50,1,0,6.415944580036116,22,1
user_000722,57,100k-150k,desktop,returning,East,37,True,113,3,0,False,True,True,75,1,0,9.415956800350045,38,2
user_000723,56,50k-75k,mobile,returning,South,28,False,0,0,0,True,True,True,64,1,0,8.96589081806309,-64,-1
user_000724,34,30k-50k,mobile,new,East,77,True,117,1,0,False,True,True,76,2,0,9.639529893142976,41,-1
user_000725,30,<30k,mobile,returning,South,52,False,0,0,0,False,True,True,109,3,0,9.088279576964926,-109,-3
user_000726,36,50k-75k,mobile,returning,Midwest,49,True,85,1,1,False,False,True,67,1,0,6.370354391079662,18,0
user_000727,63,<30k,tablet,new,West,28,False,0,0,0,True,False,False,0,0,0,,0,0
user_000728,49,30k-50k,mobile,returning,East,49,False,0,0,0,False,True,True,75,1,0,7.9268233206352345,-75,-1
user_000729,48,50k-75k,tablet,returning,West,60,True,129,1,0,True,False,True,109,1,0,6.50458237879356,20,0
user_000730,54,100k-150k,mobile,returning,East,56,True,84,7,0,True,True,True,78,8,0,8.561442064644963,6,-1
user_000731,33,30k-50k,desktop,new,East,58,False,0,0,0,False,True,True,88,1,0,7.629371648186519,-88,-1
user_000732,18,<30k,mobile,returning,East,41,False,0,0,0,False,True,False,0,0,0,,0,0
user_000733,42,100k-150k,desktop,returning,East,60,True,107,2,0,False,False,True,111,1,0,8.82882273312987,-4,1
user_000734,49,30k-50k,mobile,new,South,31,True,142,8,1,True,True,True,127,8,1,7.7543450460767245,15,0
user_000735,47,<30k,mobile,returning,West,69,True,37,2,0,False,False,True,32,4,0,6.4286166640009705,5,-2
user_000736,48,<30k,tablet,new,South,31,False,0,0,0,False,False,True,107,2,0,6.845009000625912,-107,-2
user_000737,42,<30k,desktop,returning,South,38,False,0,0,0,False,True,False,0,0,0,,0,0
user_000738,26,30k-50k,mobile,returning,East,72,True,119,1,1,True,True,True,129,3,0,8.684319629227904,-10,-2
user_000739,54,75k-100k,mobile,new,East,62,True,90,3,2,False,True,True,73,1,0,6.784991577842129,17,2
user_000740,26,75k-100k,mobile,returning,West,53,True,118,4,0,True,True,True,102,1,0,10.0,16,3
user_000741,39,<30k,mobile,returning,South,33,False,0,0,0,False,False,False,0,0,0,,0,0
user_000742,39,30k-50k,mobile,returning,West,64,True,134,2,1,True,True,True,101,1,0,9.944459553793447,33,1
user_000743,27,>150k,mobile,returning,East,92,True,51,1,0,True,False,False,0,0,0,,51,1
user_000744,62,<30k,desktop,returning,South,27,True,134,2,0,True,False,True,135,4,0,6.309273238059338,-1,-2
user_000745,30,<30k,mobile,new,Midwest,49,True,115,3,0,False,False,True,122,6,1,7.937780904444468,-7,-3
user_000746,35,50k-75k,desktop,returning,West,49,True,42,2,0,True,True,True,37,4,0,8.342598458252143,5,-2
user_000747,61,30k-50k,desktop,returning,Midwest,23,True,126,4,0,False,False,True,121,6,0,5.1322448633259805,5,-2
user_000748,64,30k-50k,desktop,returning,West,28,True,143,5,0,True,True,True,131,4,0,7.379085835982333,12,1
user_000749,24,<30k,desktop,new,West,78,True,167,3,0,True,True,True,108,5,0,8.811898031990916,59,-2
user_000750,44,50k-75k,mobile,new,East,46,False,0,0,0,False,False,True,161,1,0,6.154228934128854,-161,-1
user_000751,49,<30k,mobile,returning,West,74,True,92,6,0,True,True,False,0,0,0,,92,6
user_000752,28,100k-150k,desktop,returning,West,72,True,46,4,0,True,True,True,46,2,0,10.0,0,2
user_000753,59,75k-100k,mobile,returning,Midwest,33,True,75,2,0,False,True,True,29,2,0,8.859218691269497,46,0
user_000754,49,<30k,mobile,returning,West,52,True,51,5,0,False,False,True,42,6,2,8.708429828467988,9,-1
user_000755,18,50k-75k,mobile,returning,East,67,True,59,1,0,False,False,True,52,2,0,7.432894172107426,7,-1
user_000756,33,100k-150k,desktop,returning,South,51,True,30,3,0,False,True,False,0,0,0,,30,3
user_000757,65,100k-150k,mobile,returning,South,55,True,70,2,0,True,True,True,32,2,0,8.459940651944573,38,0
user_000758,70,100k-150k,desktop,returning,West,45,True,135,2,0,False,False,True,165,1,0,7.955350202946912,-30,1
user_000759,53,50k-75k,desktop,returning,Midwest,33,True,30,2,0,False,True,True,38,1,0,8.060561351250028,-8,1
user_000760,22,50k-75k,mobile,new,Midwest,63,True,111,1,0,True,True,True,64,1,0,10.0,47,0
user_000761,59,>150k,desktop,returning,East,49,True,75,3,0,False,False,True,66,5,0,6.633640919351249,9,-2
user_000762,41,50k-75k,desktop,new,East,44,True,163,2,1,False,False,True,178,4,2,4.87261114990222,-15,-2
user_000763,59,<30k,mobile,returning,West,41,False,0,0,0,True,True,True,91,1,0,10.0,-91,-1
user_000764,58,50k-75k,mobile,returning,Midwest,41,True,143,1,0,True,True,True,80,1,0,4.607090386488644,63,0
user_000765,39,>150k,desktop,new,Midwest,48,True,61,4,0,False,False,True,67,6,1,6.7235605187618965,-6,-2
user_000766,38,100k-150k,desktop,returning,East,78,True,89,3,0,False,True,True,57,2,0,7.5081097806606305,32,1
user_000767,40,100k-150k,mobile,returning,South,40,True,93,4,0,True,False,True,101,2,0,6.252341976561419,-8,2
user_000768,36,30k-50k,desktop,returning,Midwest,35,True,77,2,1,True,True,True,20,3,0,7.829273156638467,57,-1
user_000769,34,<30k,mobile,returning,South,83,False,0,0,0,False,True,True,92,2,0,8.426910719900976,-92,-2
user_000770,35,>150k,desktop,returning,East,70,True,137,2,0,True,False,True,128,3,0,7.6918592868880316,9,-1
user_000771,39,30k-50k,desktop,returning,Midwest,28,True,154,2,0,True,False,True,142,2,0,6.3573862959269904,12,0
user_000772,52,75k-100k,tablet,returning,South,66,True,136,2,0,True,True,True,131,1,0,8.858400747768247,5,1
user_000773,80,30k-50k,desktop,returning,Midwest,13,False,0,0,0,False,True,True,118,1,0,9.310397695683442,-118,-1
user_000774,73,30k-50k,desktop,new,South,18,True,147,3,0,False,True,True,137,3,0,6.91006396549403,10,0
user_000775,18,50k-75k,mobile,returning,East,70,True,126,3,0,True,True,True,88,2,0,9.080820673145277,38,1
user_000776,69,75k-100k,mobile,returning,East,40,True,139,1,0,False,False,True,104,1,0,6.597708222791839,35,0
user_000777,24,50k-75k,mobile,returning,East,78,False,0,0,0,True,True,True,87,1,0,6.021741085040592,-87,-1
user_000778,37,50k-75k,mobile,new,West,69,True,61,5,0,False,True,True,62,10,0,8.637055275591184,-1,-5
user_000779,30,30k-50k,desktop,returning,West,82,True,72,1,0,True,True,True,20,1,0,7.433393523603023,52,0
user_000780,43,<30k,mobile,returning,West,41,True,66,3,0,True,True,True,84,1,0,6.982741012373771,-18,2
user_000781,77,100k-150k,mobile,returning,West,38,True,99,4,0,True,True,True,72,4,0,6.609138904345416,27,0
user_000782,33,50k-75k,mobile,new,West,76,False,0,0,0,True,True,False,0,0,0,,0,0
user_000783,68,75k-100k,tablet,returning,South,42,True,78,3,0,False,False,True,88,2,0,6.7755426894631805,-10,1
user_000784,32,30k-50k,desktop,returning,East,84,True,72,5,1,False,True,True,40,6,0,8.105186381819871,32,-1
user_000785,48,30k-50k,desktop,new,East,61,True,132,2,0,False,False,True,114,1,0,8.311802558508472,18,1
user_000786,55,50k-75k,mobile,new,South,87,True,64,2,0,False,True,True,60,2,0,8.013425369816655,4,0
user_000787,33,<30k,mobile,returning,East,62,True,81,3,0,False,True,True,88,4,0,8.770053486068857,-7,-1
user_000788,66,75k-100k,desktop,returning,West,51,True,43,2,0,True,True,True,23,4,0,7.498030319534257,20,-2
user_000789,30,50k-75k,desktop,returning,South,69,True,116,6,1,False,True,True,78,4,0,8.757284563422193,38,2
user_000790,27,30k-50k,mobile,returning,South,80,True,113,3,0,False,True,True,105,3,0,10.0,8,0
user_000791,38,30k-50k,desktop,returning,West,61,True,93,3,1,False,True,True,90,4,0,7.07130446864866,3,-1
user_000792,39,30k-50k,desktop,new,South,40,False,0,0,0,False,False,True,108,1,0,8.057372618277606,-108,-1
user_000793,64,30k-50k,desktop,returning,Midwest,26,True,100,3,0,True,False,True,106,3,1,5.274721181878866,-6,0
user_000794,62,100k-150k,mobile,returning,South,39,True,78,5,0,True,True,True,75,3,0,6.957946117549882,3,2
user_000795,28,<30k,desktop,returning,South,76,True,90,2,2,False,False,True,113,2,0,7.701467552878067,-23,0
user_000796,53,100k-150k,mobile,new,Midwest,51,True,108,3,1,True,True,True,98,2,0,7.377564324632719,10,1
user_000797,65,75k-100k,mobile,returning,East,48,True,80,1,0,True,True,True,55,1,1,9.014980324552825,25,0
user_000798,41,>150k,mobile,returning,East,68,True,42,3,1,True,True,True,32,4,0,7.475336689090476,10,-1
user_000799,68,100k-150k,mobile,new,South,22,True,108,4,1,False,False,True,131,7,0,7.839697388364272,-23,-3
user_000800,41,50k-75k,desktop,new,West,31,True,101,1,1,False,True,True,78,2,1,6.489541440193725,23,-1
user_000801,59,30k-50k,mobile,returning,West,48,True,78,3,0,False,True,False,0,0,0,,78,3
user_000802,33,30k-50k,desktop,returning,East,94,True,87,4,0,True,True,True,61,4,0,8.473900822520687,26,0
user_000803,43,50k-75k,mobile,returning,Midwest,39,True,159,2,0,True,True,True,130,1,0,7.9365903288155675,29,1
user_000804,54,>150k,mobile,returning,South,84,True,91,5,0,False,True,True,106,2,0,7.262845355946685,-15,3
user_000805,50,75k-100k,desktop,returning,East,48,True,111,6,0,False,True,True,73,5,0,7.247613544655081,38,1
user_000806,46,75k-100k,mobile,returning,East,38,True,94,4,0,True,True,True,54,2,0,7.964079341970038,40,2
user_000807,35,50k-75k,desktop,new,South,46,True,156,4,0,False,True,True,117,1,0,9.736197241942813,39,3
user_000808,38,>150k,desktop,new,East,76,True,69,1,0,False,False,True,64,1,0,6.785431139481203,5,0
user_000809,21,30k-50k,mobile,new,South,62,True,150,1,0,False,True,True,118,1,0,9.083869712430007,32,0
user_000810,44,30k-50k,mobile,returning,East,54,True,70,3,0,False,True,True,42,1,0,7.431516994525695,28,2
user_000811,49,30k-50k,desktop,returning,Midwest,37,True,60,2,0,False,False,True,29,3,0,7.661732574455024,31,-1
user_000812,37,30k-50k,mobile,new,West,65,True,144,4,0,False,True,True,113,2,0,9.301585608161622,31,2
user_000813,50,50k-75k,desktop,returning,West,63,True,52,3,0,True,False,True,37,4,0,7.566850415835403,15,-1
user_000814,61,50k-75k,desktop,returning,East,11,True,162,5,0,False,True,True,118,7,0,8.724701165947105,44,-2
user_000815,48,100k-150k,tablet,returning,East,48,True,106,2,0,True,True,True,100,2,0,8.86194032014615,6,0
user_000816,46,30k-50k,mobile,returning,South,35,True,108,2,0,False,True,True,72,1,0,7.613220446591424,36,1
user_000817,32,<30k,mobile,returning,East,43,True,56,1,0,False,False,True,67,1,0,8.12023128094771,-11,0
user_000818,56,<30k,mobile,returning,South,0,True,198,7,1,False,False,True,180,4,0,6.806294611601219,18,3
user_000819,45,100k-150k,mobile,returning,South,68,True,125,4,0,True,True,True,114,2,0,6.966372185040732,11,2
user_000820,49,<30k,mobile,returning,Midwest,7,False,0,0,0,False,True,True,118,1,0,7.053756414109401,-118,-1
user_000821,44,50k-75k,mobile,new,South,62,True,94,3,0,True,False,True,82,2,0,8.514015594864365,12,1
user_000822,49,75k-100k,mobile,returning,Midwest,45,True,42,1,0,True,True,True,50,1,0,8.589804416195209,-8,0
user_000823,21,75k-100k,mobile,returning,West,62,True,114,3,0,True,True,True,90,2,0,6.450089859385772,24,1
user_000824,18,50k-75k,desktop,returning,South,78,True,111,2,0,True,True,True,108,1,1,8.20637741789817,3,1
user_000825,47,100k-150k,mobile,new,East,97,True,61,2,0,False,True,True,76,2,0,8.658655464743536,-15,0
user_000826,48,50k-75k,tablet,returning,South,28,True,180,5,0,True,False,True,159,4,0,6.107089810980295,21,1
user_000827,43,100k-150k,desktop,returning,East,51,True,62,3,0,True,True,True,79,1,0,8.884135010374418,-17,2
user_000828,56,50k-75k,desktop,new,South,25,True,187,2,0,False,False,True,195,1,0,7.12386685184672,-8,1
user_000829,28,>150k,mobile,new,East,98,True,81,6,0,False,True,True,46,2,0,7.935283553231539,35,4
user_000830,24,75k-100k,mobile,new,East,53,True,145,9,0,True,True,True,144,4,0,5.312672064249477,1,5
user_000831,43,50k-75k,mobile,new,East,55,True,145,3,0,False,True,True,121,1,0,8.128244841009185,24,2
user_000832,62,50k-75k,desktop,returning,West,59,True,133,1,1,True,False,True,122,1,0,7.617987373492717,11,0
user_000833,67,75k-100k,mobile,returning,West,54,True,150,2,0,True,True,True,145,3,0,5.688173198459607,5,-1
user_000834,22,30k-50k,desktop,new,South,61,True,112,1,1,True,True,True,82,1,1,6.942212816285715,30,0
user_000835,63,<30k,tablet,new,West,12,False,0,0,0,False,False,False,0,0,0,,0,0
user_000836,38,50k-75k,mobile,new,West,39,True,142,9,0,True,False,True,140,1,0,6.412297132875569,2,8
user_000837,35,75k-100k,mobile,returning,East,60,True,117,4,0,True,True,True,68,4,0,6.833142410889238,49,0
user_000838,52,<30k,mobile,new,East,45,True,97,5,0,True,True,True,75,1,0,6.938457462012098,22,4
user_000839,47,100k-150k,mobile,returning,East,59,True,90,2,0,True,True,True,63,2,0,7.014760086583059,27,0
user_000840,33,<30k,mobile,new,Midwest,70,False,0,0,0,False,False,True,101,1,0,10.0,-101,-1
user_000841,55,100k-150k,mobile,returning,Midwest,42,True,117,1,0,True,True,True,110,1,1,6.472796409570562,7,0
user_000842,20,75k-100k,desktop,new,South,72,True,168,1,0,False,True,True,149,1,0,7.818657912627498,19,0
user_000843,74,50k-75k,mobile,returning,South,45,True,81,3,0,False,False,True,111,6,0,5.677835060201642,-30,-3
user_000844,30,50k-75k,mobile,new,East,61,True,161,4,0,True,True,True,106,2,0,7.5105941770212405,55,2
user_000845,51,50k-75k,mobile,new,East,60,True,119,1,1,True,True,True,106,1,0,6.730984437324052,13,0
user_000846,49,<30k,desktop,returning,South,22,False,0,0,0,True,True,True,130,1,0,7.016372920054967,-130,-1
user_000847,37,100k-150k,desktop,returning,East,65,True,93,2,0,True,True,True,47,1,0,6.082503581703611,46,1
user_000848,28,75k-100k,mobile,returning,East,72,True,72,1,1,True,True,True,33,1,0,7.936852076331529,39,0
user_000849,18,75k-100k,desktop,new,West,100,True,88,6,0,False,True,True,55,5,0,8.348062495246827,33,1
user_000850,34,<30k,desktop,returning,South,57,True,61,5,0,False,False,True,65,6,0,8.771670930422472,-4,-1
user_000851,34,<30k,mobile,new,West,48,False,0,0,0,False,False,True,124,1,0,8.284287577311547,-124,-1
user_000852,49,100k-150k,desktop,returning,Midwest,52,False,0,0,0,True,True,True,104,1,0,9.351212374204064,-104,-1
user_000853,31,30k-50k,desktop,new,South,50,True,151,1,0,False,False,True,111,1,0,6.6735158189435,40,0
user_000854,52,100k-150k,mobile,returning,Midwest,76,True,76,4,1,True,True,True,91,4,0,7.142237935906211,-15,0
user_000855,43,75k-100k,mobile,returning,South,57,True,136,5,0,False,True,True,133,2,0,9.465356561231136,3,3
user_000856,34,<30k,mobile,returning,Midwest,54,True,82,1,0,True,True,True,65,1,0,8.793802854785232,17,0
user_000857,48,50k-75k,desktop,returning,Midwest,15,True,103,5,0,True,True,True,68,5,0,8.13117828963819,35,0
user_000858,65,<30k,tablet,returning,East,8,False,0,0,0,True,False,True,116,1,0,5.948100358987788,-116,-1
user_000859,50,75k-100k,desktop,new,East,37,True,72,5,0,False,True,True,76,2,0,7.597915738624583,-4,3
user_000860,18,<30k,desktop,returning,South,21,True,120,4,1,True,False,True,112,7,0,6.348728742090063,8,-3
user_000861,62,<30k,desktop,returning,West,30,True,125,3,0,True,True,True,114,2,1,7.755095405256079,11,1
user_000862,53,100k-150k,mobile,returning,West,85,True,67,5,0,False,True,True,70,1,0,6.411548157260839,-3,4
user_000863,31,<30k,desktop,returning,East,61,True,118,3,0,False,True,True,99,5,0,9.778976202802298,19,-2
user_000864,62,75k-100k,desktop,new,West,49,False,0,0,0,True,True,True,116,1,0,7.046213726774726,-116,-1
user_000865,27,<30k,mobile,returning,South,35,True,93,3,0,False,True,True,92,3,0,6.50894270738106,1,0
user_000866,62,50k-75k,mobile,new,Midwest,57,True,55,4,0,True,False,True,20,5,0,5.822290053756883,35,-1
user_000867,57,75k-100k,desktop,new,East,41,False,0,0,0,False,True,True,106,2,0,7.123888939032686,-106,-2
user_000868,49,>150k,desktop,new,West,94,True,108,5,0,True,True,True,88,8,0,8.204568481275661,20,-3
user_000869,38,75k-100k,desktop,returning,South,56,True,80,1,0,False,True,True,62,1,0,8.855147229291713,18,0
user_000870,27,75k-100k,mobile,returning,West,84,True,42,1,1,False,False,True,46,1,0,5.456700179420885,-4,0
user_000871,51,75k-100k,mobile,new,East,41,True,130,3,1,True,True,True,100,2,0,4.88928759989561,30,1
user_000872,36,50k-75k,desktop,new,Midwest,38,True,164,5,0,True,False,True,173,2,0,5.133003214788961,-9,3
user_000873,18,75k-100k,desktop,returning,East,52,True,99,3,1,False,False,True,123,8,0,7.751227639350284,-24,-5
user_000874,21,>150k,mobile,new,East,91,True,82,6,0,False,True,True,37,5,0,9.441629245723549,45,1
user_000875,55,100k-150k,mobile,returning,West,78,True,79,2,0,True,True,True,82,1,0,9.558727924473128,-3,1
user_000876,27,30k-50k,tablet,returning,South,80,True,123,3,0,True,True,True,85,2,0,10.0,38,1
user_000877,42,30k-50k,mobile,new,West,46,True,141,2,0,False,False,True,192,1,0,6.832684196638254,-51,1
user_000878,37,75k-100k,mobile,new,Midwest,61,True,136,4,0,True,False,True,92,4,0,8.479097056762722,44,0
user_000879,24,75k-100k,desktop,returning,Midwest,76,True,75,2,0,True,True,True,47,1,0,7.291131446307727,28,1
user_000880,52,<30k,desktop,returning,Midwest,21,False,0,0,0,False,False,False,0,0,0,,0,0
user_000881,56,75k-100k,tablet,returning,Midwest,20,True,121,4,0,True,False,True,141,5,0,8.421899307813757,-20,-1
user_000882,29,<30k,desktop,returning,East,89,True,55,4,0,False,True,True,33,5,0,7.080387185484432,22,-1
user_000883,50,50k-75k,mobile,returning,South,53,True,122,3,0,True,False,True,119,2,1,9.19438316256824,3,1
user_000884,65,30k-50k,mobile,new,South,42,True,154,1,0,True,False,True,190,1,0,8.724279261982527,-36,0
user_000885,29,30k-50k,desktop,new,East,75,True,74,6,0,False,True,True,72,7,0,8.751676291878553,2,-1
user_000886,31,100k-150k,mobile,returning,East,88,True,58,1,0,True,True,True,37,1,0,8.723255415350545,21,0
user_000887,57,<30k,desktop,new,South,1,False,0,0,0,True,False,True,92,1,1,5.383798818352532,-92,-1
user_000888,36,>150k,desktop,returning,South,55,True,59,4,0,True,True,True,56,4,0,7.947054973054187,3,0
user_000889,27,30k-50k,desktop,returning,West,100,True,70,2,0,True,True,True,20,1,0,7.640879125676519,50,1
user_000890,48,30k-50k,tablet,returning,East,35,True,41,4,0,True,False,True,20,2,0,8.630929061807697,21,2
user_000891,60,100k-150k,desktop,returning,East,63,True,87,5,0,False,False,True,90,13,0,8.418907515428275,-3,-8
user_000892,53,30k-50k,mobile,returning,West,27,True,114,4,0,True,False,True,107,3,0,7.665284909994009,7,1
user_000893,51,>150k,desktop,returning,East,84,True,96,4,0,True,True,True,100,3,0,7.485523243567699,-4,1
user_000894,28,100k-150k,mobile,returning,Midwest,76,True,115,2,0,True,True,True,90,1,0,9.617348841077618,25,1
user_000895,55,<30k,mobile,returning,West,37,True,87,3,0,True,True,True,84,2,0,8.141100769519472,3,1
user_000896,66,30k-50k,desktop,new,South,22,True,131,4,1,False,False,True,128,1,1,7.612123041388095,3,3
user_000897,62,<30k,mobile,new,Midwest,0,False,0,0,0,True,False,True,152,1,0,5.880585955545613,-152,-1
user_000898,31,<30k,mobile,returning,East,71,True,120,3,0,False,True,True,79,3,1,8.8576036984484,41,0
user_000899,61,100k-150k,desktop,new,West,66,True,82,2,0,False,True,False,0,0,0,,82,2
user_000900,34,50k-75k,mobile,returning,Midwest,21,True,77,3,0,False,False,True,55,2,0,7.9143806656195705,22,1
user_000901,18,30k-50k,desktop,returning,South,22,False,0,0,0,True,True,True,51,2,0,7.92060411092376,-51,-2
user_000902,54,50k-75k,desktop,returning,East,74,True,30,2,0,True,True,True,20,4,0,8.143562295277679,10,-2
user_000903,41,50k-75k,mobile,returning,West,69,True,104,7,1,True,True,True,79,9,0,7.957720270499334,25,-2
user_000904,40,>150k,desktop,returning,East,50,True,95,1,0,True,True,True,71,1,0,8.688189518733655,24,0
user_000905,36,<30k,desktop,returning,South,27,False,0,0,0,True,False,True,124,1,0,8.34477333209915,-124,-1
user_000906,32,50k-75k,desktop,returning,East,70,False,0,0,0,True,True,True,79,3,0,8.098005943885806,-79,-3
user_000907,52,>150k,desktop,new,Midwest,44,True,85,5,1,True,True,True,92,3,0,8.513100231567648,-7,2
user_000908,57,30k-50k,desktop,returning,Midwest,33,True,71,2,0,True,False,True,79,2,0,7.8411601039751995,-8,0
user_000909,67,<30k,mobile,new,South,9,True,177,8,0,False,False,False,0,0,0,,177,8
user_000910,23,75k-100k,mobile,new,East,62,True,142,1,2,True,True,True,99,1,0,6.69677918230825,43,0
user_000911,59,<30k,desktop,returning,East,32,True,66,3,2,False,False,True,56,4,0,7.503054753956322,10,-1
user_000912,46,<30k,mobile,returning,Midwest,27,True,74,5,1,False,False,False,0,0,0,,74,5
user_000913,53,30k-50k,mobile,returning,South,43,True,89,1,0,False,False,True,83,1,0,7.052630241519608,6,0
user_000914,35,50k-75k,desktop,returning,South,53,True,61,3,0,True,True,True,68,5,0,8.093878112067687,-7,-2
user_000915,80,100k-150k,desktop,new,South,62,True,144,2,0,False,True,True,85,1,0,7.1999181951964975,59,1
user_000916,55,75k-100k,mobile,returning,West,61,True,83,6,0,True,True,True,24,3,0,9.765378255096618,59,3
user_000917,43,75k-100k,desktop,new,East,2,True,161,6,1,True,False,True,166,6,0,6.061059992266041,-5,0
user_000918,27,<30k,desktop,returning,South,54,True,109,3,0,False,True,True,98,2,0,9.49002740129393,11,1
user_000919,33,75k-100k,mobile,returning,Midwest,65,False,0,0,0,True,False,True,95,1,0,5.224339998963227,-95,-1
user_000920,45,75k-100k,mobile,returning,South,51,True,66,1,0,False,True,True,33,1,0,9.32482892414309,33,0
user_000921,31,50k-75k,desktop,new,East,71,False,0,0,0,True,True,False,0,0,0,,0,0
user_000922,41,50k-75k,desktop,returning,West,53,True,109,2,1,True,True,True,103,1,0,6.960991702316934,6,1
user_000923,22,100k-150k,mobile,returning,West,100,True,61,3,1,False,True,True,39,2,0,7.43668411626955,22,1
user_000924,55,75k-100k,mobile,returning,West,65,True,97,7,0,True,True,True,68,6,0,7.496853078080391,29,1
user_000925,27,<30k,desktop,returning,West,66,False,0,0,0,False,True,True,127,1,0,9.938663475679665,-127,-1
user_000926,54,75k-100k,desktop,new,East,50,True,178,2,0,False,True,True,122,1,0,8.024437238666588,56,1
user_000927,28,50k-75k,mobile,returning,East,22,True,98,4,0,True,True,False,0,0,0,,98,4
user_000928,80,100k-150k,desktop,returning,East,45,False,0,0,0,True,False,True,139,1,0,7.500789527935752,-139,-1
user_000929,41,30k-50k,desktop,returning,East,44,True,61,2,0,False,True,True,20,2,0,7.874688207734032,41,0
user_000930,52,100k-150k,mobile,new,East,35,True,187,3,0,False,False,True,194,3,0,7.756600685233152,-7,0
user_000931,24,50k-75k,mobile,returning,South,54,True,67,5,0,False,False,True,41,9,0,6.528263465182141,26,-4
user_000932,66,30k-50k,desktop,returning,West,38,True,65,4,1,True,False,True,108,7,0,4.5340586808613645,-43,-3
user_000933,49,30k-50k,desktop,new,Midwest,41,True,105,2,0,False,False,True,125,3,0,6.648098115140094,-20,-1
user_000934,42,50k-75k,desktop,new,South,42,True,134,1,0,False,False,True,151,1,0,6.213740587186695,-17,0
user_000935,44,50k-75k,mobile,new,South,48,True,184,4,0,True,True,True,169,3,0,8.580627804205218,15,1
user_000936,58,100k-150k,desktop,new,Midwest,27,True,124,4,0,False,False,True,179,1,0,9.089177240583952,-55,3
user_000937,53,<30k,mobile,new,South,44,True,133,5,0,False,False,False,0,0,0,,133,5
user_000938,65,50k-75k,mobile,new,East,25,True,140,4,0,False,False,True,128,5,0,8.70232093303943,12,-1
user_000939,55,50k-75k,mobile,new,West,57,False,0,0,0,False,False,True,125,1,1,7.155041322180538,-125,-1
user_000940,36,75k-100k,desktop,returning,East,57,True,91,1,0,True,False,True,117,1,0,6.910386062189096,-26,0
user_000941,62,50k-75k,desktop,returning,South,65,True,106,6,0,True,True,True,81,5,0,8.19171745984193,25,1
user_000942,58,<30k,mobile,new,West,49,False,0,0,0,False,True,True,85,1,0,8.177096007785275,-85,-1
user_000943,34,<30k,desktop,new,East,39,True,99,2,1,False,False,True,131,2,0,5.601825266085395,-32,0
user_000944,47,30k-50k,desktop,returning,South,37,True,120,4,0,False,True,True,114,3,0,9.081969563311555,6,1
user_000945,26,<30k,desktop,returning,East,63,False,0,0,0,True,True,True,100,2,0,8.411530866392397,-100,-2
user_000946,34,30k-50k,mobile,returning,West,94,True,30,2,0,True,True,True,20,2,0,9.850627533317569,10,0
user_000947,32,<30k,mobile,returning,Midwest,62,True,50,3,0,True,True,False,0,0,0,,50,3
user_000948,33,30k-50k,desktop,new,West,100,True,74,1,0,False,True,True,56,1,0,9.19495847853276,18,0
user_000949,32,100k-150k,desktop,new,South,61,True,113,2,0,False,True,False,0,0,0,,113,2
user_000950,19,50k-75k,mobile,returning,West,63,True,83,1,0,False,True,True,82,1,0,9.55917414230137,1,0
user_000951,29,75k-100k,desktop,new,East,64,True,133,5,0,True,False,False,0,0,0,,133,5
user_000952,49,75k-100k,desktop,new,East,37,True,115,3,0,False,False,True,134,6,0,4.069380131754668,-19,-3
user_000953,57,<30k,tablet,returning,East,27,True,199,6,1,False,False,False,0,0,0,,199,6
user_000954,65,50k-75k,mobile,returning,South,49,True,98,4,0,False,True,True,88,3,0,6.85715232835503,10,1
user_000955,69,100k-150k,desktop,returning,West,64,True,61,1,1,False,True,True,37,1,1,5.996484688989023,24,0
user_000956,38,75k-100k,desktop,new,South,48,True,73,5,0,False,True,True,40,4,0,8.258733533960003,33,1
user_000957,61,50k-75k,mobile,new,West,12,False,0,0,0,True,False,True,138,1,0,9.279981991547057,-138,-1
user_000958,45,75k-100k,desktop,returning,West,78,True,95,1,0,True,True,True,76,1,1,8.07070131338982,19,0
user_000959,53,>150k,mobile,new,Midwest,56,True,117,1,0,True,True,False,0,0,0,,117,1
user_000960,33,<30k,desktop,returning,Midwest,34,True,115,5,0,True,True,True,86,1,0,7.7155939270336305,29,4
user_000961,56,100k-150k,mobile,returning,Midwest,59,True,118,5,0,True,True,True,126,3,0,7.148808101756174,-8,2
user_000962,44,30k-50k,desktop,returning,East,57,True,114,4,1,False,False,True,110,1,0,5.777861753994951,4,3
user_000963,35,<30k,mobile,returning,East,36,False,0,0,0,False,False,True,129,1,0,7.252576118133512,-129,-1
user_000964,67,75k-100k,mobile,returning,East,33,True,60,8,0,True,True,True,47,10,0,10.0,13,-2
user_000965,65,50k-75k,mobile,returning,East,36,True,99,5,0,False,False,True,98,12,0,7.063112729787895,1,-7
user_000966,49,50k-75k,desktop,returning,East,47,True,100,3,1,False,True,True,80,1,0,7.063232225661593,20,2
user_000967,47,75k-100k,desktop,returning,West,95,True,66,5,0,True,True,False,0,0,0,,66,5
user_000968,43,50k-75k,mobile,new,West,68,False,0,0,0,False,True,True,110,1,0,9.54102888354366,-110,-1
user_000969,55,50k-75k,mobile,new,Midwest,91,False,0,0,0,True,True,True,90,1,1,7.7003024406751,-90,-1
user_000970,18,30k-50k,desktop,new,West,75,True,137,2,0,True,True,True,101,2,0,9.750200906002162,36,0
user_000971,33,30k-50k,desktop,returning,South,62,True,38,3,0,False,True,True,20,4,0,9.946374170919299,18,-1
user_000972,45,30k-50k,tablet,returning,Midwest,41,True,63,1,0,True,True,True,30,1,0,3.7614888854949036,33,0
user_000973,18,<30k,desktop,returning,South,85,True,68,3,1,True,True,True,26,3,0,6.0083972061359265,42,0
user_000974,42,100k-150k,desktop,new,East,41,True,57,3,0,False,False,True,20,5,0,8.719065490894225,37,-2
user_000975,64,50k-75k,desktop,returning,West,45,True,90,3,0,False,True,True,67,5,0,6.521288638008011,23,-2
user_000976,55,75k-100k,mobile,returning,South,53,True,89,2,0,True,True,False,0,0,0,,89,2
user_000977,77,>150k,desktop,returning,East,39,True,187,3,1,False,False,True,182,5,0,7.179717147324069,5,-2
user_000978,42,50k-75k,desktop,new,Midwest,32,True,115,2,0,False,False,True,168,2,0,7.353697052801294,-53,0
user_000979,18,75k-100k,desktop,returning,East,69,True,58,2,0,True,True,True,20,3,0,8.247150906583284,38,-1
user_000980,50,50k-75k,desktop,returning,South,40,True,58,1,0,True,True,True,20,1,0,7.245076226372911,38,0
user_000981,55,<30k,desktop,new,East,40,True,119,3,0,False,False,False,0,0,0,,119,3
user_000982,39,<30k,mobile,returning,East,19,True,130,3,1,False,True,True,105,2,0,7.278461129407726,25,1
user_000983,44,50k-75k,desktop,returning,East,54,True,95,1,0,True,False,True,95,1,0,5.553779517252561,0,0
user_000984,54,<30k,mobile,returning,West,26,True,119,6,1,False,False,True,124,7,0,7.080910401853232,-5,-1
user_000985,50,75k-100k,desktop,returning,East,72,True,77,5,0,True,True,True,67,5,0,7.013144084490721,10,0
user_000986,59,50k-75k,mobile,new,East,69,False,0,0,0,True,True,False,0,0,0,,0,0
user_000987,18,>150k,desktop,new,Midwest,69,True,193,4,0,True,True,True,138,3,0,9.035578853605257,55,1
user_000988,43,100k-150k,mobile,returning,East,59,True,76,1,0,False,True,True,32,1,0,9.17730890294144,44,0
user_000989,33,30k-50k,desktop,returning,East,71,False,0,0,0,False,True,True,89,1,0,7.7279537242213765,-89,-1
user_000990,48,100k-150k,desktop,returning,South,61,True,98,3,0,True,False,True,107,3,1,10.0,-9,0
user_000991,28,75k-100k,desktop,returning,West,81,True,30,1,0,False,False,True,40,1,0,8.108321171575191,-10,0
user_000992,44,50k-75k,desktop,returning,West,38,True,93,6,0,False,False,True,69,6,0,4.840409942590689,24,0
user_000993,21,>150k,mobile,returning,Midwest,92,True,77,6,0,True,True,True,54,6,0,8.967539658189818,23,0
user_000994,41,50k-75k,mobile,returning,West,58,True,126,4,0,False,False,True,116,1,0,4.633043549194802,10,3
user_000995,40,30k-50k,desktop,new,West,59,True,110,5,0,True,True,True,94,4,1,7.343564555282053,16,1
user_000996,51,<30k,desktop,returning,South,47,True,46,1,0,False,False,True,42,1,0,6.945145463302393,4,0
user_000997,21,<30k,desktop,returning,South,55,False,0,0,0,True,True,True,93,1,1,7.192068873939112,-93,-1
user_000998,34,100k-150k,desktop,returning,West,85,True,109,5,0,True,True,True,108,2,0,9.131857183520122,1,3
user_000999,60,75k-100k,mobile,new,South,23,True,162,2,0,False,False,True,165,2,0,6.376498469824011,-3,0
user_001000,43,50k-75k,desktop,returning,West,56,True,113,1,0,True,True,True,63,1,1,5.986522301388303,50,0
user_001001,52,75k-100k,desktop,returning,Midwest,37,True,97,3,0,False,False,True,93,1,1,6.952496607788034,4,2
user_001002,47,>150k,mobile,returning,West,100,True,65,1,0,True,True,True,68,1,0,7.296776410834404,-3,0
user_001003,43,<30k,mobile,new,East,40,False,0,0,0,False,False,True,123,1,0,7.251020688979043,-123,-1
user_001004,33,75k-100k,desktop,returning,West,63,True,79,1,0,True,True,True,86,1,0,7.920079387892171,-7,0
user_001005,53,30k-50k,desktop,new,East,77,True,134,2,0,True,True,True,102,1,0,9.293730250348146,32,1
user_001006,48,50k-75k,mobile,returning,West,53,True,30,5,1,True,True,True,25,3,0,6.3310668832492665,5,2
user_001007,39,100k-150k,mobile,returning,Midwest,63,True,72,1,0,False,True,True,94,1,0,8.057816967442617,-22,0
user_001008,53,75k-100k,mobile,returning,West,51,True,105,3,0,True,True,True,103,2,0,6.14484538505908,2,1
user_001009,32,50k-75k,mobile,returning,South,78,True,30,2,0,True,True,True,20,1,0,7.9550036694233155,10,1
user_001010,80,<30k,mobile,returning,Midwest,32,True,95,4,0,False,True,True,57,1,0,8.431510919622022,38,3
user_001011,46,50k-75k,desktop,returning,West,43,True,125,1,0,True,True,True,60,1,0,6.937761524207981,65,0
user_001012,49,100k-150k,mobile,returning,South,52,True,71,5,0,True,True,True,76,3,0,8.695761611976232,-5,2
user_001013,41,30k-50k,mobile,returning,Midwest,31,True,104,1,0,False,True,True,88,1,0,8.265238150937355,16,0
user_001014,54,50k-75k,desktop,returning,West,74,False,0,0,0,False,False,True,132,1,0,7.123142939381083,-132,-1
user_001015,49,50k-75k,desktop,returning,West,91,True,92,2,0,True,True,True,67,1,0,7.232257830784995,25,1
user_001016,43,75k-100k,mobile,returning,Midwest,32,True,74,6,0,True,True,True,81,6,0,7.450831062391209,-7,0
user_001017,36,75k-100k,desktop,returning,South,21,True,118,3,0,False,False,True,129,2,0,6.400981708304326,-11,1
user_001018,30,100k-150k,desktop,returning,South,71,True,30,1,0,False,True,False,0,0,0,,30,1
user_001019,38,30k-50k,mobile,new,East,38,True,72,2,0,False,False,True,50,4,0,7.344211568302275,22,-2
user_001020,49,50k-75k,mobile,new,Midwest,51,True,108,3,0,False,False,True,99,5,0,7.154490669063666,9,-2
user_001021,61,30k-50k,desktop,new,West,36,True,179,6,0,True,False,True,170,9,0,7.372829375314324,9,-3
user_001022,24,30k-50k,mobile,new,South,75,True,87,1,0,False,True,True,54,1,0,7.176728158072673,33,0
user_001023,38,50k-75k,desktop,returning,West,71,True,32,4,0,True,True,True,34,6,0,7.373576629282803,-2,-2
user_001024,33,75k-100k,mobile,returning,East,71,True,96,4,0,True,True,True,50,2,1,9.571790118161049,46,2
user_001025,69,75k-100k,mobile,returning,South,36,True,85,1,1,True,False,True,68,1,0,9.705168068915157,17,0
user_001026,68,75k-100k,mobile,returning,East,41,True,30,6,0,False,False,True,20,4,1,7.273674008752103,10,2
user_001027,46,50k-75k,mobile,returning,South,56,True,102,3,0,False,True,False,0,0,0,,102,3
user_001028,57,75k-100k,desktop,new,West,53,True,86,4,1,False,False,True,73,4,1,4.855960731511146,13,0
user_001029,33,100k-150k,mobile,new,East,70,True,129,3,1,True,True,True,100,3,0,8.93289493835053,29,0
user_001030,32,75k-100k,mobile,returning,East,72,True,102,1,0,True,True,True,96,1,0,7.107292982130289,6,0
user_001031,22,30k-50k,mobile,returning,South,61,True,88,2,0,True,True,True,113,3,0,6.931410420663498,-25,-1
user_001032,61,100k-150k,mobile,new,Midwest,48,True,162,1,0,True,True,True,148,2,0,10.0,14,-1
user_001033,52,50k-75k,tablet,returning,West,33,True,112,3,0,False,False,True,100,2,0,7.491497561363145,12,1
user_001034,48,30k-50k,mobile,new,East,67,False,0,0,0,True,True,True,92,2,0,8.380129921137351,-92,-2
user_001035,37,>150k,mobile,new,West,62,True,120,2,0,True,True,True,104,3,0,8.584849269966202,16,-1
user_001036,39,75k-100k,desktop,returning,West,71,True,30,4,0,False,False,True,44,2,0,7.498023962385987,-14,2
user_001037,19,<30k,desktop,returning,West,61,True,95,5,0,True,True,False,0,0,0,,95,5
user_001038,40,75k-100k,desktop,returning,West,26,True,139,5,1,True,True,True,94,2,0,9.097973007523317,45,3
user_001039,47,50k-75k,mobile,returning,South,62,True,40,4,0,False,True,True,59,4,0,8.807476983767362,-19,0
user_001040,18,100k-150k,mobile,returning,East,80,True,49,1,1,True,True,True,70,1,0,7.3026102239755275,-21,0
user_001041,42,>150k,mobile,new,East,42,True,135,2,0,False,False,True,132,4,0,6.732923041074904,3,-2
user_001042,26,50k-75k,desktop,returning,East,53,True,87,5,0,False,False,True,100,5,0,9.503592126094148,-13,0
user_001043,28,75k-100k,mobile,new,South,63,True,137,2,0,True,True,True,79,1,0,9.855853158428653,58,1
user_001044,80,30k-50k,desktop,returning,Midwest,0,False,0,0,0,True,True,True,94,1,0,6.698116418283246,-94,-1
user_001045,36,>150k,tablet,new,South,50,True,80,2,0,True,True,True,52,1,0,7.008174577457016,28,1
user_001046,57,75k-100k,mobile,returning,West,45,True,85,2,0,True,False,True,77,6,0,5.420525450492238,8,-4
user_001047,25,100k-150k,mobile,returning,Midwest,47,True,102,3,0,False,False,True,114,1,0,8.26030352537992,-12,2
user_001048,46,50k-75k,mobile,new,South,47,False,0,0,0,False,False,True,106,1,0,7.750261962571091,-106,-1
user_001049,48,<30k,mobile,returning,East,50,True,111,1,0,True,True,True,115,2,0,8.969729733355639,-4,-1
user_001050,18,<30k,desktop,returning,West,74,False,0,0,0,False,True,True,110,2,0,8.641165887290851,-110,-2
user_001051,32,50k-75k,mobile,returning,South,65,True,94,10,0,False,True,True,86,7,0,6.793670632609976,8,3
user_001052,37,75k-100k,mobile,returning,East,42,True,99,4,0,True,True,True,69,1,0,7.373770846315171,30,3
user_001053,39,75k-100k,mobile,returning,West,30,True,103,2,0,False,False,True,110,1,0,6.397119132495155,-7,1
user_001054,45,100k-150k,desktop,new,East,47,True,91,2,0,False,True,True,70,2,0,8.400887959114028,21,0
user_001055,59,50k-75k,desktop,returning,East,34,True,77,4,0,True,False,True,102,3,0,6.149966339691424,-25,1
user_001056,34,100k-150k,mobile,new,East,75,True,141,6,0,True,True,True,82,5,0,9.194650868383318,59,1
user_001057,55,<30k,desktop,new,West,40,True,111,2,0,True,True,True,76,1,0,4.732999852008703,35,1
user_001058,35,100k-150k,desktop,returning,South,50,True,92,7,0,False,True,True,119,5,0,8.737035090662364,-27,2
user_001059,24,30k-50k,mobile,returning,South,91,True,85,2,0,False,True,False,0,0,0,,85,2
user_001060,38,100k-150k,mobile,new,Midwest,61,True,169,1,0,True,True,True,145,1,0,7.212112445532648,24,0
user_001061,35,50k-75k,desktop,returning,Midwest,40,True,96,2,1,True,False,True,88,2,0,6.0581509619064775,8,0
user_001062,61,50k-75k,mobile,returning,East,23,True,121,7,0,True,False,True,146,8,0,6.329740746018373,-25,-1
user_001063,40,50k-75k,mobile,returning,South,46,True,65,5,1,True,True,True,45,3,0,7.217908468356486,20,2
user_001064,42,50k-75k,desktop,new,West,84,True,79,2,0,True,True,True,72,3,0,8.70642040862798,7,-1
user_001065,74,50k-75k,mobile,returning,East,41,True,90,9,0,True,False,True,74,10,0,7.537723939715609,16,-1
user_001066,47,75k-100k,tablet,returning,East,56,True,55,2,0,False,True,True,76,4,0,7.698886751893316,-21,-2
user_001067,39,30k-50k,mobile,returning,East,81,False,0,0,0,True,True,True,136,2,0,8.97795514000321,-136,-2
user_001068,18,30k-50k,desktop,new,East,93,True,84,2,0,False,True,True,56,3,0,7.235310173538993,28,-1
user_001069,47,75k-100k,desktop,returning,West,39,False,0,0,0,False,False,False,0,0,0,,0,0
user_001070,29,100k-150k,desktop,returning,East,47,True,78,3,0,False,True,True,50,3,0,6.013179556639053,28,0
user_001071,41,30k-50k,mobile,returning,West,57,True,80,5,1,False,True,True,73,2,0,8.083894992031857,7,3
user_001072,62,100k-150k,desktop,returning,South,22,True,155,1,0,False,False,True,146,1,0,6.52510915878305,9,0
user_001073,26,<30k,mobile,returning,South,32,True,124,1,0,False,False,False,0,0,0,,124,1
user_001074,56,50k-75k,mobile,new,West,35,True,133,2,0,False,False,True,123,6,0,5.488137450134103,10,-4
user_001075,42,30k-50k,mobile,returning,South,43,True,71,1,0,True,True,True,35,1,0,9.470299449544921,36,0
user_001076,42,50k-75k,desktop,returning,South,82,False,0,0,0,False,False,True,119,1,0,6.477106620995489,-119,-1
user_001077,26,<30k,tablet,returning,West,84,False,0,0,0,True,True,False,0,0,0,,0,0
user_001078,39,50k-75k,desktop,returning,South,19,True,92,3,0,False,False,True,121,1,0,7.5128089019637505,-29,2
user_001079,30,50k-75k,desktop,returning,East,76,True,88,5,0,False,True,True,63,5,0,7.423194940284869,25,0
user_001080,44,100k-150k,mobile,returning,West,53,True,71,2,0,False,False,True,74,5,0,8.454478195301219,-3,-3
user_001081,29,100k-150k,desktop,returning,East,84,True,113,2,1,False,True,True,113,1,0,8.467315800098456,0,1
user_001082,45,100k-150k,mobile,returning,South,70,False,0,0,0,True,False,True,116,1,0,6.086422929515495,-116,-1
user_001083,44,75k-100k,desktop,new,Midwest,37,True,153,3,0,False,True,True,92,4,0,8.487392496360837,61,-1
user_001084,34,30k-50k,mobile,returning,East,72,True,84,3,1,True,True,True,54,3,0,5.175401214450568,30,0
user_001085,69,50k-75k,mobile,returning,Midwest,35,True,78,1,1,True,False,True,82,1,1,6.247341107292552,-4,0
user_001086,62,30k-50k,desktop,returning,East,58,True,30,2,0,False,False,False,0,0,0,,30,2
user_001087,33,30k-50k,mobile,new,South,70,False,0,0,0,False,False,True,141,1,0,8.038876121516283,-141,-1
user_001088,51,50k-75k,desktop,returning,West,55,True,107,3,0,False,False,True,93,1,0,6.3442177272894344,14,2
user_001089,42,<30k,mobile,returning,Midwest,33,True,105,2,0,False,True,True,83,2,0,5.769237603532837,22,0
user_001090,51,<30k,mobile,returning,East,43,False,0,0,0,True,False,False,0,0,0,,0,0
user_001091,54,50k-75k,mobile,returning,South,71,True,101,6,0,True,True,True,68,6,0,7.049984934455287,33,0
user_001092,37,100k-150k,mobile,returning,South,21,True,140,4,0,False,True,True,122,3,0,6.735290378432541,18,1
user_001093,40,<30k,mobile,new,South,8,False,0,0,0,False,False,False,0,0,0,,0,0
user_001094,49,75k-100k,mobile,returning,Midwest,59,True,127,5,0,True,True,True,136,3,1,7.589879212503732,-9,2
user_001095,33,75k-100k,mobile,returning,West,92,True,83,2,0,True,True,True,81,1,0,8.125197271835594,2,1
user_001096,76,100k-150k,desktop,returning,West,44,True,101,2,0,True,False,True,102,2,0,9.537020408381965,-1,0
user_001097,56,75k-100k,mobile,returning,South,21,True,167,4,0,True,False,True,155,2,0,6.845142229448817,12,2
user_001098,35,50k-75k,desktop,new,Midwest,68,True,135,2,0,False,False,True,147,2,0,8.721424688426547,-12,0
user_001099,43,75k-100k,desktop,returning,West,76,True,58,3,0,True,True,True,51,2,0,9.931747140060272,7,1
user_001100,65,30k-50k,mobile,returning,South,19,True,137,6,0,True,True,True,134,6,0,7.3400345033335554,3,0
user_001101,45,<30k,desktop,returning,South,12,True,158,3,0,False,True,True,134,8,0,8.387390328683574,24,-5
user_001102,19,30k-50k,mobile,returning,South,85,True,52,4,0,True,True,True,40,6,0,7.56232325424788,12,-2
user_001103,25,50k-75k,desktop,returning,East,70,True,134,2,0,False,True,True,98,2,0,8.823033549556614,36,0
user_001104,30,100k-150k,desktop,new,South,74,True,78,3,0,True,True,True,71,3,0,9.048652830760991,7,0
user_001105,36,50k-75k,mobile,returning,West,37,True,30,6,0,False,True,True,20,5,0,8.07239457905687,10,1
user_001106,46,50k-75k,desktop,returning,West,33,True,134,4,1,False,True,True,95,7,0,6.971762245171247,39,-3
user_001107,39,<30k,desktop,returning,Midwest,23,True,110,5,0,False,False,True,100,4,0,6.927671896906014,10,1
user_001108,43,100k-150k,tablet,returning,West,84,True,79,2,0,False,True,True,62,1,0,10.0,17,1
user_001109,39,<30k,mobile,new,East,8,False,0,0,0,True,False,False,0,0,0,,0,0
user_001110,46,75k-100k,desktop,returning,East,34,True,96,2,0,True,True,True,84,1,0,7.130625145078129,12,1
user_001111,50,30k-50k,mobile,returning,South,38,True,108,1,0,False,False,True,103,1,0,7.994854594353239,5,0
user_001112,53,100k-150k,desktop,new,South,31,False,0,0,0,False,True,True,96,1,1,6.950756830268435,-96,-1
user_001113,33,<30k,mobile,returning,East,50,True,150,4,0,True,False,True,152,5,0,8.813192148108621,-2,-1
user_001114,38,75k-100k,mobile,returning,West,41,True,136,7,0,True,False,True,121,6,1,6.944737566228972,15,1
user_001115,42,50k-75k,mobile,new,South,45,True,91,5,0,True,True,True,113,5,0,7.973810289255377,-22,0
user_001116,53,50k-75k,desktop,new,West,81,True,111,2,0,True,True,True,109,1,0,8.846263601549724,2,1
user_001117,45,50k-75k,mobile,new,Midwest,23,True,129,3,1,True,True,True,73,4,0,9.508367460072252,56,-1
user_001118,39,50k-75k,mobile,returning,South,48,True,163,3,0,False,True,True,124,1,1,9.000176259553605,39,2
user_001119,44,<30k,desktop,new,South,16,True,100,7,0,False,False,False,0,0,0,,100,7
user_001120,53,50k-75k,desktop,new,East,45,True,117,2,0,False,False,True,84,3,0,7.5210629747459326,33,-1
user_001121,45,<30k,desktop,returning,East,47,True,51,3,0,True,False,True,48,3,0,6.628788383228969,3,0
user_001122,46,30k-50k,mobile,new,South,40,True,119,1,0,True,False,True,83,1,1,8.76411982309994,36,0
user_001123,73,50k-75k,desktop,new,East,32,True,162,3,1,False,True,True,140,3,1,8.050418733653169,22,0
user_001124,49,<30k,mobile,new,Midwest,15,True,220,3,1,False,False,False,0,0,0,,220,3
user_001125,26,30k-50k,desktop,returning,East,59,False,0,0,0,False,False,True,118,2,0,6.948999480884876,-118,-2
user_001126,42,<30k,mobile,returning,East,48,True,107,1,0,False,False,True,89,2,0,7.567585449949076,18,-1
user_001127,20,75k-100k,desktop,returning,East,32,True,95,6,0,True,True,True,100,8,0,8.821908899342565,-5,-2
user_001128,80,75k-100k,desktop,new,West,41,True,106,1,0,False,False,True,103,2,0,8.276804586070806,3,-1
user_001129,49,30k-50k,desktop,returning,South,41,True,88,1,1,False,True,True,79,1,1,8.637628881428302,9,0
user_001130,18,75k-100k,desktop,returning,South,59,True,63,2,0,True,True,True,63,3,0,8.167565911947577,0,-1
user_001131,61,50k-75k,desktop,new,South,51,True,146,3,0,False,True,True,103,1,0,7.846492922461945,43,2
user_001132,18,<30k,desktop,new,West,80,True,82,3,0,True,True,True,50,5,0,6.931142904723842,32,-2
user_001133,45,50k-75k,mobile,returning,West,64,True,30,2,0,False,True,True,20,3,0,9.2754423217134,10,-1
user_001134,36,75k-100k,mobile,new,South,19,True,182,6,0,False,False,True,144,11,0,7.75990432281505,38,-5
user_001135,41,75k-100k,mobile,returning,East,48,True,83,3,0,True,True,True,102,1,0,8.676162813124627,-19,2
user_001136,47,30k-50k,desktop,returning,West,53,True,94,3,0,False,True,True,73,4,0,9.662778083177693,21,-1
user_001137,50,50k-75k,mobile,returning,West,42,True,90,1,1,False,False,True,67,1,1,8.396963737664127,23,0
user_001138,80,50k-75k,mobile,new,South,15,False,0,0,0,True,False,True,115,1,0,7.891980702042771,-115,-1
user_001139,54,30k-50k,mobile,new,Midwest,30,True,129,4,0,True,True,True,111,4,0,7.1087930830437,18,0
user_001140,40,50k-75k,mobile,returning,East,40,True,64,1,0,False,True,True,23,1,0,7.610137379013944,41,0
user_001141,36,75k-100k,desktop,new,East,41,True,140,2,1,False,True,True,128,1,0,10.0,12,1
user_001142,35,<30k,desktop,new,West,44,False,0,0,0,False,False,True,130,1,1,4.88223429776099,-130,-1
user_001143,64,75k-100k,mobile,new,Midwest,15,True,225,4,0,False,True,True,193,6,0,9.04168685477908,32,-2
user_001144,18,50k-75k,mobile,returning,West,100,True,91,2,0,True,True,True,68,1,1,9.49048858689324,23,1
user_001145,22,30k-50k,desktop,returning,South,90,True,47,3,0,False,True,True,60,3,1,7.815806086163261,-13,0
user_001146,41,30k-50k,mobile,returning,East,60,True,105,4,0,True,False,True,62,2,0,7.408968300150303,43,2
user_001147,21,50k-75k,mobile,returning,Midwest,81,True,32,1,0,True,True,True,37,2,0,9.56353851604871,-5,-1
user_001148,43,100k-150k,mobile,returning,East,27,True,137,6,0,True,True,True,104,5,0,8.946734761783071,33,1
user_001149,31,75k-100k,mobile,returning,East,64,True,121,1,0,True,True,True,82,3,0,6.80198092984796,39,-2
user_001150,52,50k-75k,desktop,returning,Midwest,43,True,110,7,0,False,False,True,140,10,0,8.886002936238674,-30,-3
user_001151,56,50k-75k,desktop,new,East,6,True,161,3,0,True,False,True,155,3,0,6.798492555823707,6,0
user_001152,54,100k-150k,mobile,new,South,43,True,124,2,0,False,True,True,89,1,0,10.0,35,1
user_001153,54,50k-75k,desktop,new,West,61,True,142,5,0,True,False,True,158,9,0,6.616105810803667,-16,-4
user_001154,62,50k-75k,mobile,returning,South,36,True,63,3,0,True,True,True,30,2,0,8.023599883980332,33,1
user_001155,46,30k-50k,mobile,returning,West,25,True,104,3,0,True,True,True,56,1,0,8.45945446659369,48,2
user_001156,63,50k-75k,desktop,returning,Midwest,63,True,99,4,0,True,True,True,48,6,0,6.9066974144991855,51,-2
user_001157,45,75k-100k,mobile,new,West,36,False,0,0,0,True,True,True,104,1,0,5.205517574906363,-104,-1
user_001158,19,100k-150k,desktop,returning,East,62,False,0,0,0,False,False,True,111,2,1,8.581295586402454,-111,-2
user_001159,34,30k-50k,mobile,returning,South,77,True,92,2,0,False,True,True,86,2,0,8.724443379906011,6,0
user_001160,38,100k-150k,desktop,returning,East,95,True,33,1,0,True,True,True,20,1,0,6.293243871381261,13,0
user_001161,65,75k-100k,mobile,new,East,36,True,146,2,0,False,False,True,172,1,0,6.00077634642015,-26,1
user_001162,59,75k-100k,desktop,new,Midwest,30,False,0,0,0,True,False,True,113,2,0,7.139205349466966,-113,-2
user_001163,55,100k-150k,mobile,returning,West,42,True,83,4,0,False,True,True,39,2,0,4.930107703569567,44,2
user_001164,69,<30k,desktop,new,West,44,False,0,0,0,False,False,True,124,1,0,8.33783438690152,-124,-1
user_001165,74,100k-150k,desktop,returning,East,55,True,90,1,1,True,True,True,68,1,0,6.0834473387028565,22,0
user_001166,51,50k-75k,desktop,returning,West,54,True,139,1,1,False,True,True,92,3,0,6.407206981136267,47,-2
user_001167,30,75k-100k,desktop,new,South,72,True,127,5,0,True,True,True,87,4,0,5.74395882147355,40,1
user_001168,52,50k-75k,desktop,new,Midwest,27,True,141,5,1,False,False,True,142,5,0,5.577585004005949,-1,0
user_001169,41,30k-50k,mobile,new,West,72,True,98,2,0,False,True,True,86,1,0,6.5997588429138965,12,1
user_001170,44,30k-50k,mobile,new,Midwest,51,True,143,3,0,True,True,False,0,0,0,,143,3
user_001171,77,100k-150k,desktop,new,Midwest,47,True,81,2,0,True,True,True,41,1,0,7.202155534657035,40,1
user_001172,80,100k-150k,mobile,returning,South,40,True,104,3,0,False,False,True,134,4,0,4.598268260924413,-30,-1
user_001173,61,30k-50k,tablet,returning,West,22,True,117,3,0,False,False,True,127,1,0,6.531809973601056,-10,2
user_001174,20,<30k,mobile,returning,East,53,True,145,2,0,True,True,True,53,2,0,7.917053307507029,92,0
user_001175,57,30k-50k,desktop,returning,West,19,True,122,2,0,False,False,True,131,2,0,7.807419865752119,-9,0
user_001176,57,<30k,mobile,new,South,32,False,0,0,0,True,True,True,96,1,0,9.570622091033906,-96,-1
user_001177,46,75k-100k,desktop,returning,Midwest,38,True,104,2,0,True,True,True,69,1,0,6.7311519901727115,35,1
user_001178,65,75k-100k,desktop,returning,East,50,True,53,3,0,False,False,True,20,3,0,5.618473317918673,33,0
user_001179,46,100k-150k,mobile,returning,Midwest,75,True,32,2,0,False,True,False,0,0,0,,32,2
user_001180,45,50k-75k,desktop,returning,South,55,True,92,1,0,False,False,True,67,1,0,6.666681006642144,25,0
user_001181,32,75k-100k,desktop,new,South,81,True,85,5,1,False,True,True,71,5,0,7.960003881158506,14,0
user_001182,53,30k-50k,desktop,new,South,22,True,129,4,0,False,False,False,0,0,0,,129,4
user_001183,25,100k-150k,desktop,returning,Midwest,66,True,84,1,0,False,True,True,124,1,0,7.893676064953274,-40,0
user_001184,68,>150k,desktop,returning,East,54,True,118,3,1,False,True,True,111,1,0,7.425224448863828,7,2
user_001185,40,50k-75k,desktop,new,East,26,True,172,7,0,True,False,True,166,6,1,6.198914798236548,6,1
user_001186,48,<30k,tablet,new,South,34,False,0,0,0,False,True,True,81,1,0,6.67163645311488,-81,-1
user_001187,42,50k-75k,desktop,new,Midwest,31,True,63,4,0,False,True,False,0,0,0,,63,4
user_001188,48,100k-150k,desktop,returning,West,64,True,105,3,0,True,True,True,47,1,0,10.0,58,2
user_001189,27,100k-150k,mobile,returning,West,100,True,66,4,1,False,True,True,56,1,0,6.5863876368673635,10,3
user_001190,53,75k-100k,mobile,returning,Midwest,34,True,85,7,0,False,True,True,32,2,0,6.783163321280197,53,5
user_001191,41,30k-50k,desktop,new,Midwest,29,True,157,3,0,False,False,True,160,3,1,6.163798552135838,-3,0
user_001192,43,30k-50k,desktop,new,South,47,True,140,1,0,True,False,True,128,1,0,8.5687845683403,12,0
user_001193,62,75k-100k,mobile,returning,Midwest,52,True,81,1,0,True,False,True,80,1,0,4.846376893428311,1,0
user_001194,73,30k-50k,mobile,new,Midwest,30,True,149,2,0,False,False,True,151,2,0,4.953565263347066,-2,0
user_001195,61,30k-50k,mobile,new,West,36,True,145,7,0,False,False,True,149,8,0,8.398431741701101,-4,-1
user_001196,44,100k-150k,desktop,returning,West,85,True,68,3,0,True,True,True,44,1,0,10.0,24,2
user_001197,22,30k-50k,desktop,new,Midwest,68,False,0,0,0,True,True,False,0,0,0,,0,0
user_001198,33,50k-75k,desktop,returning,West,66,True,91,2,2,True,True,False,0,0,0,,91,2
user_001199,55,<30k,mobile,returning,East,46,True,77,2,0,True,False,True,79,6,0,6.581989019313018,-2,-4
user_001200,42,30k-50k,mobile,new,West,46,True,163,5,0,True,False,True,156,2,0,9.527124765217945,7,3
user_001201,47,30k-50k,desktop,new,South,58,True,120,2,0,False,False,False,0,0,0,,120,2
user_001202,62,50k-75k,mobile,returning,Midwest,27,True,122,3,0,True,False,False,0,0,0,,122,3
user_001203,39,100k-150k,mobile,returning,West,55,True,102,1,0,True,True,True,57,1,0,7.047308915659505,45,0
user_001204,68,30k-50k,desktop,new,East,48,True,105,3,0,False,False,True,111,3,0,6.995527195206883,-6,0
user_001205,44,50k-75k,desktop,returning,East,38,False,0,0,0,True,False,True,117,1,0,10.0,-117,-1
user_001206,61,100k-150k,desktop,returning,East,33,True,76,2,0,True,True,True,115,5,0,8.91231207663619,-39,-3
user_001207,23,75k-100k,mobile,returning,East,62,True,152,2,0,True,True,True,122,2,0,7.461982090849113,30,0
user_001208,36,<30k,mobile,new,West,33,False,0,0,0,False,True,False,0,0,0,,0,0
user_001209,79,50k-75k,mobile,returning,West,73,True,30,1,0,False,True,True,20,1,0,8.193420116857627,10,0
user_001210,44,75k-100k,mobile,returning,West,50,True,59,4,0,True,True,True,41,9,0,8.202678797888563,18,-5
user_001211,37,50k-75k,desktop,new,South,25,True,174,5,0,False,False,True,194,7,0,6.3881552738737755,-20,-2
user_001212,41,30k-50k,mobile,new,East,70,True,122,4,0,True,True,True,94,4,0,9.174692529847416,28,0
user_001213,52,50k-75k,desktop,returning,East,45,True,134,1,0,False,False,True,137,1,0,6.913904652396012,-3,0
user_001214,49,50k-75k,mobile,new,South,39,True,113,7,0,False,False,True,139,10,0,6.785182498182511,-26,-3
user_001215,35,50k-75k,desktop,returning,East,50,True,33,6,0,True,True,True,37,3,0,8.541802249167818,-4,3
user_001216,41,<30k,mobile,returning,West,35,True,144,6,0,True,True,True,129,5,0,8.059520397632422,15,1
user_001217,35,75k-100k,desktop,new,West,67,True,150,1,0,False,False,True,158,2,0,8.223695364475079,-8,-1
user_001218,36,100k-150k,desktop,returning,East,59,True,51,1,0,True,False,True,67,1,2,8.337956881691408,-16,0
user_001219,65,50k-75k,desktop,returning,East,14,True,106,6,0,False,False,True,117,5,0,7.977249922427404,-11,1
user_001220,66,100k-150k,mobile,returning,West,71,False,0,0,0,True,True,True,74,2,0,9.869358530573418,-74,-2
user_001221,35,100k-150k,mobile,returning,West,77,True,75,7,0,True,True,True,38,5,0,7.405361634073238,37,2
user_001222,39,100k-150k,desktop,returning,South,71,False,0,0,0,True,True,True,122,3,0,7.10596138510089,-122,-3
user_001223,58,<30k,desktop,returning,West,32,True,80,5,0,True,True,True,67,5,0,8.437965851899335,13,0
user_001224,26,>150k,desktop,new,South,80,True,96,4,0,True,True,True,59,5,0,7.553855184825579,37,-1
user_001225,36,100k-150k,desktop,returning,Midwest,50,True,61,3,0,False,True,True,25,1,0,8.332129655206232,36,2
user_001226,41,75k-100k,mobile,returning,South,67,True,72,3,0,False,True,True,20,2,0,8.247335702360564,52,1
user_001227,31,75k-100k,desktop,returning,West,62,True,79,1,0,False,True,True,59,1,0,5.899453445905747,20,0
user_001228,59,<30k,mobile,new,East,41,True,118,5,0,False,False,True,134,6,0,8.712403798732764,-16,-1
user_001229,32,<30k,desktop,returning,East,72,False,0,0,0,False,True,True,88,1,1,9.810353792042951,-88,-1
user_001230,26,75k-100k,mobile,returning,East,79,False,0,0,0,False,True,True,94,1,0,6.120775061491323,-94,-1
user_001231,59,75k-100k,desktop,returning,Midwest,28,True,153,5,0,False,False,True,148,5,0,7.078351717338751,5,0
user_001232,37,50k-75k,desktop,returning,East,28,True,111,2,2,True,False,False,0,0,0,,111,2
user_001233,64,100k-150k,mobile,returning,South,24,True,134,3,0,True,False,True,133,1,0,6.828885703807162,1,2
user_001234,55,30k-50k,mobile,returning,West,53,True,96,3,0,False,True,True,50,2,0,8.2858907718147,46,1
user_001235,31,30k-50k,tablet,returning,East,68,True,50,2,0,True,True,True,30,5,0,6.740015740632725,20,-3
user_001236,42,75k-100k,mobile,returning,West,57,True,81,3,0,False,False,True,81,1,1,6.545648731555152,0,2
user_001237,27,>150k,desktop,returning,East,74,True,72,3,0,False,True,True,69,5,0,9.514643101713617,3,-2
user_001238,18,50k-75k,desktop,returning,East,66,True,39,4,1,False,False,False,0,0,0,,39,4
user_001239,58,50k-75k,desktop,returning,East,51,True,39,3,0,False,False,True,20,3,0,8.788113357192453,19,0
user_001240,41,100k-150k,mobile,returning,Midwest,25,True,141,5,0,True,False,True,105,4,0,8.050014456739353,36,1
user_001241,61,30k-50k,mobile,new,West,64,True,133,1,0,True,True,True,91,1,0,7.172267487667634,42,0
user_001242,42,>150k,desktop,new,South,76,True,133,1,0,False,True,True,108,1,0,6.708991902121981,25,0
user_001243,75,50k-75k,tablet,returning,South,8,True,120,4,0,False,True,True,96,4,1,10.0,24,0
user_001244,51,100k-150k,tablet,returning,West,94,True,75,3,0,True,True,True,20,2,0,7.921020674502948,55,1
user_001245,18,30k-50k,desktop,returning,South,64,True,30,2,0,True,True,True,26,3,0,8.998605400935155,4,-1
user_001246,31,>150k,desktop,returning,East,97,True,88,2,0,False,True,True,75,1,0,7.659789376043111,13,1
user_001247,49,30k-50k,desktop,new,Midwest,32,True,79,3,0,True,False,True,83,1,0,7.763758430162554,-4,2
user_001248,39,30k-50k,mobile,new,South,52,True,169,2,0,False,True,True,103,1,0,5.88003987025244,66,1
user_001249,38,75k-100k,desktop,returning,East,52,True,94,4,0,False,True,True,57,2,0,8.814544242065926,37,2
user_001250,50,50k-75k,tablet,returning,East,39,True,44,4,0,True,True,True,20,4,0,5.4918517794382415,24,0
user_001251,52,75k-100k,mobile,returning,West,56,True,62,7,0,False,True,False,0,0,0,,62,7
user_001252,36,30k-50k,mobile,returning,South,52,True,91,3,0,True,True,True,91,1,0,7.2147385555354555,0,2
user_001253,35,75k-100k,mobile,returning,South,5,True,167,5,0,False,True,True,129,1,0,6.933559632701375,38,4
user_001254,24,50k-75k,mobile,new,Midwest,60,True,147,3,0,False,True,True,95,2,0,8.716692157547175,52,1
user_001255,24,100k-150k,desktop,returning,East,98,True,55,2,0,False,True,True,62,1,0,8.509496991223624,-7,1
user_001256,33,30k-50k,desktop,new,West,73,True,64,3,2,False,True,True,50,3,1,7.745205579132226,14,0
user_001257,40,30k-50k,desktop,returning,East,64,True,97,4,0,True,True,True,70,1,0,8.253043111964947,27,3
user_001258,27,30k-50k,mobile,returning,East,84,True,84,2,0,False,True,True,62,1,0,8.458474175001173,22,1
user_001259,42,50k-75k,mobile,new,East,58,True,144,6,0,False,False,True,156,8,0,6.382372718024381,-12,-2
user_001260,32,75k-100k,mobile,new,West,72,True,124,2,0,True,True,True,78,1,0,10.0,46,1
user_001261,46,30k-50k,desktop,new,Midwest,9,True,160,3,2,False,False,True,166,2,0,7.465115863926132,-6,1
user_001262,41,50k-75k,mobile,new,Midwest,49,True,87,4,0,True,False,True,109,1,0,7.741199653469192,-22,3
user_001263,31,<30k,desktop,new,Midwest,50,False,0,0,0,False,True,True,90,1,0,9.06899975155413,-90,-1
user_001264,51,50k-75k,desktop,new,East,69,True,129,1,0,True,True,True,122,5,0,7.048666094148877,7,-4
user_001265,29,<30k,desktop,returning,South,60,True,43,1,0,True,True,True,20,1,0,8.761806836507176,23,0
user_001266,63,75k-100k,desktop,new,East,16,False,0,0,0,False,False,True,123,1,0,6.995799787432705,-123,-1
user_001267,60,30k-50k,desktop,returning,South,26,True,132,5,0,False,False,True,136,2,1,9.246294756160939,-4,3
user_001268,26,30k-50k,tablet,returning,South,86,True,71,1,0,True,False,True,91,1,0,6.8462104725196316,-20,0
user_001269,47,75k-100k,desktop,new,West,49,True,64,2,1,True,False,True,71,2,0,8.478944372805424,-7,0
user_001270,39,50k-75k,desktop,returning,East,48,True,152,2,1,False,False,True,128,3,0,4.996864199537333,24,-1
user_001271,61,30k-50k,tablet,returning,East,39,True,119,3,0,False,False,True,139,1,0,7.191562068192125,-20,2
user_001272,53,50k-75k,mobile,new,East,56,True,102,5,0,True,True,True,99,6,0,7.518850696484102,3,-1
user_001273,34,75k-100k,desktop,new,South,77,True,76,3,0,True,True,False,0,0,0,,76,3
user_001274,37,75k-100k,mobile,new,West,44,True,111,5,0,False,True,True,95,2,0,6.294766170049099,16,3
user_001275,46,50k-75k,desktop,returning,East,44,True,69,2,1,False,False,True,89,2,0,6.330524454693494,-20,0
user_001276,44,50k-75k,mobile,returning,Midwest,62,True,89,3,0,False,True,True,89,2,0,9.528311704528312,0,1
user_001277,43,<30k,desktop,new,East,56,False,0,0,0,True,True,True,92,1,0,6.723043511501993,-92,-1
user_001278,42,75k-100k,desktop,returning,East,72,True,65,3,0,False,True,False,0,0,0,,65,3
user_001279,48,100k-150k,desktop,returning,South,79,True,56,1,0,False,True,True,48,1,0,7.795464056710106,8,0
user_001280,77,30k-50k,desktop,returning,South,22,False,0,0,0,True,True,True,132,1,0,6.742221856633607,-132,-1
user_001281,35,100k-150k,mobile,returning,East,49,True,30,3,0,True,True,True,20,3,0,8.602864309027979,10,0
user_001282,40,30k-50k,desktop,new,West,63,True,105,4,0,False,True,True,108,1,0,10.0,-3,3
user_001283,66,30k-50k,desktop,returning,South,26,False,0,0,0,False,False,True,156,2,0,7.068300110073419,-156,-2
user_001284,67,75k-100k,mobile,new,East,25,True,134,4,2,False,True,True,98,4,0,6.578897227447009,36,0
user_001285,18,50k-75k,mobile,new,West,100,False,0,0,0,False,True,False,0,0,0,,0,0
user_001286,44,50k-75k,mobile,returning,South,19,True,136,5,0,False,False,True,136,10,0,6.675055760146954,0,-5
user_001287,33,>150k,mobile,returning,West,98,True,119,1,1,False,True,True,106,1,0,8.524058386386317,13,0
user_001288,26,>150k,desktop,returning,Midwest,100,True,64,3,0,False,True,True,82,3,0,8.773958224211759,-18,0
user_001289,61,100k-150k,tablet,returning,South,80,True,148,3,0,True,True,True,117,2,0,8.333591690934435,31,1
user_001290,18,50k-75k,mobile,new,West,82,True,109,3,0,False,True,True,84,2,1,8.450303377739559,25,1
user_001291,50,50k-75k,tablet,returning,East,71,True,87,2,0,False,True,True,78,1,1,9.119352363427023,9,1
user_001292,39,75k-100k,mobile,returning,East,38,True,114,3,0,False,True,True,131,3,0,6.473472657958277,-17,0
user_001293,50,<30k,tablet,new,West,30,False,0,0,0,False,False,True,129,1,0,7.248921622920216,-129,-1
user_001294,39,<30k,desktop,returning,West,49,True,68,3,0,False,False,True,66,4,0,8.064402038196313,2,-1
user_001295,30,75k-100k,mobile,new,West,100,True,115,2,1,True,True,True,102,2,0,5.233854254517823,13,0
user_001296,48,30k-50k,desktop,returning,South,39,True,97,2,0,False,True,False,0,0,0,,97,2
user_001297,25,75k-100k,mobile,returning,East,93,True,78,2,1,False,True,True,56,3,1,5.252773373726306,22,-1
user_001298,57,>150k,mobile,returning,South,35,True,84,7,0,True,True,True,66,2,0,6.422415394358434,18,5
user_001299,34,>150k,mobile,returning,East,71,True,30,5,0,True,True,True,20,4,0,7.018269788003892,10,1
user_001300,48,50k-75k,mobile,returning,Midwest,35,False,0,0,0,True,True,True,83,1,0,7.5943028788129565,-83,-1
user_001301,59,75k-100k,tablet,new,West,56,True,93,3,0,False,False,True,81,2,0,6.942445116508472,12,1
user_001302,40,<30k,desktop,new,West,54,True,79,3,0,True,True,True,56,2,0,8.1224478510043,23,1
user_001303,45,50k-75k,desktop,new,South,47,True,94,1,0,False,False,True,83,2,0,8.633431730008997,11,-1
user_001304,52,30k-50k,mobile,returning,East,39,True,84,3,0,True,False,True,79,2,0,9.149418973807089,5,1
user_001305,52,<30k,desktop,returning,East,23,False,0,0,0,True,False,True,119,3,0,7.351193216586697,-119,-3
user_001306,62,75k-100k,desktop,new,East,32,True,97,2,0,False,True,True,62,1,0,8.314639772347318,35,1
user_001307,38,50k-75k,mobile,new,East,50,False,0,0,0,False,True,True,85,1,0,8.467970172699967,-85,-1
user_001308,66,50k-75k,desktop,returning,Midwest,34,True,129,4,0,True,True,True,127,6,0,10.0,2,-2
user_001309,60,50k-75k,mobile,new,South,28,True,96,2,0,True,False,True,65,2,0,6.4763268981441335,31,0
user_001310,50,50k-75k,desktop,returning,Midwest,7,False,0,0,0,False,False,True,96,1,0,8.160702780538516,-96,-1
user_001311,29,100k-150k,mobile,returning,West,100,False,0,0,0,False,True,True,102,2,0,8.506126365594476,-102,-2
user_001312,54,50k-75k,desktop,new,Midwest,52,True,130,3,0,False,True,True,130,4,0,8.00470470500206,0,-1
user_001313,80,30k-50k,desktop,returning,South,14,True,152,3,0,False,False,True,180,3,0,7.040915465032988,-28,0
user_001314,21,100k-150k,desktop,returning,East,62,True,71,2,0,False,True,True,68,3,0,10.0,3,-1
user_001315,30,30k-50k,mobile,returning,West,87,True,30,1,0,False,True,True,30,2,0,9.485489591803212,0,-1
user_001316,41,30k-50k,mobile,new,South,50,True,126,4,0,True,True,True,136,1,0,8.139780648752696,-10,3
user_001317,75,50k-75k,desktop,returning,South,32,True,107,6,0,True,True,True,106,3,0,10.0,1,3
user_001318,49,100k-150k,mobile,returning,South,85,True,48,3,0,True,True,True,20,1,0,6.276614865469577,28,2
user_001319,69,50k-75k,mobile,returning,Midwest,20,True,124,10,0,False,False,True,133,11,0,7.693750132579429,-9,-1
user_001320,28,100k-150k,mobile,returning,East,97,True,90,3,0,True,True,True,76,2,0,10.0,14,1
user_001321,63,75k-100k,desktop,returning,South,30,True,98,5,0,False,True,True,55,7,0,8.16877773706814,43,-2
user_001322,59,<30k,desktop,new,South,3,True,103,3,0,False,False,True,166,5,0,8.170887965392932,-63,-2
user_001323,58,75k-100k,mobile,new,East,25,True,169,5,0,True,True,True,138,5,0,8.183928407868995,31,0
user_001324,40,100k-150k,desktop,returning,Midwest,78,True,64,4,0,True,True,True,58,1,0,10.0,6,3
user_001325,32,30k-50k,mobile,returning,East,68,True,128,6,0,True,True,True,78,2,0,9.450562158426706,50,4
user_001326,51,75k-100k,mobile,new,East,28,True,164,1,3,True,True,True,124,1,0,7.94893166183101,40,0
user_001327,18,50k-75k,mobile,returning,West,57,True,43,1,1,True,True,True,42,1,0,8.37978945008336,1,0
user_001328,31,<30k,desktop,returning,Midwest,63,False,0,0,0,False,True,True,116,1,1,10.0,-116,-1
user_001329,22,30k-50k,desktop,returning,West,79,True,138,3,0,True,True,True,95,3,0,7.651780085696281,43,0
user_001330,27,<30k,mobile,new,Midwest,56,True,114,5,0,False,False,True,115,4,1,6.098864146899893,-1,1
user_001331,58,<30k,desktop,new,Midwest,0,False,0,0,0,False,True,True,104,1,0,9.350147779159595,-104,-1
user_001332,73,30k-50k,mobile,new,West,32,True,131,2,1,False,False,True,136,3,1,6.808003293229965,-5,-1
user_001333,46,30k-50k,mobile,returning,Midwest,52,False,0,0,0,False,True,True,98,1,0,7.436380328874291,-98,-1
user_001334,28,50k-75k,desktop,returning,South,53,True,40,3,0,True,True,True,20,3,0,8.371941399535551,20,0
user_001335,47,30k-50k,desktop,returning,East,45,True,65,1,0,False,True,True,59,1,0,7.866925428481477,6,0
user_001336,74,100k-150k,mobile,returning,East,53,True,105,2,1,False,False,True,103,1,0,7.320303945310819,2,1
user_001337,37,100k-150k,desktop,new,South,40,True,145,2,0,False,False,False,0,0,0,,145,2
user_001338,24,100k-150k,desktop,returning,West,81,True,56,4,0,False,False,True,43,3,0,7.107263261981394,13,1
user_001339,47,30k-50k,desktop,new,East,49,True,86,2,0,False,False,True,91,1,0,9.061398210039103,-5,1
user_001340,22,50k-75k,mobile,new,Midwest,92,True,122,4,0,False,True,True,81,1,0,9.773923824073576,41,3
user_001341,26,50k-75k,mobile,returning,East,76,True,96,1,0,True,True,True,79,1,0,7.629414170334191,17,0
user_001342,34,30k-50k,mobile,returning,South,48,True,111,3,0,True,True,True,76,2,0,9.278147811081876,35,1
user_001343,59,30k-50k,desktop,new,Midwest,30,True,107,6,0,False,False,True,94,9,0,4.7647778991615635,13,-3
user_001344,27,30k-50k,desktop,returning,West,74,True,86,1,0,True,True,True,82,1,0,7.882533438000285,4,0
user_001345,34,30k-50k,mobile,returning,East,87,True,42,2,0,True,True,True,45,2,0,6.37078308499623,-3,0
user_001346,28,<30k,desktop,new,Midwest,93,False,0,0,0,True,True,True,88,1,0,7.652038300048655,-88,-1
user_001347,51,50k-75k,desktop,new,Midwest,34,True,85,2,0,True,True,True,46,1,0,6.8798231957488385,39,1
user_001348,43,50k-75k,mobile,new,East,33,True,171,7,0,False,False,True,188,9,1,6.0473088823978856,-17,-2
user_001349,58,75k-100k,mobile,returning,South,37,True,62,3,0,False,True,True,59,1,1,6.753223404329187,3,2
user_001350,38,50k-75k,desktop,new,West,40,True,153,2,0,False,True,True,155,1,0,8.231034109544911,-2,1
user_001351,18,100k-150k,mobile,returning,Midwest,96,True,30,3,0,True,True,True,20,4,0,8.662427243907777,10,-1
user_001352,39,50k-75k,mobile,new,South,55,True,172,1,1,False,False,True,181,1,0,7.43594802974568,-9,0
user_001353,30,75k-100k,mobile,returning,East,43,True,111,4,0,True,True,True,85,2,0,7.901870652502788,26,2
user_001354,80,75k-100k,desktop,returning,West,46,True,58,3,0,True,False,True,44,4,0,5.137196895681165,14,-1
user_001355,52,100k-150k,mobile,returning,South,54,True,115,3,0,True,True,True,99,4,0,7.06296821072019,16,-1
user_001356,36,<30k,desktop,returning,Midwest,33,True,104,6,0,False,True,True,95,5,0,8.7302611210713,9,1
user_001357,29,100k-150k,desktop,new,Midwest,79,True,66,2,0,False,True,True,38,1,0,8.714727406669304,28,1
user_001358,65,30k-50k,mobile,returning,Midwest,30,True,77,2,0,False,True,True,72,1,0,8.56721827374199,5,1
user_001359,68,100k-150k,desktop,new,Midwest,15,True,168,5,0,True,True,True,103,6,0,9.360908471620695,65,-1
user_001360,40,75k-100k,mobile,returning,West,49,True,77,2,0,True,True,True,46,2,1,7.121379763606086,31,0
user_001361,44,50k-75k,mobile,returning,East,49,True,95,2,0,False,True,True,88,2,0,7.505807117597815,7,0
user_001362,35,100k-150k,desktop,returning,Midwest,55,True,96,3,0,False,False,True,77,2,1,6.552200692861695,19,1
user_001363,56,30k-50k,desktop,returning,East,8,True,113,6,0,False,False,True,123,7,1,6.721819956850056,-10,-1
user_001364,55,<30k,desktop,returning,South,46,True,71,2,1,False,True,True,88,2,0,9.247158872706606,-17,0
user_001365,49,75k-100k,desktop,returning,Midwest,45,True,69,1,0,False,True,True,51,1,0,7.56796630225434,18,0
user_001366,44,75k-100k,desktop,returning,West,47,True,70,1,0,True,True,False,0,0,0,,70,1
user_001367,36,50k-75k,desktop,returning,Midwest,45,True,42,1,0,False,True,True,37,1,0,5.623199636706372,5,0
user_001368,27,75k-100k,desktop,new,Midwest,69,True,79,2,0,False,True,True,70,1,0,10.0,9,1
user_001369,52,<30k,tablet,returning,West,35,True,45,4,0,True,True,True,20,3,1,10.0,25,1
user_001370,21,75k-100k,desktop,new,South,51,False,0,0,0,True,True,True,44,2,0,7.722631610985833,-44,-2
user_001371,56,50k-75k,mobile,returning,South,23,False,0,0,0,False,False,True,112,1,0,5.053756414566724,-112,-1
user_001372,56,75k-100k,desktop,new,Midwest,21,True,167,3,1,False,False,True,176,2,0,7.504635085237806,-9,1
user_001373,59,<30k,desktop,new,East,30,True,30,6,0,False,True,True,20,2,0,7.653365205842116,10,4
user_001374,40,75k-100k,desktop,new,East,49,True,94,4,0,False,True,True,38,4,0,8.478640695853688,56,0
user_001375,34,50k-75k,desktop,returning,Midwest,66,True,100,1,0,False,True,True,88,1,0,9.266737463404658,12,0
user_001376,69,<30k,desktop,new,West,3,True,130,4,0,False,False,True,130,4,0,5.463160119246838,0,0
user_001377,55,30k-50k,desktop,returning,East,68,False,0,0,0,True,False,True,105,1,0,7.2683244399194145,-105,-1
user_001378,53,75k-100k,desktop,new,Midwest,42,True,123,8,1,True,False,False,0,0,0,,123,8
user_001379,40,100k-150k,desktop,new,West,43,True,161,1,1,True,True,True,167,1,0,8.412455238265379,-6,0
user_001380,45,30k-50k,desktop,new,South,57,True,112,6,0,True,True,True,84,3,1,4.838591427443506,28,3
user_001381,55,75k-100k,mobile,returning,East,24,True,123,4,0,False,False,True,83,5,0,8.031138381760433,40,-1
user_001382,41,50k-75k,desktop,new,East,48,False,0,0,0,False,False,True,129,1,0,5.370564840532578,-129,-1
user_001383,54,<30k,desktop,new,Midwest,29,True,179,3,0,True,False,False,0,0,0,,179,3
user_001384,30,50k-75k,mobile,returning,East,72,True,144,1,1,True,True,True,127,2,0,10.0,17,-1
user_001385,60,>150k,mobile,new,Midwest,38,True,167,5,0,False,True,True,146,1,0,8.691379167118312,21,4
user_001386,32,50k-75k,desktop,new,South,75,False,0,0,0,False,True,True,87,1,0,6.442272587227121,-87,-1
user_001387,37,<30k,mobile,returning,East,39,True,140,4,0,False,True,True,122,5,0,8.225522169954848,18,-1
user_001388,47,50k-75k,desktop,returning,East,69,True,90,1,1,False,True,True,77,1,0,7.007303293771086,13,0
user_001389,39,<30k,mobile,returning,South,42,True,95,4,0,True,True,True,97,1,0,8.25233044829265,-2,3
user_001390,37,30k-50k,mobile,returning,South,65,True,123,3,0,True,True,True,102,1,0,6.87254402712681,21,2
user_001391,49,50k-75k,desktop,new,East,57,True,143,4,0,True,True,True,112,1,1,7.1644875823367276,31,3
user_001392,55,50k-75k,desktop,returning,Midwest,56,True,48,1,0,True,True,True,21,2,0,5.854254354534373,27,-1
user_001393,62,75k-100k,mobile,new,East,23,True,182,2,0,False,False,True,211,1,0,6.68255997488696,-29,1
user_001394,53,30k-50k,mobile,returning,South,24,True,95,4,2,True,True,True,76,3,1,7.426988672979309,19,1
user_001395,61,50k-75k,mobile,returning,Midwest,30,True,58,4,1,True,True,True,50,7,0,10.0,8,-3
user_001396,65,30k-50k,mobile,returning,East,40,True,127,3,0,False,True,True,122,2,0,6.770276027439592,5,1
user_001397,49,30k-50k,desktop,new,East,44,True,154,4,2,False,False,True,157,7,0,8.26735832026174,-3,-3
user_001398,18,30k-50k,desktop,returning,East,100,True,85,1,0,True,True,False,0,0,0,,85,1
user_001399,43,30k-50k,desktop,returning,South,59,True,134,4,0,False,True,True,121,5,0,7.749571978891851,13,-1
user_001400,71,75k-100k,desktop,returning,South,7,True,193,3,1,False,False,True,168,1,0,7.786260818874688,25,2
user_001401,18,75k-100k,tablet,new,Midwest,67,True,107,1,0,True,True,True,69,1,0,4.698821043797357,38,0
user_001402,80,75k-100k,desktop,returning,East,29,True,136,6,0,False,False,True,140,4,0,6.503449591148016,-4,2
user_001403,36,50k-75k,mobile,returning,East,73,True,94,2,0,True,True,True,62,1,0,9.035908371305563,32,1
user_001404,41,50k-75k,mobile,returning,East,96,True,30,4,0,True,True,True,45,3,0,9.404611995723588,-15,1
user_001405,47,<30k,desktop,new,West,59,True,111,4,0,False,False,False,0,0,0,,111,4
user_001406,35,75k-100k,mobile,returning,Midwest,64,True,143,6,0,True,True,True,117,4,0,10.0,26,2
user_001407,31,>150k,desktop,returning,West,80,True,67,2,0,True,True,True,67,3,0,7.974178059445665,0,-1
user_001408,32,30k-50k,desktop,new,West,70,True,182,2,1,True,False,True,232,4,0,5.585352573559871,-50,-2
user_001409,18,30k-50k,desktop,returning,West,57,True,87,2,0,False,False,True,106,2,0,5.422259453655615,-19,0
user_001410,55,<30k,desktop,returning,Midwest,62,True,100,2,0,False,True,True,61,1,0,7.4864952880617635,39,1
user_001411,74,100k-150k,mobile,returning,East,50,True,102,1,1,True,True,True,74,1,0,7.598263876463781,28,0
user_001412,42,75k-100k,desktop,returning,South,35,True,65,2,0,False,False,True,79,2,0,7.25991391050329,-14,0
user_001413,47,<30k,mobile,returning,South,22,True,158,5,1,False,False,True,157,2,0,7.013410761360492,1,3
user_001414,58,50k-75k,mobile,returning,South,26,True,113,2,0,False,False,True,111,3,0,8.091538863661679,2,-1
user_001415,43,50k-75k,desktop,returning,West,71,True,76,4,0,True,True,True,73,5,0,9.621951780263567,3,-1
user_001416,74,75k-100k,mobile,new,West,44,True,128,2,0,False,False,True,118,1,0,9.243331714618867,10,1
user_001417,57,30k-50k,desktop,returning,Midwest,29,True,136,4,1,False,False,True,132,3,1,6.7510979364273425,4,1
user_001418,46,50k-75k,desktop,new,East,43,True,142,3,0,False,False,True,156,3,0,7.104038359942249,-14,0
user_001419,35,30k-50k,mobile,returning,East,42,True,38,1,0,False,False,True,32,1,0,7.180976698367146,6,0
user_001420,60,75k-100k,mobile,returning,East,56,True,99,4,1,True,True,True,81,4,0,7.4465282762994836,18,0
user_001421,38,100k-150k,mobile,new,East,53,True,90,2,0,False,False,True,108,1,0,7.883617134081557,-18,1
user_001422,31,30k-50k,desktop,returning,East,88,True,115,6,0,False,True,True,144,2,0,8.28243965212618,-29,4
user_001423,54,30k-50k,desktop,new,West,58,True,89,4,0,False,False,True,108,2,0,8.306606289251201,-19,2
user_001424,62,75k-100k,mobile,returning,Midwest,36,False,0,0,0,False,True,True,102,1,0,7.346454171050597,-102,-1
user_001425,80,50k-75k,mobile,returning,East,55,True,134,3,1,False,True,True,110,7,0,7.6777768296267705,24,-4
user_001426,44,100k-150k,desktop,returning,South,33,True,146,6,1,True,True,True,100,2,0,7.67146285313311,46,4
user_001427,57,100k-150k,desktop,returning,West,46,True,97,1,0,True,True,True,42,2,0,7.787788716937309,55,-1
user_001428,31,30k-50k,mobile,new,East,91,False,0,0,0,True,True,True,78,1,0,8.685581722631625,-78,-1
user_001429,64,50k-75k,mobile,returning,East,47,True,129,3,0,False,False,True,141,3,0,7.968461108468386,-12,0
user_001430,33,30k-50k,desktop,returning,East,79,True,42,1,0,True,True,True,25,2,0,9.569210403788741,17,-1
user_001431,70,30k-50k,desktop,returning,South,22,False,0,0,0,True,True,False,0,0,0,,0,0
user_001432,39,50k-75k,mobile,returning,South,16,True,144,1,1,True,True,True,123,1,0,7.945102699367894,21,0
user_001433,53,75k-100k,desktop,returning,South,50,True,101,1,0,False,False,True,85,2,0,7.327645458053632,16,-1
user_001434,41,75k-100k,desktop,new,East,54,True,122,2,1,False,True,True,93,1,0,7.790985676712665,29,1
user_001435,51,<30k,desktop,returning,West,62,True,129,3,0,True,False,False,0,0,0,,129,3
user_001436,45,50k-75k,desktop,returning,West,32,True,95,10,0,False,False,True,101,12,0,6.806945278297996,-6,-2
user_001437,35,50k-75k,desktop,returning,Midwest,53,True,105,7,0,True,False,True,127,9,0,4.742272201060273,-22,-2
user_001438,33,<30k,desktop,new,West,94,True,157,3,1,False,True,True,145,3,0,10.0,12,0
user_001439,18,100k-150k,mobile,new,East,100,True,106,2,0,False,True,True,70,1,0,6.390233314720699,36,1
user_001440,79,50k-75k,desktop,returning,East,8,True,188,6,0,False,True,True,142,8,1,6.660666937208525,46,-2
user_001441,44,100k-150k,tablet,new,Midwest,56,True,116,3,0,True,True,True,93,3,0,8.558351634777212,23,0
user_001442,18,50k-75k,mobile,returning,East,78,True,30,1,0,False,True,True,20,1,0,8.658946841916515,10,0
user_001443,45,30k-50k,mobile,new,East,28,True,142,3,0,False,False,False,0,0,0,,142,3
user_001444,33,30k-50k,desktop,returning,West,79,False,0,0,0,True,True,True,110,1,0,9.536669929312586,-110,-1
user_001445,46,50k-75k,mobile,returning,East,61,True,111,2,0,True,True,True,118,1,0,8.93032966574938,-7,1
user_001446,56,50k-75k,mobile,returning,South,22,False,0,0,0,False,True,True,60,2,0,7.50442086866158,-60,-2
user_001447,29,50k-75k,desktop,returning,West,95,True,74,1,1,True,True,True,69,1,0,6.079491000827195,5,0
user_001448,35,30k-50k,mobile,returning,West,39,True,143,2,2,True,False,False,0,0,0,,143,2
user_001449,27,50k-75k,mobile,returning,Midwest,47,True,99,3,0,False,True,True,83,3,0,9.073819893607196,16,0
user_001450,38,50k-75k,desktop,new,West,69,True,140,2,0,False,True,True,118,1,0,7.648151460884105,22,1
user_001451,43,50k-75k,desktop,returning,East,75,True,86,4,0,True,True,True,44,3,0,5.76850188251704,42,1
user_001452,18,100k-150k,tablet,returning,South,82,True,45,1,0,True,False,False,0,0,0,,45,1
user_001453,36,50k-75k,desktop,returning,West,55,False,0,0,0,False,True,True,71,3,0,6.940716556999837,-71,-3
user_001454,48,<30k,mobile,returning,South,47,False,0,0,0,False,False,False,0,0,0,,0,0
user_001455,35,<30k,mobile,new,East,40,True,131,4,0,False,False,True,116,5,0,7.690667601626883,15,-1
user_001456,18,30k-50k,mobile,returning,East,67,False,0,0,0,True,True,True,112,1,0,8.150843607986923,-112,-1
user_001457,56,>150k,mobile,returning,Midwest,46,True,88,2,0,False,True,True,72,3,0,8.288625685061783,16,-1
user_001458,32,50k-75k,desktop,new,Midwest,57,False,0,0,0,True,True,True,105,1,0,7.165101405106448,-105,-1
user_001459,27,50k-75k,desktop,new,Midwest,72,True,102,2,0,False,True,True,70,2,0,9.281639496313023,32,0
user_001460,59,50k-75k,desktop,returning,East,11,True,104,3,0,True,True,True,48,4,0,7.460663399386682,56,-1
user_001461,60,100k-150k,desktop,new,East,43,True,124,1,0,True,False,True,93,1,0,7.540496614201166,31,0
user_001462,46,50k-75k,mobile,returning,South,38,True,78,2,1,True,False,True,59,2,0,6.940115936694622,19,0
user_001463,33,30k-50k,mobile,new,East,65,True,136,4,0,False,True,True,118,1,0,8.036632349034537,18,3
user_001464,56,<30k,mobile,returning,South,40,True,30,4,1,False,False,True,38,4,0,7.032133835049108,-8,0
user_001465,56,75k-100k,desktop,new,East,60,True,134,3,0,True,False,True,116,2,0,6.254534353903558,18,1
user_001466,22,100k-150k,mobile,returning,East,67,True,56,3,0,True,True,True,38,1,0,8.095393342270656,18,2
user_001467,31,75k-100k,desktop,returning,South,61,True,69,1,0,False,True,True,52,1,0,7.426321636495554,17,0
user_001468,59,<30k,mobile,returning,East,38,False,0,0,0,True,True,True,100,1,1,5.907947883556416,-100,-1
user_001469,39,<30k,mobile,new,East,21,True,168,2,1,True,False,True,158,2,0,8.41043199589674,10,0
user_001470,35,50k-75k,desktop,returning,West,82,True,59,3,0,False,True,True,67,6,0,10.0,-8,-3
user_001471,36,30k-50k,mobile,returning,East,28,True,115,2,1,False,False,True,100,1,0,6.969091171333439,15,1
user_001472,62,<30k,desktop,new,West,45,True,114,2,0,False,True,True,112,1,0,7.203978087408911,2,1
user_001473,29,100k-150k,desktop,new,Midwest,92,True,109,2,0,True,True,True,63,2,0,7.618286763181613,46,0
user_001474,50,100k-150k,mobile,returning,South,62,True,117,5,0,True,True,True,64,2,1,8.70787056796887,53,3
user_001475,66,75k-100k,mobile,returning,West,35,True,91,1,0,False,True,True,63,1,0,8.662376665533086,28,0
user_001476,43,50k-75k,mobile,returning,South,37,False,0,0,0,False,False,True,123,1,0,6.955843336065732,-123,-1
user_001477,31,30k-50k,desktop,new,Midwest,55,False,0,0,0,False,True,True,85,6,0,5.605364912288654,-85,-6
user_001478,48,100k-150k,mobile,returning,West,19,True,171,1,0,False,False,True,217,1,0,7.680899407658886,-46,0
user_001479,47,30k-50k,mobile,returning,Midwest,67,True,90,2,1,False,True,True,73,1,0,8.152232155373868,17,1
user_001480,32,50k-75k,mobile,new,West,69,True,101,1,0,False,False,True,91,1,0,7.202450904190916,10,0
user_001481,61,50k-75k,desktop,returning,West,52,True,77,2,1,True,True,True,74,1,1,6.607009931882178,3,1
user_001482,61,50k-75k,mobile,new,West,32,False,0,0,0,False,True,True,81,1,0,8.738210681580252,-81,-1
user_001483,72,<30k,mobile,returning,South,13,True,200,4,0,False,False,True,190,1,0,6.627453168729933,10,3
user_001484,18,50k-75k,mobile,returning,Midwest,66,True,83,5,0,True,True,True,51,6,0,7.903155223628852,32,-1
user_001485,18,50k-75k,mobile,new,South,95,False,0,0,0,True,True,True,83,1,0,8.081829860099582,-83,-1
user_001486,44,30k-50k,mobile,returning,South,52,True,82,3,0,True,True,True,58,2,0,6.242269136790728,24,1
user_001487,56,50k-75k,desktop,returning,Midwest,17,True,94,1,0,True,False,True,81,3,0,6.122959538504052,13,-2
user_001488,58,50k-75k,desktop,returning,West,54,False,0,0,0,True,True,True,73,1,0,7.640574261006838,-73,-1
user_001489,56,30k-50k,mobile,new,East,4,True,215,4,0,False,False,True,230,5,0,5.387415885557408,-15,-1
user_001490,41,30k-50k,desktop,new,West,5,False,0,0,0,False,False,True,146,2,1,6.420094034139326,-146,-2
user_001491,41,30k-50k,mobile,new,Midwest,68,True,157,2,1,True,True,True,87,1,0,9.015020104155678,70,1
user_001492,37,75k-100k,desktop,new,South,53,True,145,4,0,False,True,True,130,2,0,7.736070493770131,15,2
user_001493,67,30k-50k,mobile,new,Midwest,27,True,141,5,0,False,False,True,151,8,0,9.37060796633289,-10,-3
user_001494,60,75k-100k,desktop,returning,West,23,True,109,4,0,True,True,True,100,2,0,10.0,9,2
user_001495,58,<30k,mobile,returning,Midwest,3,False,0,0,0,False,False,False,0,0,0,,0,0
user_001496,33,75k-100k,mobile,new,South,60,True,120,3,1,False,True,True,102,2,0,8.592983092497127,18,1
user_001497,49,50k-75k,desktop,new,East,30,True,149,7,0,False,False,True,149,5,0,8.199618850173026,0,2
user_001498,41,100k-150k,mobile,returning,South,64,False,0,0,0,False,False,True,96,1,0,7.851849084240786,-96,-1
user_001499,34,75k-100k,desktop,returning,West,97,True,68,1,0,False,True,True,60,2,0,10.0,8,-1
user_001500,47,30k-50k,mobile,returning,East,50,True,47,1,0,False,False,True,65,1,0,9.90248371787728,-18,0
user_001501,50,50k-75k,desktop,returning,East,52,True,38,1,0,False,False,True,30,1,0,6.370395026966832,8,0
user_001502,38,50k-75k,desktop,new,West,60,True,87,3,1,True,True,True,84,2,0,7.308093071291996,3,1
user_001503,80,30k-50k,desktop,new,East,42,False,0,0,0,False,True,True,99,1,0,8.08075938190037,-99,-1
user_001504,35,100k-150k,desktop,returning,South,68,True,76,5,0,True,True,True,65,2,0,8.966247229259231,11,3
user_001505,55,<30k,desktop,returning,South,55,True,116,3,0,True,True,True,66,3,0,9.417611297034775,50,0
user_001506,57,>150k,desktop,new,South,34,True,98,2,1,False,False,True,101,1,0,5.5421889079432285,-3,1
user_001507,23,>150k,desktop,returning,East,65,True,155,2,0,True,True,True,151,1,0,6.743376640584224,4,1
user_001508,67,75k-100k,desktop,returning,West,44,True,98,1,1,True,False,True,118,1,0,6.989607461944456,-20,0
user_001509,58,50k-75k,desktop,returning,Midwest,26,True,112,3,1,False,True,True,73,2,0,8.064076263898409,39,1
user_001510,40,30k-50k,tablet,new,West,66,True,61,2,1,False,False,True,56,1,1,6.821582041486338,5,1
user_001511,60,75k-100k,desktop,returning,South,14,True,117,4,0,True,True,True,101,1,0,7.3330211178328835,16,3
user_001512,46,<30k,mobile,returning,East,79,True,67,2,0,False,True,True,23,2,0,8.207269457267566,44,0
user_001513,44,75k-100k,tablet,new,Midwest,61,True,148,4,0,True,True,True,142,4,0,8.83379163250049,6,0
user_001514,46,<30k,desktop,new,West,67,True,155,3,0,False,False,True,154,4,0,8.260461376933705,1,-1
user_001515,24,100k-150k,desktop,returning,West,90,True,85,2,0,True,True,True,86,1,0,8.1673588645665,-1,1
user_001516,32,100k-150k,mobile,new,East,74,True,150,2,0,True,True,True,109,2,0,7.478629341203084,41,0
user_001517,51,50k-75k,mobile,new,East,75,False,0,0,0,False,False,True,147,1,0,7.882417327148111,-147,-1
user_001518,47,50k-75k,desktop,returning,South,39,False,0,0,0,True,False,True,120,2,0,7.758893152233331,-120,-2
user_001519,38,100k-150k,desktop,new,East,68,True,145,5,1,False,True,True,121,9,2,7.740951457096448,24,-4
user_001520,59,100k-150k,desktop,returning,West,77,True,46,2,0,True,True,True,62,1,0,8.380137865292813,-16,1
user_001521,47,100k-150k,mobile,new,East,47,True,120,6,0,True,True,True,105,4,0,7.760339172611331,15,2
user_001522,54,100k-150k,mobile,returning,West,70,True,117,3,0,True,True,True,47,2,0,7.959965159400949,70,1
user_001523,40,<30k,desktop,returning,South,29,True,153,2,0,True,True,False,0,0,0,,153,2
user_001524,68,<30k,mobile,new,South,41,False,0,0,0,False,True,True,117,1,0,8.78492225462346,-117,-1
user_001525,35,50k-75k,mobile,returning,South,40,True,77,2,0,True,True,True,38,2,0,9.196239606467572,39,0
user_001526,29,50k-75k,desktop,returning,Midwest,52,True,47,3,0,False,True,True,27,2,0,6.822817527947982,20,1
user_001527,75,30k-50k,mobile,returning,East,37,False,0,0,0,True,True,True,118,2,0,10.0,-118,-2
user_001528,57,50k-75k,mobile,new,East,47,True,91,4,1,False,True,True,59,5,0,7.657891314030419,32,-1
user_001529,80,75k-100k,mobile,returning,Midwest,16,True,110,1,0,False,False,True,96,1,1,4.8575088386819605,14,0
user_001530,36,50k-75k,desktop,returning,West,65,True,109,1,0,False,True,True,74,1,0,5.776199868207628,35,0
user_001531,25,<30k,tablet,returning,West,66,True,145,1,0,True,True,True,113,1,0,8.240964508018651,32,0
user_001532,62,50k-75k,desktop,returning,Midwest,5,True,170,2,0,False,False,True,196,3,0,7.945772734999108,-26,-1
user_001533,27,30k-50k,desktop,returning,Midwest,49,True,54,4,0,False,False,True,32,1,0,7.193368779359955,22,3
user_001534,64,<30k,desktop,returning,East,23,False,0,0,0,True,True,True,82,1,0,4.127756752361335,-82,-1
user_001535,24,<30k,desktop,returning,South,47,False,0,0,0,False,False,True,119,2,0,9.870603074806857,-119,-2
user_001536,61,50k-75k,mobile,new,Midwest,28,True,156,2,0,False,False,True,153,2,0,6.7767579869597885,3,0
user_001537,50,<30k,desktop,returning,South,43,False,0,0,0,True,False,False,0,0,0,,0,0
user_001538,40,100k-150k,mobile,returning,West,68,True,84,7,0,False,True,True,66,4,0,8.46353068901058,18,3
user_001539,34,30k-50k,mobile,returning,West,87,True,97,1,0,True,True,True,79,1,0,7.976041917859944,18,0
user_001540,26,100k-150k,desktop,returning,Midwest,99,True,59,2,0,True,True,True,33,5,1,8.789439717486763,26,-3
user_001541,49,100k-150k,mobile,returning,West,52,True,115,5,0,False,True,True,109,4,0,6.972948931129608,6,1
user_001542,42,75k-100k,desktop,new,West,80,True,44,5,0,False,True,True,24,4,0,8.526090541194257,20,1
user_001543,67,100k-150k,mobile,returning,East,45,True,74,2,1,False,True,True,65,1,0,6.605479074466135,9,1
user_001544,23,50k-75k,mobile,new,West,86,False,0,0,0,True,True,False,0,0,0,,0,0
user_001545,59,<30k,desktop,returning,South,20,True,111,3,0,False,False,True,124,2,0,7.826607085130482,-13,1
user_001546,40,100k-150k,desktop,returning,East,44,True,98,1,0,False,False,True,66,1,1,5.91031132998024,32,0
user_001547,44,<30k,tablet,returning,Midwest,67,True,54,4,0,True,False,True,67,5,0,6.407050159993273,-13,-1
user_001548,33,<30k,desktop,returning,East,71,True,64,7,0,True,True,True,44,3,0,7.576698644990122,20,4
user_001549,38,30k-50k,mobile,returning,South,61,True,76,3,0,True,True,False,0,0,0,,76,3
user_001550,46,50k-75k,desktop,new,West,64,True,110,3,0,True,True,True,96,1,0,6.580375925010364,14,2
user_001551,46,>150k,mobile,returning,West,49,True,100,2,1,False,False,True,125,1,0,6.104955148993813,-25,1
user_001552,43,30k-50k,mobile,new,West,88,True,64,6,0,False,False,True,92,7,0,8.520935466006316,-28,-1
user_001553,48,<30k,mobile,new,Midwest,29,True,84,3,1,False,False,True,63,5,0,6.53364026169646,21,-2
user_001554,63,<30k,mobile,returning,Midwest,19,True,155,6,0,False,False,True,112,4,0,7.265678400138057,43,2
user_001555,34,75k-100k,desktop,returning,West,100,True,82,4,0,True,True,True,83,4,0,10.0,-1,0
user_001556,69,<30k,mobile,new,Midwest,51,False,0,0,0,False,False,True,122,2,0,8.165234846320578,-122,-2
user_001557,64,<30k,desktop,returning,East,33,True,95,5,0,True,False,False,0,0,0,,95,5
user_001558,40,75k-100k,desktop,returning,East,56,True,94,1,0,False,True,True,43,1,0,9.551443957529827,51,0
user_001559,34,30k-50k,mobile,returning,East,58,True,101,2,0,True,True,True,60,1,0,7.787545322725642,41,1
user_001560,18,100k-150k,desktop,returning,Midwest,71,False,0,0,0,False,True,True,79,1,0,7.86788417456098,-79,-1
user_001561,18,100k-150k,mobile,returning,East,82,True,65,2,1,False,True,True,42,1,0,6.9104601747376595,23,1
user_001562,38,50k-75k,mobile,returning,West,82,True,30,5,0,True,True,True,41,3,0,9.299363870763123,-11,2
user_001563,21,75k-100k,desktop,returning,East,48,True,37,1,0,False,True,True,20,1,0,6.57774218315667,17,0
user_001564,41,75k-100k,desktop,returning,South,42,True,104,3,0,True,False,True,108,4,0,7.101597596304899,-4,-1
user_001565,59,75k-100k,mobile,new,South,41,True,174,1,0,True,False,True,176,2,0,7.53638146928551,-2,-1
user_001566,28,30k-50k,mobile,returning,West,62,True,58,2,0,False,True,True,49,1,0,9.917724059036908,9,1
user_001567,46,30k-50k,mobile,returning,West,55,True,100,2,1,True,True,True,69,1,0,7.205755213226775,31,1
user_001568,46,>150k,mobile,new,Midwest,62,True,85,1,0,False,True,True,90,2,1,6.641049519422616,-5,-1
user_001569,62,75k-100k,mobile,returning,West,58,True,116,1,0,True,True,True,119,1,0,8.757968746779541,-3,0
user_001570,59,>150k,mobile,new,East,60,True,142,4,0,True,True,True,126,6,0,6.121299230242713,16,-2
user_001571,43,30k-50k,mobile,returning,East,67,True,111,5,0,True,False,True,118,10,0,7.592186452162368,-7,-5
user_001572,37,75k-100k,desktop,returning,East,61,True,53,2,0,True,True,True,48,4,0,7.853070678246003,5,-2
user_001573,51,50k-75k,mobile,returning,East,42,True,137,5,0,True,True,True,122,8,0,9.39696759680278,15,-3
user_001574,43,>150k,mobile,returning,East,57,True,89,2,1,False,True,True,75,1,0,8.171337238489434,14,1
user_001575,62,100k-150k,mobile,returning,East,67,True,117,3,0,True,True,True,85,2,0,9.336270537260019,32,1
user_001576,18,75k-100k,desktop,returning,West,69,True,81,4,0,True,True,True,65,6,0,8.715762549892855,16,-2
user_001577,44,30k-50k,desktop,returning,East,62,True,83,3,0,True,False,True,84,2,0,6.1084246977944785,-1,1
user_001578,18,75k-100k,desktop,returning,East,50,True,40,3,0,True,True,True,57,1,0,9.379645731003068,-17,2
user_001579,31,100k-150k,desktop,new,West,92,True,94,2,0,False,False,False,0,0,0,,94,2
user_001580,62,75k-100k,mobile,returning,West,27,True,148,3,0,True,False,True,132,3,0,6.056135710303235,16,0
user_001581,58,50k-75k,tablet,returning,East,20,False,0,0,0,False,False,True,119,1,0,5.669593559284399,-119,-1
user_001582,49,100k-150k,mobile,returning,East,92,True,56,3,0,True,True,True,41,3,0,8.610357395999365,15,0
user_001583,20,50k-75k,mobile,returning,West,85,False,0,0,0,True,True,False,0,0,0,,0,0
user_001584,23,>150k,mobile,new,West,88,False,0,0,0,True,True,True,115,1,0,9.748489712275752,-115,-1
user_001585,48,50k-75k,desktop,returning,Midwest,36,True,46,4,0,True,True,True,52,1,2,7.767547174888413,-6,3
user_001586,58,30k-50k,desktop,new,East,29,True,164,4,0,True,True,True,141,2,0,7.4326732099142125,23,2
user_001587,42,<30k,desktop,new,Midwest,48,True,116,3,0,False,False,True,109,3,0,5.262871334966339,7,0
user_001588,71,50k-75k,desktop,returning,East,45,True,136,4,1,True,True,True,117,1,0,7.731515175961133,19,3
user_001589,36,<30k,desktop,returning,West,68,True,63,2,0,False,False,True,51,2,1,8.138149603004063,12,0
user_001590,37,<30k,desktop,returning,South,51,True,30,2,0,True,True,True,27,1,0,9.646043595781851,3,1
user_001591,18,75k-100k,desktop,returning,South,69,True,79,2,0,True,False,True,84,2,0,7.104163302603828,-5,0
user_001592,53,>150k,desktop,new,East,74,True,96,2,0,True,True,True,109,2,0,7.113122985256837,-13,0
user_001593,43,75k-100k,desktop,new,South,46,True,112,3,1,False,False,True,125,2,0,6.689591496224137,-13,1
user_001594,46,<30k,tablet,returning,South,49,True,39,1,0,True,False,False,0,0,0,,39,1
user_001595,78,75k-100k,desktop,new,Midwest,31,True,136,3,0,True,True,True,126,4,0,7.770658800472017,10,-1
user_001596,39,50k-75k,desktop,new,East,43,True,124,2,0,False,True,True,102,1,0,7.356386325579771,22,1
user_001597,28,>150k,mobile,new,Midwest,85,True,142,4,0,False,True,True,116,6,0,7.28570977542001,26,-2
user_001598,37,75k-100k,desktop,new,East,53,True,127,4,0,True,True,True,122,3,0,7.491052393549195,5,1
user_001599,20,50k-75k,desktop,new,East,84,True,103,5,0,False,True,True,59,3,1,7.873027182315956,44,2
user_001600,38,75k-100k,desktop,new,South,77,True,119,6,0,True,True,True,121,12,0,7.345089087081773,-2,-6
user_001601,18,100k-150k,mobile,new,East,76,True,61,1,0,False,True,True,80,1,0,9.263460326725216,-19,0
user_001602,58,75k-100k,desktop,returning,South,15,True,105,6,1,False,False,True,161,7,1,8.383933602181143,-56,-1
user_001603,42,50k-75k,desktop,returning,South,65,True,109,3,0,False,False,True,144,7,0,8.269370230419904,-35,-4
user_001604,80,30k-50k,mobile,new,East,45,False,0,0,0,False,True,False,0,0,0,,0,0
user_001605,18,>150k,desktop,new,East,69,False,0,0,0,True,True,True,102,2,0,6.788970179013299,-102,-2
user_001606,40,75k-100k,desktop,returning,South,49,False,0,0,0,True,False,True,160,1,0,6.856730084212874,-160,-1
user_001607,18,75k-100k,mobile,new,West,77,False,0,0,0,False,True,True,134,1,0,9.712607723426052,-134,-1
user_001608,22,30k-50k,desktop,returning,West,95,True,102,5,0,False,True,False,0,0,0,,102,5
user_001609,28,30k-50k,mobile,new,West,85,True,108,1,0,True,True,True,65,1,0,8.549837491979035,43,0
user_001610,32,50k-75k,desktop,new,West,97,True,116,4,0,False,True,True,90,5,0,7.13363186658587,26,-1
user_001611,29,75k-100k,mobile,returning,East,84,True,34,4,0,False,True,True,30,3,0,7.846266282247517,4,1
user_001612,43,<30k,desktop,new,East,73,True,77,7,0,True,True,True,58,6,0,9.033032576859167,19,1
user_001613,74,75k-100k,desktop,returning,Midwest,35,True,102,4,1,False,True,True,100,1,0,6.40136814164106,2,3
user_001614,34,100k-150k,mobile,returning,South,82,True,36,2,0,True,True,True,30,2,0,10.0,6,0
user_001615,23,100k-150k,mobile,returning,South,100,True,74,5,0,True,True,True,25,5,0,7.765227379093737,49,0
user_001616,48,30k-50k,mobile,returning,East,37,True,94,1,0,True,True,True,91,1,0,9.549040389781135,3,0
user_001617,32,75k-100k,desktop,returning,East,62,True,111,2,0,False,True,True,69,4,0,9.80152526878481,42,-2
user_001618,45,50k-75k,mobile,returning,Midwest,69,True,83,1,0,True,True,True,25,1,0,9.587311743743495,58,0
user_001619,42,<30k,desktop,new,South,31,False,0,0,0,True,False,False,0,0,0,,0,0
user_001620,47,<30k,desktop,returning,East,50,True,102,2,0,False,False,True,70,1,0,9.063056964376742,32,1
user_001621,47,75k-100k,desktop,new,East,47,True,107,4,0,False,True,True,89,3,1,9.162585270237859,18,1
user_001622,18,50k-75k,tablet,returning,Midwest,69,True,58,3,0,False,True,True,39,1,0,5.771602949973778,19,2
user_001623,53,<30k,desktop,returning,West,69,True,80,2,0,False,False,True,85,5,0,8.11265296519153,-5,-3
user_001624,77,50k-75k,mobile,returning,Midwest,44,False,0,0,0,False,False,True,161,3,1,6.225695433475181,-161,-3
user_001625,54,<30k,desktop,new,West,53,True,81,1,1,False,True,True,55,2,0,8.935268101686358,26,-1
user_001626,53,50k-75k,mobile,returning,South,50,True,37,1,0,False,True,True,20,2,0,8.137664143777243,17,-1
user_001627,48,50k-75k,desktop,new,East,13,True,192,3,0,False,False,True,168,2,0,5.630022108891571,24,1
user_001628,24,100k-150k,desktop,new,West,81,True,100,3,0,False,True,True,105,2,0,9.14931878788632,-5,1
user_001629,46,75k-100k,desktop,returning,Midwest,63,True,40,1,1,False,True,True,35,1,0,9.026877533620917,5,0
user_001630,36,30k-50k,desktop,returning,Midwest,26,True,120,1,0,False,False,True,118,1,0,8.26898004016721,2,0
user_001631,32,50k-75k,tablet,returning,South,78,True,117,2,0,True,True,True,104,2,0,6.183172589812185,13,0
user_001632,48,50k-75k,desktop,returning,South,62,True,103,1,0,True,True,True,84,1,1,9.167597348552082,19,0
user_001633,75,50k-75k,desktop,returning,East,9,True,121,2,0,True,False,True,121,3,0,5.754092018056803,0,-1
user_001634,29,50k-75k,mobile,returning,East,73,False,0,0,0,True,True,True,64,1,0,8.49487815978229,-64,-1
user_001635,44,<30k,mobile,returning,West,51,True,135,5,0,True,True,True,154,2,0,8.788722018974969,-19,3
user_001636,49,30k-50k,mobile,new,South,59,True,118,1,0,True,False,True,97,1,1,5.453287589343952,21,0
user_001637,57,30k-50k,mobile,returning,South,16,True,163,6,0,True,False,True,146,4,0,6.970600778111463,17,2
user_001638,35,50k-75k,mobile,returning,West,71,True,68,1,0,False,True,True,43,1,0,8.937127360509356,25,0
user_001639,47,75k-100k,mobile,returning,West,62,True,108,5,0,False,False,True,159,5,0,5.8333855864687605,-51,0
user_001640,41,>150k,desktop,returning,East,45,True,92,2,0,False,True,True,105,4,0,8.453540813872937,-13,-2
user_001641,54,30k-50k,tablet,new,Midwest,78,True,139,4,0,False,True,True,96,3,0,9.786932197530568,43,1
user_001642,31,75k-100k,mobile,returning,East,60,True,132,3,0,True,True,True,92,3,0,7.585630249497015,40,0
user_001643,60,<30k,mobile,returning,West,35,True,89,3,1,False,False,True,77,6,1,6.668781685869636,12,-3
user_001644,51,75k-100k,mobile,returning,East,33,True,51,3,0,False,True,True,87,3,0,10.0,-36,0
user_001645,26,50k-75k,desktop,returning,Midwest,56,False,0,0,0,True,False,True,144,1,0,7.601565005167047,-144,-1
user_001646,52,75k-100k,desktop,new,West,51,True,82,1,0,True,False,True,64,1,0,5.964462388016653,18,0
user_001647,40,30k-50k,desktop,returning,Midwest,44,True,95,1,0,False,False,True,102,1,0,7.811097666601455,-7,0
user_001648,51,50k-75k,desktop,returning,Midwest,30,True,65,1,0,True,True,True,76,3,0,7.837258600982401,-11,-2
user_001649,43,30k-50k,desktop,new,Midwest,36,True,94,5,0,False,True,True,108,4,0,9.58134760986573,-14,1
user_001650,18,75k-100k,mobile,returning,Midwest,80,True,80,5,0,False,False,False,0,0,0,,80,5
user_001651,24,50k-75k,desktop,returning,Midwest,60,False,0,0,0,False,True,True,104,2,0,7.108100836191791,-104,-2
user_001652,35,30k-50k,mobile,new,Midwest,53,True,100,3,0,True,False,True,115,4,0,5.295716649816632,-15,-1
user_001653,38,>150k,desktop,returning,Midwest,63,True,126,3,0,True,True,True,101,3,0,10.0,25,0
user_001654,35,30k-50k,mobile,returning,East,66,True,107,2,1,False,True,True,76,2,0,6.063799018067855,31,0
user_001655,18,100k-150k,mobile,new,East,69,True,105,5,1,False,False,False,0,0,0,,105,5
user_001656,31,75k-100k,mobile,returning,South,43,True,93,7,0,False,False,True,123,9,0,6.894219589415699,-30,-2
user_001657,54,75k-100k,desktop,returning,South,70,True,92,4,0,True,True,True,97,1,0,8.68577311784707,-5,3
user_001658,34,100k-150k,desktop,new,East,84,True,127,4,0,False,True,True,89,2,0,9.577031815586414,38,2
user_001659,46,>150k,mobile,returning,East,82,True,91,1,0,True,True,True,49,1,0,6.461970266978608,42,0
user_001660,52,30k-50k,mobile,returning,East,50,True,56,3,0,True,True,True,61,2,0,6.003251371157137,-5,1
user_001661,43,50k-75k,desktop,returning,East,67,True,85,1,1,True,True,True,101,1,0,8.89703203465391,-16,0
user_001662,58,100k-150k,mobile,new,South,48,True,169,2,0,False,True,True,135,1,0,7.876602621821548,34,1
user_001663,63,100k-150k,mobile,returning,East,57,True,112,7,0,True,True,True,85,5,0,7.348127634278818,27,2
user_001664,51,30k-50k,desktop,returning,West,78,True,50,5,0,True,True,True,20,5,0,10.0,30,0
user_001665,18,100k-150k,mobile,new,East,91,False,0,0,0,True,True,True,130,1,0,9.452050176366107,-130,-1
user_001666,41,<30k,desktop,returning,East,48,True,79,2,0,True,True,True,87,1,0,7.972967346719383,-8,1
user_001667,34,50k-75k,desktop,new,South,61,True,89,3,0,False,True,True,58,2,0,8.24755670042615,31,1
user_001668,43,50k-75k,desktop,returning,Midwest,42,True,126,2,0,False,True,True,105,2,0,7.789910653536396,21,0
user_001669,38,100k-150k,mobile,returning,West,90,True,30,3,0,True,True,True,20,1,0,8.458328750961552,10,2
user_001670,39,75k-100k,mobile,new,West,48,True,114,2,1,False,False,True,141,2,0,5.867724258631362,-27,0
user_001671,23,50k-75k,desktop,returning,Midwest,91,True,79,4,0,True,True,True,67,5,0,6.52032473062172,12,-1
user_001672,48,50k-75k,mobile,returning,West,57,True,110,4,0,True,True,True,107,1,0,8.510809203001145,3,3
user_001673,22,100k-150k,mobile,new,East,95,True,92,1,0,True,True,True,82,1,0,6.976545925320618,10,0
user_001674,33,75k-100k,desktop,new,West,90,True,67,2,0,True,True,True,64,4,0,5.3740130530635675,3,-2
user_001675,39,100k-150k,mobile,returning,South,74,True,65,4,0,False,True,True,80,5,0,7.2608511542492975,-15,-1
user_001676,67,30k-50k,desktop,returning,West,62,True,133,4,0,True,False,True,169,2,0,6.710584294369392,-36,2
user_001677,52,30k-50k,mobile,new,Midwest,35,True,113,5,0,False,False,True,137,8,0,5.511080491406175,-24,-3
user_001678,69,30k-50k,mobile,returning,South,18,True,145,4,1,True,False,True,118,1,0,6.922368701381403,27,3
user_001679,18,50k-75k,desktop,new,East,66,False,0,0,0,False,True,True,46,1,0,9.773050925126654,-46,-1
user_001680,28,100k-150k,mobile,new,Midwest,88,True,84,1,0,False,True,True,64,1,0,8.060350535784435,20,0
user_001681,39,50k-75k,desktop,new,Midwest,69,True,92,1,0,False,True,True,113,1,0,10.0,-21,0
user_001682,56,100k-150k,desktop,returning,Midwest,69,True,100,5,0,True,True,True,107,3,0,7.508817432351719,-7,2
user_001683,50,100k-150k,mobile,new,West,86,True,86,1,0,False,True,True,77,1,0,8.58598736869893,9,0
user_001684,39,75k-100k,desktop,returning,East,63,True,65,3,0,True,True,True,91,1,0,8.052228339012682,-26,2
user_001685,28,100k-150k,desktop,new,Midwest,81,True,88,1,0,False,True,True,39,1,0,8.665027779630456,49,0
user_001686,58,50k-75k,mobile,new,South,34,False,0,0,0,False,False,True,115,1,0,6.329828863728782,-115,-1
user_001687,52,75k-100k,mobile,returning,Midwest,48,True,74,3,0,False,False,True,80,4,0,6.2760478338920445,-6,-1
user_001688,44,50k-75k,tablet,returning,West,73,True,33,3,0,False,True,True,20,3,0,8.640199729884223,13,0
user_001689,68,50k-75k,desktop,new,East,26,True,237,2,0,True,True,True,142,1,0,8.7041249795159,95,1
user_001690,71,75k-100k,desktop,returning,East,44,True,65,1,0,False,True,True,77,1,0,5.676654450585806,-12,0
user_001691,43,100k-150k,desktop,returning,Midwest,53,True,89,1,0,False,True,True,36,1,0,7.832173730113638,53,0
user_001692,61,50k-75k,mobile,new,West,53,True,87,5,1,True,True,True,67,3,1,7.3779073070083605,20,2
user_001693,52,>150k,mobile,returning,South,47,True,148,1,0,True,True,True,143,3,0,8.607498949487594,5,-2
user_001694,42,75k-100k,mobile,returning,South,39,True,103,2,0,False,True,True,68,4,1,6.943587041136687,35,-2
user_001695,38,50k-75k,desktop,new,South,43,True,158,1,0,True,False,True,130,1,0,7.656600022117228,28,0
user_001696,48,30k-50k,desktop,returning,East,46,True,64,1,0,True,False,True,59,1,0,6.9506776212363945,5,0
user_001697,33,>150k,mobile,returning,Midwest,100,True,89,1,1,False,True,True,73,1,0,9.72686555002261,16,0
user_001698,43,100k-150k,desktop,returning,Midwest,55,True,109,2,0,True,True,True,106,2,1,8.77084559107013,3,0
user_001699,54,50k-75k,mobile,returning,South,39,True,53,4,0,False,False,True,37,6,0,8.37998222674182,16,-2
user_001700,47,75k-100k,mobile,returning,West,81,True,72,3,0,False,False,True,76,3,0,8.26456482950712,-4,0
user_001701,44,30k-50k,desktop,returning,West,53,True,126,3,0,False,True,True,133,5,0,8.321548871496827,-7,-2
user_001702,39,50k-75k,desktop,returning,East,73,True,54,2,0,True,True,True,72,1,0,7.989520614232551,-18,1
user_001703,39,75k-100k,mobile,returning,Midwest,62,True,30,2,0,True,True,True,20,1,0,9.219357190866948,10,1
user_001704,62,50k-75k,desktop,returning,East,17,False,0,0,0,True,False,False,0,0,0,,0,0
user_001705,55,50k-75k,mobile,new,South,34,True,79,5,1,False,True,True,74,4,0,6.523685612430641,5,1
user_001706,45,<30k,desktop,returning,East,35,False,0,0,0,True,True,True,90,3,0,6.312907872568197,-90,-3
user_001707,63,50k-75k,mobile,returning,East,52,False,0,0,0,False,False,True,163,1,0,6.09524146376574,-163,-1
user_001708,51,30k-50k,mobile,returning,South,14,True,140,2,0,False,True,True,123,3,0,8.932714283739275,17,-1
user_001709,52,<30k,mobile,returning,West,61,False,0,0,0,True,True,True,94,1,0,10.0,-94,-1
user_001710,49,100k-150k,desktop,returning,Midwest,60,True,57,1,0,True,True,True,36,1,0,7.901783086390116,21,0
user_001711,50,75k-100k,mobile,returning,South,65,True,71,5,0,True,True,True,38,5,0,7.945124635160448,33,0
user_001712,58,75k-100k,tablet,new,Midwest,9,True,154,1,0,True,False,True,160,2,0,6.318420204832505,-6,-1
user_001713,39,75k-100k,mobile,new,Midwest,35,True,109,6,0,False,True,True,97,4,0,6.76314484626498,12,2
user_001714,36,100k-150k,mobile,returning,South,39,True,84,3,0,False,True,True,91,4,0,9.149950118641241,-7,-1
user_001715,34,75k-100k,desktop,returning,South,75,False,0,0,0,False,True,True,103,1,1,7.889156947779401,-103,-1
user_001716,39,<30k,mobile,new,Midwest,36,True,127,7,0,False,True,True,81,7,0,7.905143731712081,46,0
user_001717,20,100k-150k,mobile,returning,Midwest,49,True,110,3,0,False,True,True,103,2,0,6.523947313550155,7,1
user_001718,20,<30k,mobile,returning,South,27,True,139,6,0,False,False,True,176,10,0,5.751501695877515,-37,-4
user_001719,52,75k-100k,desktop,new,East,69,True,77,2,0,True,False,True,32,3,0,5.995922681430598,45,-1
user_001720,60,<30k,desktop,new,East,26,False,0,0,0,False,False,True,151,1,0,7.384492519868083,-151,-1
user_001721,40,50k-75k,mobile,new,South,26,True,170,8,0,False,False,True,172,9,0,4.5967918659721185,-2,-1
user_001722,59,30k-50k,desktop,returning,East,29,True,146,5,0,False,True,True,110,6,1,8.526024345536104,36,-1
user_001723,50,50k-75k,desktop,returning,South,43,True,86,1,0,True,False,True,82,1,0,9.034478898447833,4,0
user_001724,30,<30k,mobile,returning,East,43,True,86,3,0,False,True,True,98,2,0,9.054058426151887,-12,1
user_001725,29,75k-100k,mobile,returning,South,74,True,49,2,1,True,True,True,50,4,0,3.8975510801918123,-1,-2
user_001726,30,100k-150k,mobile,new,West,97,True,97,6,0,True,True,True,50,4,0,7.1283162008700325,47,2
user_001727,53,<30k,mobile,new,Midwest,45,False,0,0,0,False,False,False,0,0,0,,0,0
user_001728,41,30k-50k,mobile,returning,West,64,True,53,1,0,False,False,True,50,4,1,5.185561241300564,3,-3
user_001729,19,100k-150k,mobile,returning,Midwest,92,False,0,0,0,False,True,True,78,1,0,9.597343901245736,-78,-1
user_001730,28,50k-75k,desktop,new,West,78,True,119,2,0,True,True,True,98,2,0,8.308602962226374,21,0
user_001731,29,75k-100k,mobile,returning,West,81,True,112,3,0,True,True,True,54,2,0,8.238192389657511,58,1
user_001732,39,<30k,mobile,returning,West,52,True,95,1,0,False,True,True,37,1,0,8.072820793394742,58,0
user_001733,30,<30k,desktop,returning,South,88,True,30,4,0,True,True,True,20,5,0,8.4977483603787,10,-1
user_001734,42,50k-75k,desktop,returning,Midwest,50,True,30,4,0,True,True,True,75,3,0,9.855981905360812,-45,1
user_001735,42,50k-75k,mobile,returning,West,62,True,101,1,0,True,True,True,43,1,0,8.181867536280976,58,0
user_001736,30,100k-150k,desktop,new,Midwest,71,True,33,4,0,False,True,True,39,2,0,9.631808978172925,-6,2
user_001737,59,100k-150k,mobile,returning,West,55,True,119,7,0,True,True,True,95,3,1,6.271084094518481,24,4
user_001738,48,50k-75k,tablet,returning,West,56,True,79,4,0,False,False,True,59,2,0,7.361317054494649,20,2
user_001739,39,50k-75k,mobile,new,Midwest,49,False,0,0,0,False,True,True,89,1,0,8.578402374182629,-89,-1
user_001740,39,<30k,desktop,returning,Midwest,57,False,0,0,0,True,False,True,136,1,0,7.062729046068666,-136,-1
user_001741,49,75k-100k,mobile,new,Midwest,44,True,110,3,0,False,True,True,124,1,0,7.938312829051165,-14,2
user_001742,40,30k-50k,desktop,returning,West,80,True,46,3,0,True,True,False,0,0,0,,46,3
user_001743,34,100k-150k,desktop,returning,East,75,True,77,1,0,True,True,True,40,1,0,10.0,37,0
user_001744,42,50k-75k,desktop,returning,Midwest,17,True,127,5,1,False,True,True,88,2,0,9.366114455173577,39,3
user_001745,62,<30k,desktop,returning,East,48,True,90,4,0,True,True,True,85,4,0,7.150697150330807,5,0
user_001746,52,75k-100k,mobile,returning,Midwest,15,True,172,9,0,False,False,True,173,5,0,8.661457281435561,-1,4
user_001747,49,<30k,desktop,returning,East,57,False,0,0,0,False,False,False,0,0,0,,0,0
user_001748,41,30k-50k,desktop,returning,East,35,True,102,1,0,False,True,True,76,2,0,8.439194971997546,26,-1
user_001749,42,<30k,mobile,returning,East,49,False,0,0,0,False,False,True,146,3,0,6.476493492597826,-146,-3
user_001750,45,75k-100k,desktop,returning,East,60,True,108,1,0,False,True,False,0,0,0,,108,1
user_001751,44,100k-150k,mobile,new,Midwest,56,True,114,1,0,False,False,True,139,1,0,5.309689972850985,-25,0
user_001752,45,30k-50k,desktop,returning,East,70,False,0,0,0,True,True,True,77,1,0,8.980258335119078,-77,-1
user_001753,51,50k-75k,desktop,returning,South,17,True,164,1,0,True,True,True,137,1,0,8.143164614179751,27,0
user_001754,42,30k-50k,mobile,returning,South,58,True,66,1,0,False,True,True,35,1,0,6.705543174749767,31,0
user_001755,43,<30k,desktop,new,Midwest,29,False,0,0,0,False,False,False,0,0,0,,0,0
user_001756,42,>150k,mobile,returning,East,63,True,107,1,0,False,True,True,58,1,0,6.875180495775743,49,0
user_001757,51,75k-100k,mobile,returning,West,48,True,36,3,1,False,False,True,20,3,0,6.2563710028743085,16,0
user_001758,31,30k-50k,desktop,new,West,88,True,106,3,0,True,True,True,87,2,0,9.32718526124529,19,1
user_001759,21,75k-100k,desktop,new,South,87,False,0,0,0,True,True,True,80,3,0,8.839622239607861,-80,-3
user_001760,29,50k-75k,desktop,new,East,44,True,174,1,0,False,False,True,150,1,0,7.8227071875909235,24,0
user_001761,65,75k-100k,desktop,returning,East,28,True,103,2,0,False,True,True,81,1,1,7.1771366746967855,22,1
user_001762,55,50k-75k,desktop,new,East,44,True,97,3,0,True,True,True,64,5,0,8.657010606478682,33,-2
user_001763,26,75k-100k,mobile,returning,South,46,True,91,1,1,True,True,True,64,1,0,7.784178029209503,27,0
user_001764,55,<30k,desktop,returning,East,60,True,109,2,0,True,True,True,72,1,0,8.783791096633687,37,1
user_001765,67,50k-75k,mobile,returning,South,36,True,109,2,0,True,True,True,77,4,0,8.660949346843315,32,-2
user_001766,60,<30k,desktop,returning,Midwest,15,True,168,5,0,True,True,True,136,2,0,9.289186133164256,32,3
user_001767,43,100k-150k,desktop,returning,Midwest,80,True,30,7,0,False,True,True,33,6,1,9.595185331119518,-3,1
user_001768,54,50k-75k,mobile,returning,South,45,True,80,4,0,False,True,True,28,4,0,8.454039465798168,52,0
user_001769,63,30k-50k,desktop,returning,Midwest,60,True,107,1,0,True,True,True,79,1,0,7.937621476201184,28,0
user_001770,22,100k-150k,desktop,new,South,72,False,0,0,0,False,True,True,124,1,0,10.0,-124,-1
user_001771,44,100k-150k,mobile,returning,East,62,True,86,2,0,False,True,True,75,2,1,9.079082506128646,11,0
user_001772,41,<30k,desktop,new,East,32,False,0,0,0,True,False,True,159,1,0,5.382378647324159,-159,-1
user_001773,59,75k-100k,mobile,returning,South,38,True,108,3,0,False,False,True,115,1,0,5.857551061845509,-7,2
user_001774,65,<30k,mobile,returning,Midwest,37,False,0,0,0,False,False,False,0,0,0,,0,0
user_001775,59,50k-75k,mobile,returning,Midwest,29,True,132,6,0,True,False,True,151,2,0,5.647630032365588,-19,4
user_001776,28,30k-50k,mobile,returning,South,65,True,106,1,0,True,True,True,75,1,0,9.07482759518166,31,0
user_001777,63,30k-50k,desktop,returning,South,21,True,131,4,0,False,False,True,175,3,0,7.975911623780421,-44,1
user_001778,41,50k-75k,mobile,new,East,55,True,166,5,0,False,False,True,145,8,0,7.91350338357877,21,-3
user_001779,42,30k-50k,tablet,new,South,44,False,0,0,0,True,True,True,69,1,0,8.166791394121754,-69,-1
user_001780,43,100k-150k,mobile,returning,East,89,True,68,3,0,True,True,True,37,3,0,8.026747262715023,31,0
user_001781,54,30k-50k,mobile,returning,South,50,True,122,1,0,False,True,True,83,1,1,6.631315922427157,39,0
user_001782,18,30k-50k,mobile,returning,Midwest,58,True,97,3,0,False,True,True,74,3,0,8.298197630478404,23,0
user_001783,37,>150k,desktop,returning,Midwest,55,True,147,1,0,True,True,True,124,2,0,6.821042162817027,23,-1
user_001784,60,50k-75k,mobile,new,South,2,False,0,0,0,True,True,True,102,1,1,5.852804313026848,-102,-1
user_001785,23,<30k,mobile,returning,Midwest,41,True,104,4,0,True,True,True,106,1,0,6.462446018559646,-2,3
user_001786,35,100k-150k,tablet,returning,South,78,True,42,1,0,False,True,True,28,1,0,9.13546834989689,14,0
user_001787,31,50k-75k,desktop,returning,West,73,True,70,2,0,True,False,True,62,3,0,10.0,8,-1
user_001788,59,30k-50k,desktop,new,West,22,True,169,3,0,False,False,False,0,0,0,,169,3
user_001789,18,50k-75k,mobile,new,West,80,True,122,4,0,False,False,True,95,4,1,7.969522883770612,27,0
user_001790,62,100k-150k,desktop,new,Midwest,25,True,133,3,0,False,True,True,120,4,1,7.684694377314629,13,-1
user_001791,32,30k-50k,desktop,returning,South,46,False,0,0,0,False,True,True,86,2,0,9.77239926018207,-86,-2
user_001792,44,50k-75k,desktop,returning,West,43,False,0,0,0,False,False,False,0,0,0,,0,0
user_001793,64,<30k,mobile,new,Midwest,0,False,0,0,0,False,False,False,0,0,0,,0,0
user_001794,38,100k-150k,mobile,returning,East,45,True,64,4,0,False,True,True,20,3,0,7.6593760539225295,44,1
user_001795,80,<30k,desktop,new,East,21,False,0,0,0,True,True,True,107,2,0,7.085086505339572,-107,-2
user_001796,31,50k-75k,mobile,new,Midwest,75,True,72,2,0,True,True,True,93,1,0,7.931696001310197,-21,1
user_001797,67,30k-50k,desktop,returning,Midwest,49,True,113,4,0,False,True,True,112,3,0,7.169544741387178,1,1
user_001798,38,75k-100k,mobile,new,East,55,True,48,2,0,False,False,True,54,1,0,7.131486385091191,-6,1
user_001799,62,<30k,mobile,new,West,36,False,0,0,0,True,False,False,0,0,0,,0,0
user_001800,51,75k-100k,mobile,returning,East,55,True,30,4,0,False,False,True,20,8,0,7.686388838241493,10,-4
user_001801,21,100k-150k,desktop,returning,West,100,False,0,0,0,True,True,True,73,1,0,5.487553084234175,-73,-1
user_001802,33,50k-75k,desktop,new,West,69,True,100,1,0,False,False,True,109,1,0,7.951395396963737,-9,0
user_001803,51,>150k,mobile,new,East,77,True,52,4,0,False,False,True,58,1,0,7.486292394519527,-6,3
user_001804,57,30k-50k,desktop,returning,Midwest,35,True,101,7,0,False,False,False,0,0,0,,101,7
user_001805,61,100k-150k,desktop,returning,Midwest,43,True,88,3,0,True,True,True,56,3,0,7.771064279273512,32,0
user_001806,38,30k-50k,desktop,new,East,33,True,78,4,0,False,True,True,64,7,0,7.381883730006566,14,-3
user_001807,38,50k-75k,tablet,returning,West,53,True,61,1,0,True,True,True,44,1,0,7.613281644599469,17,0
user_001808,33,30k-50k,desktop,returning,West,96,True,137,1,0,False,True,True,108,1,0,7.622446701041503,29,0
user_001809,36,100k-150k,desktop,returning,South,73,True,45,1,0,True,True,True,49,1,0,7.91619763040734,-4,0
user_001810,65,30k-50k,desktop,new,West,41,False,0,0,0,False,False,True,156,2,0,4.863981436981707,-156,-2
user_001811,65,75k-100k,desktop,returning,West,51,True,70,1,0,False,False,True,87,2,0,5.668233368276485,-17,-1
user_001812,49,<30k,mobile,new,Midwest,46,True,158,3,0,False,False,True,167,3,0,6.859069801812843,-9,0
user_001813,54,>150k,mobile,returning,South,55,True,96,4,0,True,True,True,57,6,0,8.481053272635847,39,-2
user_001814,18,100k-150k,desktop,returning,West,100,True,89,1,1,False,True,True,70,1,0,8.812234102259485,19,0
user_001815,39,75k-100k,desktop,returning,West,64,True,92,1,0,True,True,True,85,1,0,8.898009923375417,7,0
user_001816,44,<30k,mobile,returning,Midwest,37,False,0,0,0,True,False,True,126,2,0,7.708548624272916,-126,-2
user_001817,40,30k-50k,desktop,returning,South,65,False,0,0,0,True,True,True,110,1,0,6.012956602951781,-110,-1
user_001818,36,75k-100k,desktop,returning,West,64,True,103,3,0,True,True,True,69,4,0,8.427524573064778,34,-1
user_001819,39,30k-50k,mobile,returning,East,52,True,64,1,0,True,True,True,42,1,0,6.934318535083877,22,0
user_001820,34,<30k,desktop,new,East,65,True,81,5,0,True,True,True,86,4,0,7.738529586755787,-5,1
user_001821,60,<30k,tablet,returning,East,37,False,0,0,0,True,True,True,101,1,0,6.7135590894148445,-101,-1
user_001822,47,75k-100k,desktop,returning,West,70,True,108,2,0,True,False,True,104,1,1,7.217627725497683,4,1
user_001823,54,30k-50k,desktop,returning,South,37,True,125,6,0,True,True,True,62,2,0,7.6259878560890435,63,4
user_001824,55,100k-150k,mobile,new,South,54,True,147,4,0,False,True,True,149,6,0,7.984695096838453,-2,-2
user_001825,54,<30k,mobile,returning,West,77,True,47,7,0,False,False,True,47,4,1,9.425395388478742,0,3
user_001826,39,<30k,mobile,returning,West,70,True,65,5,0,False,False,True,51,4,1,7.5675074815184065,14,1
user_001827,53,<30k,desktop,new,West,43,False,0,0,0,False,True,True,114,1,0,7.782384350417192,-114,-1
user_001828,71,100k-150k,desktop,new,East,55,True,73,5,0,True,True,True,38,9,1,8.4404697480819,35,-4
user_001829,49,>150k,mobile,new,Midwest,64,True,135,1,0,False,False,True,164,1,0,9.747284540976365,-29,0
user_001830,30,75k-100k,tablet,returning,South,55,True,86,2,0,True,True,True,65,1,0,8.133714398753023,21,1
user_001831,57,50k-75k,desktop,returning,West,32,True,137,6,0,True,False,True,141,6,0,6.8791523253206215,-4,0
user_001832,46,<30k,mobile,returning,Midwest,33,True,32,7,1,False,False,True,30,6,0,5.322801733615305,2,1
user_001833,30,50k-75k,desktop,returning,East,71,True,109,4,0,True,True,True,64,6,0,7.7147949649012615,45,-2
user_001834,39,50k-75k,desktop,new,West,71,True,44,6,0,False,True,True,26,5,2,6.656600664806755,18,1
user_001835,56,100k-150k,mobile,returning,West,49,True,84,5,0,False,False,True,74,7,0,5.9832956279380936,10,-2
user_001836,50,50k-75k,desktop,returning,South,44,True,91,1,0,True,False,True,132,1,0,7.72554169014491,-41,0
user_001837,53,>150k,mobile,returning,South,41,True,157,1,0,False,True,True,124,1,0,8.661581554787551,33,0
user_001838,66,<30k,desktop,new,West,7,True,125,2,0,True,False,False,0,0,0,,125,2
user_001839,51,100k-150k,tablet,returning,West,98,True,109,2,0,False,True,True,42,2,0,6.747119197693297,67,0
user_001840,49,50k-75k,mobile,returning,East,73,True,60,2,1,True,True,True,52,3,0,5.985445600942176,8,-1
user_001841,23,100k-150k,desktop,new,South,84,True,108,1,0,True,True,True,80,1,0,8.420773970547335,28,0
user_001842,37,75k-100k,mobile,returning,East,54,True,132,3,0,False,False,True,152,1,0,5.658288825550534,-20,2
user_001843,31,50k-75k,tablet,returning,West,61,True,148,5,0,False,True,True,64,9,0,8.068831468770934,84,-4
user_001844,40,75k-100k,desktop,returning,East,69,True,59,2,0,True,True,True,46,1,0,5.616074137650108,13,1
user_001845,72,<30k,desktop,returning,South,34,False,0,0,0,False,False,False,0,0,0,,0,0
user_001846,38,100k-150k,mobile,new,South,72,True,123,5,0,False,True,True,93,2,0,9.695579841711043,30,3
user_001847,59,50k-75k,mobile,new,South,26,True,169,7,0,True,False,False,0,0,0,,169,7
user_001848,72,30k-50k,desktop,new,South,47,False,0,0,0,True,False,False,0,0,0,,0,0
user_001849,60,<30k,mobile,new,East,54,True,162,6,0,False,False,True,156,9,0,6.111544761066916,6,-3
user_001850,27,75k-100k,desktop,new,West,86,True,122,4,0,True,True,True,105,3,0,10.0,17,1
user_001851,22,30k-50k,desktop,returning,Midwest,56,True,81,5,1,False,False,True,110,5,0,8.335284969361178,-29,0
user_001852,33,>150k,desktop,new,South,95,True,85,2,0,True,True,True,97,2,0,9.02202281518936,-12,0
user_001853,56,50k-75k,mobile,new,Midwest,21,True,191,4,0,True,True,True,136,3,0,8.519325287670997,55,1
user_001854,55,>150k,mobile,returning,South,71,True,51,6,0,False,True,True,22,3,0,8.079549989023048,29,3
user_001855,53,30k-50k,desktop,returning,South,41,True,104,9,0,True,True,True,96,9,0,8.588359832580673,8,0
user_001856,22,30k-50k,tablet,returning,East,81,False,0,0,0,True,True,True,74,1,0,10.0,-74,-1
user_001857,53,30k-50k,mobile,new,East,70,True,101,2,0,True,True,False,0,0,0,,101,2
user_001858,30,<30k,desktop,returning,South,62,True,115,2,0,False,False,False,0,0,0,,115,2
user_001859,39,50k-75k,desktop,new,West,51,True,68,4,0,False,False,True,81,5,0,7.186812265263835,-13,-1
user_001860,20,50k-75k,desktop,new,Midwest,76,True,76,3,0,False,False,True,53,5,0,9.242103197928095,23,-2
user_001861,66,<30k,mobile,returning,West,13,False,0,0,0,False,False,True,87,1,2,6.532069970508667,-87,-1
user_001862,51,50k-75k,mobile,new,Midwest,53,False,0,0,0,False,False,True,101,1,0,7.114654447395372,-101,-1
user_001863,63,50k-75k,mobile,returning,South,47,True,85,1,1,False,False,True,71,1,0,6.19048633993627,14,0
user_001864,53,<30k,desktop,returning,West,45,True,106,3,0,True,True,True,95,1,0,6.982482990738895,11,2
user_001865,57,50k-75k,mobile,new,Midwest,52,False,0,0,0,False,True,True,97,1,0,8.908825484629538,-97,-1
user_001866,46,50k-75k,mobile,returning,West,69,True,99,2,0,True,True,True,66,2,0,10.0,33,0
user_001867,60,30k-50k,mobile,returning,West,27,True,139,2,1,False,False,True,153,4,0,7.289611704855446,-14,-2
user_001868,47,30k-50k,desktop,new,South,58,True,161,5,0,False,False,True,165,4,0,9.019090984480885,-4,1
user_001869,32,50k-75k,mobile,returning,East,100,True,116,1,0,True,True,True,106,1,0,7.128012839638871,10,0
user_001870,43,50k-75k,desktop,new,East,28,True,149,6,0,False,False,True,143,6,0,5.7927759465698765,6,0
user_001871,19,75k-100k,desktop,new,West,85,True,72,3,0,True,True,True,20,2,0,9.376792798276846,52,1
user_001872,52,75k-100k,tablet,new,West,59,True,82,6,0,False,False,True,43,6,0,7.736239962384151,39,0
user_001873,61,75k-100k,desktop,new,South,40,True,116,4,0,True,False,True,118,7,0,8.292926298765046,-2,-3
user_001874,54,75k-100k,desktop,returning,Midwest,17,False,0,0,0,True,True,True,114,1,0,8.524148267335926,-114,-1
user_001875,39,50k-75k,desktop,returning,East,53,True,130,2,0,True,True,True,131,2,0,9.384415647817304,-1,0
user_001876,31,75k-100k,mobile,new,East,74,True,145,1,0,False,True,True,123,1,0,8.22707500211001,22,0
user_001877,29,100k-150k,mobile,returning,Midwest,55,True,48,6,0,True,True,True,56,3,0,9.383150301260255,-8,3
user_001878,49,75k-100k,desktop,returning,East,49,False,0,0,0,False,True,True,76,1,0,7.123026118248053,-76,-1
user_001879,33,30k-50k,mobile,new,South,79,True,96,3,0,False,True,True,79,2,2,9.019049536375958,17,1
user_001880,44,<30k,mobile,returning,East,44,True,113,2,1,True,False,True,138,2,0,9.52231525704185,-25,0
user_001881,41,30k-50k,desktop,returning,Midwest,33,True,71,2,0,True,False,True,70,1,0,7.436544572212054,1,1
user_001882,41,100k-150k,desktop,new,Midwest,66,True,107,1,1,True,True,False,0,0,0,,107,1
user_001883,68,50k-75k,tablet,new,Midwest,44,True,111,3,0,True,True,False,0,0,0,,111,3
user_001884,25,50k-75k,mobile,returning,West,75,True,119,1,1,True,True,False,0,0,0,,119,1
user_001885,48,<30k,tablet,returning,South,19,True,131,5,0,False,False,False,0,0,0,,131,5
user_001886,46,30k-50k,desktop,returning,West,60,False,0,0,0,True,False,True,146,1,0,6.478692310293597,-146,-1
user_001887,45,100k-150k,tablet,new,West,54,True,140,4,0,False,False,True,129,2,0,6.696548370785689,11,2
user_001888,64,75k-100k,mobile,returning,East,16,True,111,6,0,True,False,True,132,7,0,6.473982828961491,-21,-1
user_001889,58,50k-75k,desktop,new,South,36,False,0,0,0,False,True,True,89,1,0,8.268452713440384,-89,-1
user_001890,53,30k-50k,mobile,returning,West,69,True,68,3,0,False,True,True,54,3,0,9.755561070468362,14,0
user_001891,37,<30k,desktop,returning,East,42,False,0,0,0,False,False,True,130,1,1,7.593866918063821,-130,-1
user_001892,56,75k-100k,mobile,returning,East,27,True,161,5,0,False,False,True,152,6,1,8.280007432092118,9,-1
user_001893,47,<30k,mobile,returning,East,44,True,106,5,1,False,False,False,0,0,0,,106,5
user_001894,55,<30k,desktop,returning,South,8,True,115,3,0,True,True,True,37,1,0,6.843060454198645,78,2
user_001895,40,50k-75k,desktop,returning,West,83,True,86,2,0,False,True,True,71,1,0,9.044762561993174,15,1
user_001896,57,>150k,mobile,returning,South,50,True,99,2,0,False,True,True,61,2,0,7.626385473920483,38,0
user_001897,21,100k-150k,mobile,returning,West,98,True,87,3,1,False,True,True,63,7,0,7.0910790473382725,24,-4
user_001898,57,75k-100k,desktop,returning,East,40,True,66,2,0,False,True,True,39,3,0,7.934461473599756,27,-1
user_001899,47,30k-50k,tablet,new,West,45,True,119,1,0,False,True,True,64,1,0,8.358180883501209,55,0
user_001900,43,75k-100k,mobile,returning,East,32,True,73,2,0,True,False,True,49,2,0,6.97920031420737,24,0
user_001901,57,75k-100k,desktop,returning,Midwest,10,True,106,4,2,True,True,True,97,2,0,6.327560264253608,9,2
user_001902,18,>150k,mobile,returning,Midwest,76,True,30,3,0,False,True,True,33,1,0,6.82781917993966,-3,2
user_001903,43,30k-50k,mobile,returning,Midwest,48,True,104,1,0,True,False,True,68,1,0,7.171412362781841,36,0
user_001904,28,<30k,mobile,returning,South,71,True,105,5,0,False,True,True,95,5,0,8.710121782048917,10,0
user_001905,32,100k-150k,desktop,new,South,73,True,38,1,0,True,True,True,52,1,0,10.0,-14,0
user_001906,52,30k-50k,desktop,returning,East,40,True,100,2,0,False,True,True,53,1,0,7.8495761022650115,47,1
user_001907,38,>150k,desktop,new,West,69,True,126,2,0,True,True,True,81,3,0,10.0,45,-1
user_001908,30,50k-75k,desktop,returning,Midwest,46,False,0,0,0,True,True,True,91,1,0,8.67404056481946,-91,-1
user_001909,38,75k-100k,mobile,new,East,46,True,80,1,1,True,True,True,26,1,0,7.460733584459609,54,0
user_001910,32,100k-150k,desktop,new,West,100,True,64,3,0,False,True,True,60,1,0,10.0,4,2
user_001911,36,50k-75k,mobile,new,South,53,False,0,0,0,False,False,True,130,1,0,7.591881958602332,-130,-1
user_001912,53,30k-50k,mobile,new,South,75,True,99,2,1,True,True,True,84,2,1,6.254765196109842,15,0
user_001913,52,75k-100k,desktop,returning,West,43,True,124,5,0,True,True,True,78,1,0,7.579858947656763,46,4
user_001914,50,50k-75k,tablet,returning,South,40,True,120,1,1,False,True,True,94,1,0,5.769619257084406,26,0
user_001915,40,30k-50k,tablet,new,East,70,True,165,1,0,False,False,True,174,3,0,8.691873292633113,-9,-2
user_001916,28,50k-75k,tablet,returning,Midwest,90,True,86,1,0,True,True,True,86,2,0,7.853168585002128,0,-1
user_001917,27,<30k,desktop,new,West,76,True,76,4,2,False,True,True,48,5,0,8.519230162485126,28,-1
user_001918,48,30k-50k,desktop,new,East,33,True,146,2,0,False,True,True,133,3,0,7.270274206662906,13,-1
user_001919,42,75k-100k,desktop,new,West,48,True,179,2,0,True,True,True,123,3,0,8.227200126082412,56,-1
user_001920,69,100k-150k,mobile,new,West,74,True,111,4,0,False,True,True,129,1,0,9.610356511672569,-18,3
user_001921,59,75k-100k,desktop,returning,West,26,True,112,2,0,False,False,True,143,2,0,6.629416978529753,-31,0
user_001922,48,75k-100k,desktop,returning,Midwest,59,True,38,2,0,True,True,True,48,2,0,4.055089972504737,-10,0
user_001923,64,75k-100k,mobile,returning,South,21,True,93,6,0,True,False,True,100,7,0,6.686451836721439,-7,-1
user_001924,19,75k-100k,mobile,returning,West,95,True,82,3,0,True,True,True,90,4,0,8.097109382515438,-8,-1
user_001925,55,<30k,desktop,returning,West,58,True,105,1,0,False,False,False,0,0,0,,105,1
user_001926,45,30k-50k,mobile,new,South,46,True,143,5,0,False,True,True,132,6,0,7.949180214293638,11,-1
user_001927,36,100k-150k,desktop,returning,East,92,True,111,5,0,True,True,True,109,4,0,9.690049027101407,2,1
user_001928,18,50k-75k,desktop,new,East,60,False,0,0,0,False,True,True,73,1,0,8.563761143399692,-73,-1
user_001929,31,100k-150k,desktop,returning,South,65,True,109,1,0,True,False,True,90,1,0,9.04598033036895,19,0
user_001930,50,100k-150k,desktop,new,West,59,True,163,3,1,False,False,True,199,6,0,6.5658159254043715,-36,-3
user_001931,28,75k-100k,desktop,returning,West,68,True,77,4,0,True,True,True,24,5,0,10.0,53,-1
user_001932,37,50k-75k,desktop,returning,Midwest,44,True,118,4,0,True,True,True,77,3,0,9.247714929435132,41,1
user_001933,57,<30k,desktop,returning,West,44,False,0,0,0,False,False,True,130,1,0,7.056356138849807,-130,-1
user_001934,29,50k-75k,desktop,returning,Midwest,38,True,101,2,0,False,False,True,89,1,0,7.50379062431675,12,1
user_001935,27,30k-50k,mobile,returning,South,59,True,62,3,0,False,True,True,33,3,0,7.836644713082447,29,0
user_001936,66,30k-50k,desktop,new,West,47,True,166,3,1,False,False,True,143,3,0,8.064173283755594,23,0
user_001937,18,30k-50k,desktop,returning,Midwest,54,True,67,5,0,True,True,True,72,3,0,10.0,-5,2
user_001938,36,100k-150k,desktop,new,West,76,True,102,2,0,True,True,True,94,2,0,6.03621184731336,8,0
user_001939,32,30k-50k,desktop,new,South,77,True,87,2,0,True,True,True,62,1,0,6.527871634830813,25,1
user_001940,57,75k-100k,desktop,returning,West,45,True,74,6,0,True,True,True,86,2,0,6.530350351756387,-12,4
user_001941,68,75k-100k,mobile,returning,East,44,False,0,0,0,False,False,False,0,0,0,,0,0
user_001942,48,50k-75k,desktop,returning,Midwest,41,True,57,1,0,True,True,True,20,1,0,9.086103281561385,37,0
user_001943,57,100k-150k,mobile,returning,East,64,True,48,4,0,True,False,True,35,4,0,7.394210398891443,13,0
user_001944,18,<30k,desktop,new,South,47,True,124,3,0,True,True,True,140,3,0,6.918943497979863,-16,0
user_001945,46,30k-50k,mobile,returning,Midwest,41,True,108,3,0,True,True,True,87,2,0,7.475300253737535,21,1
user_001946,51,75k-100k,mobile,returning,West,63,True,70,1,1,True,True,True,65,2,0,7.393850287278586,5,-1
user_001947,34,100k-150k,desktop,returning,East,68,True,52,4,0,True,True,True,55,3,0,10.0,-3,1
user_001948,52,75k-100k,mobile,new,East,28,False,0,0,0,False,False,True,124,1,0,5.535157182044356,-124,-1
user_001949,24,100k-150k,desktop,returning,Midwest,79,True,82,2,0,True,True,True,85,3,0,7.946552571970689,-3,-1
user_001950,38,100k-150k,mobile,new,South,43,True,80,4,1,False,False,True,94,3,1,5.243525699393976,-14,1
user_001951,59,<30k,mobile,new,West,41,True,95,8,0,True,False,True,109,7,2,6.156241156845757,-14,1
user_001952,50,50k-75k,desktop,new,East,34,False,0,0,0,False,False,True,122,1,0,8.092548774294828,-122,-1
user_001953,53,50k-75k,desktop,returning,East,52,True,85,3,0,True,False,True,101,2,1,6.195735829645413,-16,1
user_001954,38,30k-50k,mobile,returning,Midwest,27,True,104,6,0,False,False,True,130,5,0,5.542157301177206,-26,1
user_001955,43,50k-75k,mobile,new,South,68,True,150,3,0,True,True,True,122,3,0,7.928408544392471,28,0
user_001956,66,75k-100k,desktop,new,East,38,False,0,0,0,False,False,True,136,1,0,6.264525580807418,-136,-1
user_001957,32,<30k,tablet,returning,East,51,True,95,2,1,False,True,True,88,3,0,7.506257698109018,7,-1
user_001958,43,75k-100k,tablet,returning,South,64,True,108,1,0,True,True,True,81,1,0,8.25382460856695,27,0
user_001959,40,75k-100k,mobile,returning,West,61,True,97,2,0,True,True,True,99,1,0,9.566119012860995,-2,1
user_001960,80,100k-150k,desktop,new,East,42,False,0,0,0,False,True,True,109,1,0,7.556679327443304,-109,-1
user_001961,52,30k-50k,desktop,new,West,19,True,204,4,0,False,False,True,197,3,0,7.032218785700008,7,1
user_001962,32,<30k,desktop,new,Midwest,50,False,0,0,0,False,True,False,0,0,0,,0,0
user_001963,60,50k-75k,mobile,returning,East,15,True,73,2,2,False,True,True,53,3,0,8.286930416712174,20,-1
user_001964,48,100k-150k,mobile,new,East,81,True,89,2,0,True,True,True,85,2,0,8.435860175415845,4,0
user_001965,45,50k-75k,mobile,returning,East,37,True,109,5,0,False,False,True,157,1,0,8.733867372268383,-48,4
user_001966,28,30k-50k,mobile,returning,East,60,False,0,0,0,False,False,True,138,4,0,5.41737553049555,-138,-4
user_001967,49,100k-150k,desktop,returning,West,73,True,115,3,0,False,True,True,95,2,0,8.398676149220867,20,1
user_001968,29,50k-75k,mobile,returning,South,57,True,53,1,0,True,True,True,66,1,0,7.520330628985868,-13,0
user_001969,35,50k-75k,desktop,returning,South,41,True,66,2,0,False,True,True,32,1,0,8.243945044635169,34,1
user_001970,23,>150k,mobile,returning,Midwest,83,True,75,5,0,False,True,True,43,3,0,7.510354456436036,32,2
user_001971,25,75k-100k,desktop,returning,East,53,True,87,2,0,True,True,True,39,2,1,8.098440206978806,48,0
user_001972,32,>150k,desktop,returning,East,81,True,95,3,0,True,True,True,82,1,0,9.136712358483694,13,2
user_001973,39,50k-75k,desktop,returning,West,68,True,144,2,0,False,False,True,117,4,0,7.560490604054354,27,-2
user_001974,64,<30k,desktop,returning,Midwest,24,False,0,0,0,False,True,True,95,1,0,7.229394945748564,-95,-1
user_001975,44,75k-100k,desktop,returning,South,62,True,59,2,1,True,False,True,60,3,0,8.17854484986269,-1,-1
user_001976,40,50k-75k,desktop,new,East,56,False,0,0,0,False,False,True,83,2,0,7.235802844917543,-83,-2
user_001977,58,50k-75k,desktop,returning,East,0,False,0,0,0,True,True,True,68,1,0,9.923777258548771,-68,-1
user_001978,18,75k-100k,desktop,returning,South,71,True,105,2,0,False,False,False,0,0,0,,105,2
user_001979,37,75k-100k,desktop,returning,West,47,True,113,4,0,True,False,True,151,7,0,5.802926831965519,-38,-3
user_001980,31,30k-50k,desktop,new,South,48,False,0,0,0,False,True,True,88,1,0,9.695258611478284,-88,-1
user_001981,62,50k-75k,mobile,returning,West,42,True,90,3,0,False,False,True,70,2,1,6.326087292127298,20,1
user_001982,37,75k-100k,mobile,returning,Midwest,52,True,71,1,0,True,True,True,53,1,0,6.321133582207481,18,0
user_001983,25,<30k,mobile,returning,Midwest,64,False,0,0,0,True,True,True,105,2,0,5.785515619922867,-105,-2
user_001984,52,50k-75k,desktop,returning,East,38,True,84,2,0,False,True,True,68,1,0,8.434625363656368,16,1
user_001985,55,30k-50k,desktop,new,South,41,True,133,5,1,True,False,True,153,3,0,7.237875768765983,-20,2
user_001986,45,100k-150k,mobile,returning,West,88,True,90,5,0,False,True,True,75,8,0,10.0,15,-3
user_001987,56,<30k,mobile,returning,South,26,True,67,2,0,True,False,True,90,3,1,7.76487843545928,-23,-1
user_001988,42,50k-75k,mobile,returning,West,67,True,82,1,0,True,True,True,80,1,0,7.843112261585248,2,0
user_001989,39,<30k,desktop,returning,South,29,True,155,1,0,False,False,True,170,1,0,8.331829953743998,-15,0
user_001990,46,50k-75k,desktop,returning,West,65,True,107,2,0,True,True,True,54,2,0,9.546690906269774,53,0
user_001991,60,100k-150k,desktop,returning,South,48,True,63,1,1,True,True,True,47,1,0,6.801151409603393,16,0
user_001992,36,>150k,desktop,returning,West,63,True,87,5,0,True,True,True,61,1,0,6.658990808655013,26,4
user_001993,46,30k-50k,mobile,returning,West,55,True,68,3,0,False,False,True,91,3,0,9.904830954248776,-23,0
user_001994,73,50k-75k,mobile,returning,South,15,True,106,5,0,True,True,True,96,2,0,7.037183156463151,10,3
user_001995,48,>150k,desktop,returning,Midwest,40,True,68,3,0,False,True,True,80,1,0,8.073451861993512,-12,2
user_001996,46,>150k,desktop,returning,East,57,True,72,1,0,False,True,True,45,3,0,7.4456779443674685,27,-2
user_001997,35,30k-50k,mobile,returning,East,63,True,54,6,0,True,False,True,20,6,0,5.889657886165662,34,0
user_001998,61,30k-50k,tablet,returning,Midwest,60,True,100,7,0,True,False,True,102,14,0,6.009827833394914,-2,-7
user_001999,47,100k-150k,desktop,returning,South,40,True,118,1,1,True,False,True,113,2,0,8.266235948112366,5,-1
user_002000,33,>150k,desktop,returning,Midwest,72,True,30,3,2,True,True,True,20,2,1,8.986687914470087,10,1
user_002001,48,50k-75k,desktop,new,West,58,True,192,1,0,True,True,True,164,1,0,7.01960631337499,28,0
user_002002,38,75k-100k,mobile,new,East,19,True,187,4,0,False,False,True,165,2,0,6.926725410764128,22,2
user_002003,58,30k-50k,mobile,new,South,50,True,89,2,0,True,True,True,66,2,0,8.532541544853883,23,0
user_002004,47,50k-75k,desktop,returning,West,37,False,0,0,0,True,True,True,76,2,1,7.686340853353433,-76,-2
user_002005,52,<30k,mobile,returning,East,10,True,163,3,1,True,True,True,111,2,0,7.753750031024593,52,1
user_002006,46,>150k,mobile,returning,West,64,False,0,0,0,True,True,True,93,1,0,8.385605529078068,-93,-1
user_002007,30,<30k,mobile,new,Midwest,64,True,101,3,0,False,False,True,71,2,0,7.396037043150373,30,1
user_002008,33,75k-100k,mobile,returning,East,66,True,63,5,0,True,True,True,74,5,0,8.859663328267457,-11,0
user_002009,59,<30k,desktop,returning,Midwest,31,False,0,0,0,False,True,False,0,0,0,,0,0
user_002010,42,30k-50k,mobile,new,East,47,True,122,3,0,False,True,True,104,2,0,8.60884529021811,18,1
user_002011,31,100k-150k,mobile,returning,Midwest,81,True,71,1,0,True,True,True,20,2,0,8.58932909562666,51,-1
user_002012,72,30k-50k,mobile,returning,West,53,True,74,2,0,False,True,True,100,1,0,7.388386895098306,-26,1
user_002013,55,50k-75k,mobile,returning,South,32,True,49,6,0,True,True,True,75,6,0,6.509799575297248,-26,0
user_002014,44,75k-100k,mobile,new,East,48,True,133,1,0,False,False,True,159,1,0,5.929450132485197,-26,0
user_002015,38,50k-75k,desktop,new,South,60,True,125,4,0,True,False,True,118,1,0,9.295010635813089,7,3
user_002016,45,<30k,desktop,returning,South,37,True,128,4,0,False,False,False,0,0,0,,128,4
user_002017,64,30k-50k,mobile,new,East,38,True,141,5,2,False,False,True,167,3,0,7.966510502962126,-26,2
user_002018,45,50k-75k,desktop,returning,South,44,True,86,1,0,True,False,True,88,3,0,4.795605119771104,-2,-2
user_002019,44,75k-100k,mobile,new,South,37,True,122,3,0,False,False,True,174,1,0,7.34065704102213,-52,2
user_002020,49,30k-50k,desktop,returning,East,49,True,96,1,0,False,False,True,102,1,0,4.693381892321898,-6,0
user_002021,69,75k-100k,desktop,returning,West,35,True,54,1,0,False,False,True,50,1,0,7.939570889584881,4,0
user_002022,52,<30k,mobile,new,East,42,True,91,6,0,True,True,True,74,4,1,8.22899031790728,17,2
user_002023,39,30k-50k,desktop,returning,South,41,True,88,4,0,True,True,True,50,2,0,5.95691699246565,38,2
user_002024,30,<30k,desktop,returning,Midwest,47,True,94,3,2,False,True,True,60,1,0,7.494446366833049,34,2
user_002025,26,50k-75k,desktop,returning,East,55,True,77,1,0,True,True,False,0,0,0,,77,1
user_002026,32,30k-50k,mobile,new,East,87,True,104,4,0,False,True,True,105,7,1,7.482760422933683,-1,-3
user_002027,37,75k-100k,desktop,returning,South,30,True,60,4,0,True,False,True,84,4,0,7.162540851491809,-24,0
user_002028,73,30k-50k,desktop,returning,East,40,False,0,0,0,True,False,True,130,1,0,5.7501175428271,-130,-1
user_002029,24,50k-75k,desktop,returning,West,89,True,74,2,0,True,True,True,72,2,0,7.718653798711924,2,0
user_002030,30,50k-75k,tablet,returning,East,58,True,105,3,0,True,False,True,114,4,0,7.196417043096401,-9,-1
user_002031,28,50k-75k,mobile,returning,West,69,True,100,2,0,True,True,True,92,3,0,9.440452229956593,8,-1
user_002032,22,>150k,desktop,new,West,96,True,84,7,1,False,True,True,70,4,0,7.080689149908732,14,3
user_002033,56,50k-75k,desktop,returning,Midwest,31,True,105,2,0,False,True,True,80,1,0,8.767770075788807,25,1
user_002034,52,100k-150k,desktop,new,East,48,True,91,1,0,True,True,True,46,1,0,9.775629429061425,45,0
user_002035,47,50k-75k,mobile,new,East,64,True,174,3,0,True,True,True,119,3,0,10.0,55,0
user_002036,38,75k-100k,mobile,returning,East,52,False,0,0,0,True,True,True,115,1,1,8.470063218065604,-115,-1
user_002037,36,50k-75k,mobile,new,South,30,False,0,0,0,False,True,True,74,1,0,6.505325104887586,-74,-1
user_002038,38,50k-75k,desktop,returning,Midwest,57,True,114,2,0,True,True,True,118,2,0,7.98835309488144,-4,0
user_002039,61,50k-75k,mobile,returning,West,27,True,175,5,0,False,False,True,155,6,0,4.977868872256555,20,-1
user_002040,46,50k-75k,mobile,returning,West,17,False,0,0,0,False,True,True,111,1,0,7.656008081873465,-111,-1
user_002041,39,100k-150k,mobile,returning,Midwest,70,True,101,4,0,True,True,True,44,1,0,8.034515116162877,57,3
user_002042,60,30k-50k,mobile,returning,East,12,True,59,5,0,False,True,True,20,1,0,7.591520505681037,39,4
user_002043,38,30k-50k,desktop,returning,East,59,True,96,4,0,False,True,False,0,0,0,,96,4
user_002044,64,<30k,desktop,returning,Midwest,29,True,132,3,0,False,False,True,174,2,0,8.343154442004579,-42,1
user_002045,18,<30k,mobile,returning,East,52,True,101,4,0,False,False,True,58,6,0,5.251246783520637,43,-2
user_002046,42,75k-100k,mobile,returning,West,52,True,101,6,0,False,True,True,78,10,0,6.363220501769824,23,-4
user_002047,28,30k-50k,desktop,new,West,100,True,113,1,0,True,True,True,51,1,0,8.874671310316826,62,0
user_002048,37,<30k,mobile,returning,Midwest,1,False,0,0,0,False,False,True,126,2,0,6.158446142058556,-126,-2
user_002049,50,30k-50k,mobile,returning,South,39,True,77,3,0,True,False,True,68,3,1,7.349732523236928,9,0
user_002050,43,<30k,mobile,new,West,62,False,0,0,0,False,True,False,0,0,0,,0,0
user_002051,52,<30k,tablet,returning,South,48,True,71,1,0,True,True,True,55,1,1,6.080643619097349,16,0
user_002052,32,100k-150k,desktop,new,South,62,True,82,3,0,True,True,True,58,2,0,9.377893884444626,24,1
user_002053,51,<30k,desktop,new,East,38,False,0,0,0,False,False,False,0,0,0,,0,0
user_002054,65,30k-50k,desktop,returning,East,24,True,145,3,0,False,False,True,191,3,0,6.497248809463287,-46,0
user_002055,64,100k-150k,desktop,new,South,16,True,165,4,0,False,False,True,165,1,1,6.7306297213612645,0,3
user_002056,62,100k-150k,mobile,returning,Midwest,40,True,54,7,0,True,True,True,41,7,0,7.94136884343239,13,0
user_002057,64,<30k,mobile,returning,East,14,True,158,1,0,False,False,True,156,1,0,8.186905830656745,2,0
user_002058,40,75k-100k,desktop,returning,South,22,True,154,7,0,False,False,True,145,13,0,9.864279162382962,9,-6
user_002059,38,30k-50k,desktop,new,East,49,True,69,4,0,False,False,True,74,9,1,8.125483206973533,-5,-5
user_002060,33,<30k,desktop,returning,South,58,False,0,0,0,False,False,False,0,0,0,,0,0
user_002061,39,75k-100k,tablet,returning,Midwest,22,True,111,1,0,False,False,True,110,2,0,5.785766602872094,1,-1
user_002062,32,100k-150k,mobile,new,East,100,True,105,1,0,False,True,True,78,1,0,8.072341593428085,27,0
user_002063,55,100k-150k,mobile,returning,Midwest,42,True,97,1,0,False,False,True,95,1,0,7.344601879018994,2,0
user_002064,66,30k-50k,mobile,new,South,33,True,172,6,0,False,False,True,177,4,0,8.499507982795583,-5,2
user_002065,57,30k-50k,desktop,returning,South,43,True,109,1,1,False,False,True,108,1,0,9.5064016260644,1,0
user_002066,31,<30k,desktop,returning,South,41,True,79,5,0,False,False,True,73,9,0,6.4438334230399805,6,-4
user_002067,61,50k-75k,mobile,new,South,32,True,120,3,0,False,True,True,96,3,0,5.728613023192926,24,0
user_002068,42,100k-150k,mobile,returning,West,86,True,40,1,0,False,True,True,25,1,0,9.135419102472644,15,0
user_002069,63,50k-75k,mobile,returning,East,27,True,96,2,1,False,True,True,64,1,0,7.83594998715765,32,1
user_002070,55,100k-150k,mobile,returning,South,43,True,79,6,0,True,True,True,94,5,0,7.409001917822492,-15,1
user_002071,52,50k-75k,desktop,returning,West,28,False,0,0,0,False,False,True,116,1,0,5.120161534246314,-116,-1
user_002072,53,100k-150k,mobile,returning,East,54,True,76,2,1,True,True,True,49,1,1,7.304991498517144,27,1
user_002073,62,<30k,desktop,new,East,56,True,115,1,0,False,False,False,0,0,0,,115,1
user_002074,45,50k-75k,mobile,new,East,61,False,0,0,0,True,True,True,76,1,0,8.82957002008235,-76,-1
user_002075,45,50k-75k,desktop,new,East,51,True,149,1,1,True,True,True,105,1,0,8.637844878199905,44,0
user_002076,38,30k-50k,mobile,new,South,22,True,145,7,1,True,True,True,146,5,0,6.850994923822714,-1,2
user_002077,21,100k-150k,desktop,returning,East,90,True,45,1,0,False,True,True,43,1,0,8.41053725572669,2,0
user_002078,30,<30k,desktop,new,West,21,True,160,1,0,False,True,True,121,2,0,9.84176395577827,39,-1
user_002079,38,<30k,mobile,returning,Midwest,13,True,124,5,1,False,False,True,140,4,0,5.117978673822059,-16,1
user_002080,70,50k-75k,desktop,new,West,43,False,0,0,0,False,False,True,151,2,0,5.456339167651787,-151,-2
user_002081,18,<30k,mobile,new,West,67,True,101,5,0,False,False,True,67,4,0,8.266121237263793,34,1
user_002082,36,100k-150k,desktop,returning,East,64,True,70,2,0,False,True,True,50,1,0,6.4754837754956975,20,1
user_002083,51,100k-150k,tablet,new,West,61,True,120,1,1,True,True,True,88,1,0,7.989807370603954,32,0
user_002084,68,75k-100k,desktop,returning,East,48,True,65,2,0,True,False,True,87,2,0,4.728763315284333,-22,0
user_002085,63,50k-75k,desktop,returning,Midwest,53,True,128,5,0,False,False,True,140,2,0,8.48193702009633,-12,3
user_002086,21,75k-100k,desktop,returning,Midwest,60,True,103,1,0,True,True,True,96,1,0,9.397574953541424,7,0
user_002087,26,<30k,desktop,returning,South,30,True,115,2,0,True,False,False,0,0,0,,115,2
user_002088,68,30k-50k,mobile,returning,West,58,True,92,6,0,True,False,True,95,8,0,7.726154789166363,-3,-2
user_002089,41,50k-75k,desktop,returning,East,42,True,127,1,0,False,True,True,59,1,0,8.21740751132571,68,0
user_002090,18,>150k,desktop,returning,South,72,True,30,3,0,False,True,True,35,1,0,8.088008378798436,-5,2
user_002091,36,100k-150k,desktop,returning,East,72,True,65,1,0,True,True,True,28,1,0,8.695190746049345,37,0
user_002092,36,50k-75k,tablet,new,South,44,False,0,0,0,False,False,True,126,3,0,8.081465316936727,-126,-3
user_002093,43,75k-100k,mobile,returning,West,63,True,102,6,0,False,True,True,74,6,0,7.152530873605731,28,0
user_002094,44,30k-50k,mobile,returning,Midwest,70,True,62,2,0,False,True,True,61,3,0,9.884138576999872,1,-1
user_002095,28,50k-75k,mobile,returning,West,75,True,43,2,1,True,True,True,52,1,0,6.383678026748375,-9,1
user_002096,66,75k-100k,mobile,new,West,49,True,123,2,0,True,True,True,107,1,0,9.164140551066707,16,1
user_002097,34,30k-50k,mobile,returning,Midwest,54,True,95,6,0,False,False,True,94,2,0,5.628406264086686,1,4
user_002098,36,100k-150k,tablet,returning,South,51,True,72,1,0,True,True,True,73,2,0,9.965100202126777,-1,-1
user_002099,32,30k-50k,mobile,returning,South,73,True,87,6,0,False,True,True,74,5,0,10.0,13,1
user_002100,39,100k-150k,desktop,new,South,56,True,153,1,0,True,False,True,173,2,0,9.375676798182894,-20,-1
user_002101,32,75k-100k,desktop,new,East,80,True,74,3,1,True,True,True,81,2,0,8.017589006390297,-7,1
user_002102,49,<30k,mobile,new,West,30,False,0,0,0,False,False,True,118,1,0,6.879502710223165,-118,-1
user_002103,44,30k-50k,desktop,new,East,45,True,98,2,0,False,False,True,156,2,0,5.3524970146008375,-58,0
user_002104,47,<30k,tablet,returning,East,28,True,131,4,0,True,False,True,118,10,0,7.634172596953155,13,-6
user_002105,55,75k-100k,mobile,returning,South,54,True,112,6,0,True,True,True,135,5,0,8.708924891163358,-23,1
user_002106,55,100k-150k,desktop,returning,Midwest,74,True,68,2,0,True,True,True,61,1,0,10.0,7,1
user_002107,32,>150k,mobile,returning,East,74,True,72,2,0,True,True,True,78,2,0,7.617033583230915,-6,0
user_002108,32,75k-100k,mobile,returning,Midwest,52,True,45,2,0,False,False,True,58,1,0,6.345488848874907,-13,1
user_002109,46,75k-100k,desktop,returning,South,52,True,129,2,1,False,False,True,125,2,0,5.604250597289583,4,0
user_002110,44,100k-150k,desktop,returning,West,82,True,35,4,0,True,True,True,41,7,0,9.411380722365797,-6,-3
user_002111,34,75k-100k,mobile,returning,East,64,True,131,4,0,True,True,True,93,1,0,10.0,38,3
user_002112,22,100k-150k,mobile,new,West,100,True,147,1,0,True,True,True,150,1,0,7.890033322946896,-3,0
user_002113,36,30k-50k,desktop,returning,West,49,True,74,2,0,False,False,True,68,2,0,6.780575342072735,6,0
user_002114,32,>150k,mobile,returning,West,94,True,55,9,1,True,True,False,0,0,0,,55,9
user_002115,69,<30k,desktop,returning,West,14,True,143,1,0,True,True,True,155,2,0,5.956385591125383,-12,-1
user_002116,45,>150k,desktop,returning,Midwest,43,True,74,3,0,False,False,True,80,2,0,6.06000522079288,-6,1
user_002117,38,30k-50k,mobile,returning,West,87,True,46,2,0,True,True,True,67,3,0,8.686872326835822,-21,-1
user_002118,55,50k-75k,mobile,new,Midwest,39,True,115,2,1,False,False,False,0,0,0,,115,2
user_002119,28,<30k,desktop,returning,East,44,True,84,2,0,False,True,True,85,1,0,8.997798740468074,-1,1
user_002120,35,30k-50k,desktop,returning,Midwest,56,True,117,3,0,True,True,True,122,4,0,10.0,-5,-1
user_002121,57,75k-100k,desktop,returning,East,39,True,130,5,0,False,False,True,138,6,0,8.713165211424293,-8,-1
user_002122,50,50k-75k,mobile,returning,East,52,True,83,6,1,False,True,True,69,4,0,6.023332590164991,14,2
user_002123,49,50k-75k,desktop,returning,West,57,True,125,4,0,False,True,True,89,4,0,6.969916094526105,36,0
user_002124,54,75k-100k,mobile,new,Midwest,52,True,119,2,0,True,True,True,102,1,0,9.953889912924605,17,1
user_002125,30,30k-50k,desktop,returning,Midwest,68,True,99,3,0,True,True,True,60,2,0,7.919928182634626,39,1
user_002126,61,>150k,mobile,new,South,50,True,113,3,0,False,False,True,114,4,0,7.151629850326443,-1,-1
user_002127,38,50k-75k,mobile,returning,West,68,True,88,3,0,True,True,True,93,3,0,9.825621153436387,-5,0
user_002128,69,100k-150k,mobile,returning,South,42,False,0,0,0,False,True,True,64,1,0,5.616008142627794,-64,-1
user_002129,36,100k-150k,desktop,returning,East,58,False,0,0,0,False,False,True,109,1,0,8.057160674508214,-109,-1
user_002130,49,50k-75k,mobile,new,West,77,True,46,6,0,True,True,True,47,7,0,6.548745420491825,-1,-1
user_002131,27,50k-75k,desktop,new,South,71,True,131,4,0,True,True,True,114,4,0,7.14568834658881,17,0
user_002132,38,75k-100k,desktop,returning,South,33,True,91,2,1,True,False,True,69,2,0,7.556278888093722,22,0
user_002133,42,<30k,mobile,new,South,23,True,164,4,0,False,False,False,0,0,0,,164,4
user_002134,42,50k-75k,desktop,returning,South,33,True,69,2,0,False,False,True,82,2,0,7.5844810566110406,-13,0
user_002135,56,75k-100k,mobile,new,Midwest,43,True,84,2,0,False,False,True,89,4,1,6.644704245593889,-5,-2
user_002136,48,>150k,desktop,returning,East,43,True,70,1,0,True,True,True,58,1,0,8.776102648355936,12,0
user_002137,19,75k-100k,desktop,returning,West,94,True,60,4,0,True,True,True,81,4,0,9.295424992449599,-21,0
user_002138,31,<30k,mobile,new,South,40,True,127,3,0,True,True,True,106,3,0,9.195453350323582,21,0
user_002139,47,>150k,mobile,new,East,53,True,130,4,0,False,False,True,121,4,0,6.076143645070859,9,0
user_002140,44,30k-50k,mobile,returning,East,62,True,148,1,1,True,True,True,119,1,0,9.456253720284389,29,0
user_002141,42,50k-75k,desktop,new,West,92,True,94,5,0,False,False,True,107,5,0,8.882452244927629,-13,0
user_002142,50,75k-100k,desktop,returning,Midwest,45,True,123,2,0,False,False,True,126,1,0,5.626832541378947,-3,1
user_002143,32,100k-150k,desktop,new,South,69,True,139,1,0,False,True,True,107,1,0,7.736096302120712,32,0
user_002144,36,100k-150k,mobile,returning,West,87,True,33,4,0,True,True,True,20,2,0,8.998598968188984,13,2
user_002145,64,50k-75k,mobile,returning,East,30,True,70,5,0,False,False,True,41,2,0,9.523875128231374,29,3
user_002146,34,100k-150k,mobile,returning,South,55,True,117,7,0,False,True,True,131,6,0,8.83145099403606,-14,1
user_002147,35,50k-75k,mobile,new,West,62,False,0,0,0,True,False,True,119,1,0,10.0,-119,-1
user_002148,27,30k-50k,mobile,new,West,100,True,40,7,0,False,True,True,20,6,0,6.921528279516567,20,1
user_002149,64,75k-100k,desktop,new,South,29,True,186,1,1,False,False,True,190,2,1,6.919937634977385,-4,-1
user_002150,18,50k-75k,tablet,returning,South,89,True,96,1,0,True,True,True,84,1,0,9.763665635893032,12,0
user_002151,36,75k-100k,desktop,returning,East,59,True,125,3,0,False,False,True,158,1,0,7.996727839086704,-33,2
user_002152,50,50k-75k,mobile,new,South,30,True,147,3,0,False,False,True,148,3,0,6.581854819207403,-1,0
user_002153,52,50k-75k,mobile,new,Midwest,36,False,0,0,0,True,False,True,98,1,0,9.187299157512232,-98,-1
user_002154,32,>150k,mobile,new,East,99,True,91,2,0,True,True,True,64,2,0,10.0,27,0
user_002155,51,<30k,desktop,returning,East,38,True,38,4,0,False,True,True,47,3,0,9.064639418090822,-9,1
user_002156,54,75k-100k,desktop,returning,South,49,True,92,1,0,False,True,True,49,1,0,8.622902648742624,43,0
user_002157,34,75k-100k,desktop,new,East,84,True,125,2,0,False,True,True,108,2,0,9.841461270388114,17,0
user_002158,50,50k-75k,mobile,returning,West,77,True,56,2,0,True,True,True,38,5,0,9.658869104681587,18,-3
user_002159,36,30k-50k,desktop,new,East,47,True,122,6,0,False,True,True,95,7,0,7.774647685437391,27,-1
user_002160,25,>150k,mobile,returning,East,100,True,101,3,0,True,True,True,94,4,0,9.416486470087545,7,-1
user_002161,25,75k-100k,desktop,returning,West,93,True,70,2,0,False,True,True,81,2,0,8.640764361872552,-11,0
user_002162,29,<30k,mobile,returning,East,76,True,91,3,0,True,True,True,71,1,0,6.865439192580391,20,2
user_002163,64,30k-50k,mobile,returning,Midwest,15,True,82,5,1,True,False,True,66,5,0,5.922538240679156,16,0
user_002164,25,50k-75k,desktop,returning,Midwest,79,False,0,0,0,False,False,True,87,1,0,7.107924638065381,-87,-1
user_002165,27,<30k,mobile,returning,South,50,True,80,4,0,True,True,True,51,4,0,8.60659542827705,29,0
user_002166,39,75k-100k,desktop,returning,Midwest,47,True,86,5,0,True,False,True,68,8,0,6.533842404799582,18,-3
user_002167,38,50k-75k,desktop,new,South,29,True,129,2,0,False,False,True,118,1,0,5.127199071336941,11,1
user_002168,57,75k-100k,mobile,returning,South,4,True,119,2,1,True,False,True,109,1,0,7.9765036132942315,10,1
user_002169,39,<30k,mobile,new,East,52,True,92,4,0,False,False,False,0,0,0,,92,4
user_002170,58,50k-75k,mobile,returning,South,8,True,105,1,0,False,False,True,119,1,0,7.580770035205026,-14,0
user_002171,51,50k-75k,mobile,returning,South,36,False,0,0,0,True,False,True,116,1,0,6.746662801924186,-116,-1
user_002172,55,75k-100k,desktop,returning,South,53,True,113,3,0,False,True,True,100,2,0,7.849814191983759,13,1
user_002173,54,100k-150k,desktop,returning,South,54,True,61,1,0,True,True,True,20,1,0,7.764843152279449,41,0
user_002174,43,50k-75k,mobile,new,West,35,False,0,0,0,True,False,False,0,0,0,,0,0
user_002175,80,75k-100k,tablet,returning,East,57,True,114,1,0,False,True,True,129,1,0,8.710376876427159,-15,0
user_002176,49,50k-75k,mobile,new,West,51,True,136,3,1,False,True,True,85,3,1,5.634208677998011,51,0
user_002177,43,30k-50k,desktop,returning,South,47,True,151,3,0,False,True,True,90,3,0,9.220147568146887,61,0
user_002178,41,50k-75k,mobile,returning,South,62,True,148,2,1,True,True,True,102,2,0,7.617540186374628,46,0
user_002179,64,75k-100k,mobile,new,South,28,True,146,7,0,False,False,True,132,7,0,8.37839816767987,14,0
user_002180,63,100k-150k,desktop,new,South,41,True,118,4,0,False,False,True,138,3,0,4.194684673801186,-20,1
user_002181,40,50k-75k,desktop,returning,West,69,True,173,5,0,True,True,True,159,6,0,6.673127165908756,14,-1
user_002182,36,50k-75k,mobile,new,East,41,True,122,1,0,False,True,True,103,2,0,10.0,19,-1
user_002183,49,30k-50k,desktop,returning,Midwest,57,True,65,3,2,False,True,True,65,1,0,8.40330639195861,0,2
user_002184,34,75k-100k,desktop,returning,Midwest,76,True,77,2,0,False,False,True,96,5,0,7.540965188614658,-19,-3
user_002185,55,75k-100k,mobile,new,West,71,True,91,5,1,False,True,False,0,0,0,,91,5
user_002186,51,100k-150k,mobile,returning,Midwest,45,True,110,3,0,False,False,True,127,4,0,10.0,-17,-1
user_002187,40,<30k,mobile,returning,Midwest,29,True,127,5,0,True,False,True,130,9,0,5.575182932359708,-3,-4
user_002188,33,30k-50k,mobile,new,East,99,True,94,6,0,False,True,True,46,3,0,8.048078951701383,48,3
user_002189,62,75k-100k,desktop,new,West,72,True,53,2,0,False,False,True,49,3,0,9.429950581032402,4,-1
user_002190,32,>150k,desktop,returning,East,77,True,99,4,0,False,True,True,81,4,0,10.0,18,0
user_002191,48,<30k,mobile,new,West,50,True,165,4,1,False,False,True,176,4,0,5.423633894658779,-11,0
user_002192,41,50k-75k,desktop,new,West,43,True,114,5,0,True,True,True,79,4,0,7.457531133874809,35,1
user_002193,32,30k-50k,mobile,new,East,50,True,129,2,0,False,False,True,113,1,0,8.140115866026344,16,1
user_002194,58,<30k,mobile,returning,East,31,True,112,7,0,True,False,False,0,0,0,,112,7
user_002195,50,<30k,desktop,returning,South,45,True,93,4,0,True,False,True,101,5,0,6.879603657931736,-8,-1
user_002196,51,75k-100k,desktop,returning,South,58,True,124,4,0,False,True,True,92,1,0,8.632814664192736,32,3
user_002197,33,30k-50k,mobile,returning,Midwest,58,False,0,0,0,True,True,True,108,1,0,8.504067912283825,-108,-1
user_002198,23,100k-150k,desktop,returning,Midwest,65,True,96,3,1,False,True,True,100,1,0,7.930493878028859,-4,2
user_002199,80,<30k,desktop,new,Midwest,27,False,0,0,0,False,False,False,0,0,0,,0,0
user_002200,43,100k-150k,mobile,returning,West,67,False,0,0,0,True,True,True,118,1,0,8.375324941460963,-118,-1
user_002201,46,<30k,desktop,returning,West,43,False,0,0,0,True,True,True,79,1,0,7.394737826810502,-79,-1
user_002202,24,100k-150k,mobile,returning,South,88,True,57,5,0,False,True,True,30,8,0,10.0,27,-3
user_002203,45,75k-100k,desktop,returning,Midwest,54,True,57,1,0,False,True,True,32,1,0,8.127372062641415,25,0
user_002204,32,75k-100k,mobile,returning,South,66,True,76,1,1,True,True,True,62,1,0,8.771308288862695,14,0
user_002205,41,>150k,desktop,new,South,69,True,140,1,1,False,False,True,144,2,0,7.543970606409205,-4,-1
user_002206,33,75k-100k,mobile,returning,East,43,True,69,2,0,True,True,True,73,2,0,7.911941013904197,-4,0
user_002207,44,<30k,desktop,new,East,54,False,0,0,0,True,False,True,106,1,0,9.86313143203972,-106,-1
user_002208,52,50k-75k,tablet,returning,West,59,True,100,3,0,False,False,True,139,5,0,6.884604008134663,-39,-2
user_002209,57,50k-75k,mobile,new,West,56,True,91,3,0,False,False,True,100,3,0,8.547705152298565,-9,0
user_002210,54,>150k,desktop,new,West,70,False,0,0,0,True,True,True,107,2,0,7.9088663259969785,-107,-2
user_002211,52,50k-75k,mobile,returning,South,9,True,56,4,1,False,False,True,53,6,0,5.246400366312115,3,-2
user_002212,46,100k-150k,tablet,new,West,62,True,135,6,0,True,True,True,103,7,0,7.7692479716066165,32,-1
user_002213,35,<30k,mobile,new,East,23,True,166,2,0,True,True,True,111,1,0,10.0,55,1
user_002214,33,100k-150k,desktop,new,West,100,False,0,0,0,False,True,True,76,2,0,9.092453869123242,-76,-2
user_002215,51,75k-100k,mobile,new,East,53,False,0,0,0,False,True,True,47,2,0,7.311612823036092,-47,-2
user_002216,40,<30k,desktop,new,East,52,False,0,0,0,False,True,True,64,1,0,8.542689959369802,-64,-1
user_002217,41,100k-150k,desktop,returning,South,54,True,117,2,0,True,False,True,125,1,0,7.738881915388855,-8,1
user_002218,43,50k-75k,mobile,returning,East,58,True,59,2,0,True,True,True,83,1,0,8.142771384549084,-24,1
user_002219,18,75k-100k,desktop,returning,West,79,True,92,2,1,True,True,True,70,2,0,6.865017911960416,22,0
user_002220,50,50k-75k,mobile,returning,East,50,True,110,4,0,False,True,True,102,1,0,8.640414262218009,8,3
user_002221,24,<30k,desktop,returning,West,78,False,0,0,0,True,False,False,0,0,0,,0,0
user_002222,36,100k-150k,mobile,new,Midwest,47,True,103,6,0,True,True,True,51,2,0,10.0,52,4
user_002223,73,50k-75k,mobile,returning,Midwest,42,True,69,4,0,True,True,True,79,6,0,7.382883214482347,-10,-2
user_002224,36,30k-50k,mobile,returning,South,22,False,0,0,0,True,True,True,84,3,0,8.723829022160588,-84,-3
user_002225,41,50k-75k,desktop,returning,West,61,False,0,0,0,False,True,True,90,1,0,7.707101415291052,-90,-1
user_002226,38,50k-75k,desktop,returning,West,81,True,52,7,0,True,True,True,63,1,0,6.728610132374519,-11,6
user_002227,25,30k-50k,desktop,returning,South,46,True,112,2,0,False,True,True,121,1,0,5.667461627822259,-9,1
user_002228,36,>150k,desktop,new,West,74,True,181,3,1,False,True,True,164,2,0,5.970160595079016,17,1
user_002229,32,50k-75k,mobile,returning,East,72,True,82,2,0,False,True,True,69,1,0,10.0,13,1
user_002230,63,75k-100k,tablet,returning,Midwest,29,True,84,4,0,False,False,True,79,1,0,6.71581448977391,5,3
user_002231,37,100k-150k,tablet,returning,South,50,True,67,1,0,False,True,True,71,1,0,7.372993884662065,-4,0
user_002232,53,<30k,mobile,returning,South,53,True,105,2,0,False,False,True,99,1,0,7.9715985462682,6,1
user_002233,62,50k-75k,desktop,returning,South,45,True,86,7,0,False,False,True,56,7,0,8.245868415497826,30,0
user_002234,44,50k-75k,desktop,new,East,72,True,124,2,0,False,True,True,110,1,0,8.97264276239485,14,1
user_002235,64,100k-150k,mobile,returning,South,1,True,97,2,0,False,True,True,72,2,0,5.652952030094043,25,0
user_002236,49,30k-50k,mobile,returning,West,65,True,77,4,2,True,False,True,71,3,0,6.460951979945176,6,1
user_002237,35,30k-50k,desktop,returning,West,36,True,67,3,0,True,True,True,34,4,0,7.022930981837628,33,-1
user_002238,54,75k-100k,desktop,returning,South,65,True,57,3,0,False,False,True,31,1,2,6.814359413974815,26,2
user_002239,47,75k-100k,mobile,returning,Midwest,64,True,77,2,0,False,False,True,77,1,1,7.327574677333055,0,1
user_002240,63,30k-50k,desktop,returning,Midwest,28,True,143,6,1,True,False,False,0,0,0,,143,6
user_002241,51,75k-100k,desktop,new,South,52,True,118,4,0,False,False,True,127,9,0,7.84442605135858,-9,-5
user_002242,47,30k-50k,desktop,new,East,32,True,130,1,0,False,True,True,119,2,0,7.796957681468673,11,-1
user_002243,47,75k-100k,mobile,returning,South,41,True,116,3,0,False,True,True,82,4,0,9.051713205488397,34,-1
user_002244,59,30k-50k,mobile,new,South,26,True,216,4,0,False,False,True,223,6,0,6.989724558470673,-7,-2
user_002245,36,50k-75k,mobile,returning,West,67,True,90,3,1,True,True,True,49,2,0,7.314282872859546,41,1
user_002246,38,30k-50k,desktop,returning,East,56,True,70,1,1,True,False,True,87,1,1,7.320177259292427,-17,0
user_002247,40,100k-150k,desktop,new,East,50,True,95,3,0,False,True,True,53,2,0,6.375835308686134,42,1
user_002248,79,30k-50k,desktop,returning,West,64,True,54,2,0,True,False,True,67,2,0,7.666995424156312,-13,0
user_002249,36,100k-150k,desktop,returning,East,63,True,121,1,0,True,False,True,116,1,0,7.093383178895244,5,0
user_002250,36,50k-75k,mobile,returning,West,43,True,101,1,1,False,True,True,90,1,0,7.71816690379378,11,0
user_002251,54,75k-100k,mobile,returning,East,89,True,51,6,0,False,True,False,0,0,0,,51,6
user_002252,52,100k-150k,desktop,returning,West,61,True,30,3,0,False,True,True,25,3,0,7.511910379222887,5,0
user_002253,39,50k-75k,mobile,new,South,58,True,105,5,0,False,False,True,93,4,0,7.888996740893945,12,1
user_002254,42,100k-150k,desktop,returning,East,50,True,39,2,0,False,False,True,44,2,0,6.645858023144681,-5,0
user_002255,33,50k-75k,desktop,new,South,55,True,118,3,0,False,True,True,116,2,0,8.449856668841367,2,1
user_002256,80,50k-75k,desktop,returning,South,35,True,116,7,0,False,True,True,106,8,0,9.15803018452069,10,-1
user_002257,44,75k-100k,mobile,returning,South,41,True,100,1,0,True,True,True,84,1,0,6.154007100244173,16,0
user_002258,67,100k-150k,mobile,returning,South,0,True,125,4,0,False,False,True,119,2,0,8.59707108904807,6,2
user_002259,62,100k-150k,desktop,new,West,59,True,113,2,0,False,True,True,108,1,0,7.9735463185527955,5,1
user_002260,67,100k-150k,tablet,returning,Midwest,40,False,0,0,0,False,True,True,105,1,0,6.536939441678769,-105,-1
user_002261,18,75k-100k,desktop,new,South,54,True,106,1,0,False,True,True,64,1,0,7.058111813879804,42,0
user_002262,31,75k-100k,desktop,new,South,56,False,0,0,0,False,False,True,105,5,1,8.466853523696306,-105,-5
user_002263,46,50k-75k,desktop,returning,South,33,True,127,5,0,False,False,True,100,9,0,7.491787383857747,27,-4
user_002264,43,30k-50k,desktop,returning,South,19,True,150,4,0,False,True,True,106,6,0,8.204310577837852,44,-2
user_002265,18,50k-75k,mobile,returning,East,57,False,0,0,0,True,True,True,104,1,0,6.9786060134513885,-104,-1
user_002266,28,<30k,desktop,new,West,55,True,170,3,0,False,True,True,123,3,0,7.4477126299222265,47,0
user_002267,62,50k-75k,mobile,returning,Midwest,37,False,0,0,0,False,False,True,155,1,1,7.799751449385783,-155,-1
user_002268,36,50k-75k,desktop,returning,East,76,True,30,2,0,True,True,False,0,0,0,,30,2
user_002269,35,50k-75k,desktop,new,East,31,False,0,0,0,False,True,True,68,1,0,7.8430299219738915,-68,-1
user_002270,20,30k-50k,desktop,returning,South,88,True,50,5,0,True,True,True,20,7,0,10.0,30,-2
user_002271,61,100k-150k,desktop,returning,West,58,True,38,1,0,False,True,True,35,2,0,6.7834393004965134,3,-1
user_002272,53,50k-75k,desktop,returning,South,19,True,148,2,0,False,True,True,115,1,0,6.9073979921714415,33,1
user_002273,32,<30k,desktop,returning,West,96,True,126,2,0,False,True,True,71,4,0,8.238100214270627,55,-2
user_002274,66,<30k,mobile,new,East,14,True,116,2,0,True,True,True,91,3,0,9.199783684684059,25,-1
user_002275,37,75k-100k,desktop,new,South,52,True,146,1,0,False,False,True,163,1,0,8.455224000443534,-17,0
user_002276,33,50k-75k,desktop,returning,South,63,True,84,3,0,False,False,True,132,4,0,7.1072915723094985,-48,-1
user_002277,26,100k-150k,desktop,returning,East,87,True,51,1,0,False,True,True,37,1,0,7.190963998420016,14,0
user_002278,58,<30k,mobile,new,West,44,False,0,0,0,False,False,False,0,0,0,,0,0
user_002279,49,50k-75k,desktop,new,West,35,True,119,5,0,False,True,True,104,3,0,7.824336544171873,15,2
user_002280,36,75k-100k,desktop,returning,West,78,True,86,1,0,True,True,True,81,1,0,8.016270195051336,5,0
user_002281,46,75k-100k,desktop,returning,South,57,True,44,3,0,True,True,True,40,3,0,8.399915519561938,4,0
user_002282,42,50k-75k,mobile,returning,East,34,True,132,3,1,True,True,True,128,2,0,9.37718446539736,4,1
user_002283,53,<30k,desktop,returning,East,47,True,30,1,0,True,True,True,28,2,0,5.060274160849583,2,-1
user_002284,39,50k-75k,desktop,returning,West,47,True,115,3,0,False,False,True,142,5,0,7.91272680510112,-27,-2
user_002285,18,<30k,tablet,new,East,53,True,115,7,0,False,False,True,153,8,0,6.999988164374683,-38,-1
user_002286,69,50k-75k,mobile,returning,East,45,True,138,1,1,True,True,True,108,1,1,7.597945995309682,30,0
user_002287,68,100k-150k,desktop,returning,East,50,True,46,3,1,False,False,True,58,2,0,8.393372732551846,-12,1
user_002288,18,100k-150k,mobile,returning,South,68,True,74,3,0,True,True,True,41,2,0,9.202730793846072,33,1
user_002289,37,50k-75k,desktop,returning,East,43,False,0,0,0,True,False,True,114,1,0,8.252199034004033,-114,-1
user_002290,61,<30k,desktop,returning,West,48,True,89,5,0,True,False,True,81,3,0,8.25160009874671,8,2
user_002291,40,30k-50k,mobile,returning,East,73,True,73,1,0,True,True,False,0,0,0,,73,1
user_002292,46,75k-100k,desktop,returning,South,54,True,164,1,0,True,True,False,0,0,0,,164,1
user_002293,28,30k-50k,mobile,returning,Midwest,77,True,85,1,0,True,True,True,88,1,0,8.631953834421633,-3,0
user_002294,36,50k-75k,desktop,returning,West,50,True,97,1,1,False,True,False,0,0,0,,97,1
user_002295,44,30k-50k,desktop,returning,West,65,True,99,5,0,True,True,True,102,5,0,8.96595652361863,-3,0
user_002296,53,100k-150k,desktop,returning,Midwest,45,True,107,2,0,False,True,True,81,2,0,8.600710563591626,26,0
user_002297,60,30k-50k,desktop,new,South,10,True,155,4,0,False,False,True,135,5,0,6.223525845424513,20,-1
user_002298,63,50k-75k,mobile,returning,South,36,True,85,4,1,False,False,True,123,6,0,6.845073240889488,-38,-2
user_002299,39,50k-75k,desktop,returning,East,50,True,72,1,0,False,False,True,22,1,0,6.790755423993281,50,0
user_002300,42,30k-50k,desktop,returning,Midwest,28,True,86,4,0,False,True,True,88,1,0,7.7773529536582995,-2,3
user_002301,70,50k-75k,desktop,returning,South,27,True,166,6,0,True,True,True,107,5,0,8.527841018593259,59,1
user_002302,42,<30k,desktop,new,East,35,True,110,5,0,True,True,True,78,7,0,8.073552799336637,32,-2
user_002303,40,<30k,desktop,new,Midwest,36,True,143,5,0,False,False,True,157,3,0,7.515631997289383,-14,2
user_002304,42,100k-150k,desktop,new,East,54,True,84,4,0,False,False,True,80,4,1,7.7424982861419815,4,0
user_002305,39,75k-100k,desktop,returning,West,56,True,117,1,0,True,True,True,97,1,0,8.446664314817545,20,0
user_002306,54,100k-150k,mobile,returning,East,46,True,142,2,0,False,True,True,111,2,0,8.31465938510607,31,0
user_002307,53,50k-75k,mobile,returning,East,22,True,123,3,0,False,False,True,145,2,0,7.715899606623179,-22,1
user_002308,48,75k-100k,mobile,returning,West,40,True,40,3,0,False,False,True,42,2,1,8.071228043686865,-2,1
user_002309,28,100k-150k,desktop,new,East,88,True,107,1,0,True,True,True,109,1,0,9.49847061109662,-2,0
user_002310,53,75k-100k,desktop,returning,West,52,True,30,3,1,True,True,True,27,1,0,6.792827683476285,3,2
user_002311,37,75k-100k,desktop,new,Midwest,46,True,170,1,0,False,True,True,119,1,0,10.0,51,0
user_002312,37,50k-75k,desktop,new,East,82,True,87,5,1,True,True,True,69,2,0,9.399487946936743,18,3
user_002313,39,100k-150k,mobile,new,South,63,True,55,3,0,False,True,True,51,1,0,8.825685682002991,4,2
user_002314,35,<30k,mobile,new,South,59,True,140,2,1,False,False,True,146,2,0,6.612885786437422,-6,0
user_002315,56,75k-100k,tablet,returning,South,36,True,127,5,0,False,False,True,107,5,0,7.600591852752086,20,0
user_002316,53,>150k,mobile,returning,Midwest,38,True,58,8,0,False,False,True,41,7,0,7.209249767494686,17,1
user_002317,38,30k-50k,mobile,returning,East,5,True,104,5,0,True,False,True,109,2,0,6.948890901303523,-5,3
user_002318,65,30k-50k,mobile,new,West,50,True,132,4,0,False,True,True,97,4,0,6.908381019135431,35,0
user_002319,45,30k-50k,mobile,returning,East,50,True,83,5,0,True,True,True,96,4,0,8.030767066647533,-13,1
user_002320,46,30k-50k,mobile,returning,West,83,True,80,2,0,False,True,True,62,1,0,7.148325001129665,18,1
user_002321,48,<30k,desktop,returning,East,18,True,98,3,0,True,False,True,98,5,0,6.2742977652326495,0,-2
user_002322,35,>150k,mobile,new,West,54,True,185,1,1,False,False,True,168,1,0,6.905298142199227,17,0
user_002323,50,100k-150k,desktop,new,East,98,True,64,3,0,True,True,True,93,1,0,8.82392833184521,-29,2
user_002324,54,50k-75k,mobile,returning,East,60,True,90,3,0,False,True,True,91,3,0,7.27478180967839,-1,0
user_002325,80,<30k,mobile,returning,East,50,True,47,3,0,False,True,True,20,4,0,6.933604868557553,27,-1
user_002326,38,100k-150k,mobile,new,East,50,True,111,5,0,True,True,True,55,6,0,7.482409436877625,56,-1
user_002327,43,100k-150k,desktop,new,Midwest,72,True,103,4,0,True,True,True,88,5,0,6.811786148423079,15,-1
user_002328,40,<30k,desktop,returning,Midwest,34,True,85,6,0,True,False,True,98,7,0,6.623481673907027,-13,-1
user_002329,39,>150k,desktop,returning,South,53,False,0,0,0,False,True,True,139,1,0,8.18731841640406,-139,-1
user_002330,45,100k-150k,mobile,returning,East,57,True,78,3,1,True,True,True,59,1,1,7.8119888036411105,19,2
user_002331,36,30k-50k,desktop,returning,South,52,True,98,1,0,True,True,True,103,1,0,8.339635119250966,-5,0
user_002332,28,100k-150k,desktop,returning,South,100,True,30,4,0,True,True,True,51,1,1,7.116732640616149,-21,3
user_002333,43,75k-100k,mobile,new,Midwest,43,True,96,2,0,False,False,True,114,1,0,7.380729795081297,-18,1
user_002334,41,<30k,desktop,returning,South,0,True,147,7,0,True,True,True,112,9,0,7.532106809131067,35,-2
user_002335,43,50k-75k,desktop,returning,South,57,True,139,3,0,True,True,True,98,1,0,10.0,41,2
user_002336,60,50k-75k,desktop,returning,South,23,True,159,4,0,True,True,True,151,2,0,6.974839919783662,8,2
user_002337,42,75k-100k,desktop,new,South,48,True,127,4,0,True,True,True,91,7,0,8.343330939251054,36,-3
user_002338,36,75k-100k,mobile,returning,East,30,True,101,3,0,True,True,True,91,3,0,8.392717622282142,10,0
user_002339,50,75k-100k,mobile,returning,South,39,True,78,4,0,False,True,True,116,2,0,6.695673297520171,-38,2
user_002340,55,<30k,mobile,returning,Midwest,47,True,107,1,0,False,True,True,90,1,0,8.258577112801483,17,0
user_002341,29,<30k,desktop,new,Midwest,61,True,111,2,0,False,False,False,0,0,0,,111,2
user_002342,70,>150k,desktop,new,South,55,True,47,1,0,False,False,True,75,1,0,6.946618162823407,-28,0
user_002343,32,50k-75k,desktop,new,East,69,True,127,1,0,True,True,True,92,1,0,8.397649757422617,35,0
user_002344,56,75k-100k,mobile,new,West,52,True,129,2,0,False,True,True,106,2,0,9.450962037039199,23,0
user_002345,44,50k-75k,desktop,new,Midwest,40,True,141,3,0,False,True,True,126,1,0,6.879201614767212,15,2
user_002346,55,75k-100k,desktop,returning,South,47,True,104,1,0,False,False,True,108,1,0,5.345824727495368,-4,0
user_002347,42,50k-75k,mobile,returning,West,76,True,50,3,0,False,True,True,36,4,0,9.06535963172303,14,-1
user_002348,42,<30k,mobile,new,Midwest,65,False,0,0,0,False,True,True,85,1,0,8.929962626882494,-85,-1
user_002349,38,<30k,desktop,returning,Midwest,42,True,95,5,0,True,True,True,80,7,0,6.886670532071678,15,-2
user_002350,47,100k-150k,mobile,new,South,67,True,191,2,1,False,False,True,193,1,0,7.2368609440193366,-2,1
user_002351,49,30k-50k,mobile,returning,South,40,True,51,2,0,True,False,True,43,1,0,8.984545376130248,8,1
user_002352,62,30k-50k,desktop,returning,East,27,False,0,0,0,True,False,True,136,1,0,8.08408851032097,-136,-1
user_002353,39,50k-75k,desktop,returning,West,66,False,0,0,0,True,False,True,155,1,0,8.363255202688942,-155,-1
user_002354,27,100k-150k,mobile,returning,East,68,True,89,4,1,False,True,True,121,6,0,8.44374809739923,-32,-2
user_002355,61,75k-100k,desktop,returning,East,47,True,95,3,1,False,False,True,88,2,0,7.477861305149853,7,1
user_002356,62,30k-50k,mobile,returning,East,18,False,0,0,0,False,False,False,0,0,0,,0,0
user_002357,35,30k-50k,desktop,returning,Midwest,47,True,91,3,0,False,False,True,100,1,0,8.222646104457892,-9,2
user_002358,68,100k-150k,mobile,returning,South,54,True,63,1,0,True,True,True,86,1,0,10.0,-23,0
user_002359,43,50k-75k,mobile,returning,West,61,True,51,1,0,False,False,True,47,1,0,8.386510987066645,4,0
user_002360,18,50k-75k,desktop,returning,East,65,True,39,1,0,False,True,True,38,2,0,9.108102377474973,1,-1
user_002361,45,50k-75k,mobile,returning,West,64,True,46,1,1,False,True,True,54,1,0,7.350794522669259,-8,0
user_002362,52,30k-50k,desktop,returning,West,88,True,57,5,0,False,True,True,27,3,0,9.328065946836203,30,2
user_002363,51,30k-50k,desktop,returning,East,66,True,60,2,0,False,False,True,36,1,0,6.608448490704063,24,1
user_002364,35,100k-150k,desktop,returning,South,62,True,58,2,0,True,True,True,44,3,1,7.646600998555516,14,-1
user_002365,25,50k-75k,mobile,returning,East,77,True,88,2,0,False,True,True,56,1,0,9.521293427060117,32,1
user_002366,64,75k-100k,desktop,returning,South,13,True,140,3,1,False,False,True,134,4,0,5.83643876280415,6,-1
user_002367,63,50k-75k,mobile,returning,East,28,True,132,4,0,True,True,True,122,5,0,7.566297319786037,10,-1
user_002368,45,50k-75k,mobile,new,South,46,True,155,4,0,True,False,True,148,3,0,6.436628470764525,7,1
user_002369,35,50k-75k,desktop,returning,South,65,True,120,2,0,False,True,True,84,1,0,10.0,36,1
user_002370,49,50k-75k,mobile,new,South,53,True,91,2,0,True,True,True,86,1,0,7.840307201819857,5,1
user_002371,79,50k-75k,mobile,new,East,23,True,199,3,0,False,False,False,0,0,0,,199,3
user_002372,28,<30k,tablet,returning,South,56,True,117,1,0,False,True,True,99,1,0,8.07505774033274,18,0
user_002373,48,75k-100k,desktop,returning,East,40,True,62,2,0,False,True,True,50,3,0,9.03799343766345,12,-1
user_002374,58,100k-150k,mobile,new,South,25,True,162,9,0,False,False,True,196,12,0,6.357738852739443,-34,-3
user_002375,57,50k-75k,desktop,returning,East,52,True,89,1,0,False,False,True,85,1,0,8.71637301657544,4,0
user_002376,18,75k-100k,mobile,new,South,63,True,109,4,0,True,True,True,57,5,0,8.176158135944085,52,-1
user_002377,22,<30k,mobile,new,South,57,False,0,0,0,True,True,True,113,2,0,9.418311509982791,-113,-2
user_002378,18,75k-100k,mobile,new,West,82,True,141,4,0,False,True,True,115,1,0,7.048546874428454,26,3
user_002379,41,30k-50k,desktop,returning,Midwest,49,False,0,0,0,True,True,True,60,1,0,7.627222031480272,-60,-1
user_002380,54,30k-50k,desktop,returning,Midwest,56,True,154,4,1,True,False,True,191,4,1,5.730013047311663,-37,0
user_002381,40,100k-150k,mobile,new,Midwest,50,True,113,4,0,False,True,True,94,3,0,6.98909531763597,19,1
user_002382,61,30k-50k,mobile,new,West,69,False,0,0,0,False,True,True,110,2,0,8.240858697252989,-110,-2
user_002383,33,75k-100k,desktop,new,East,79,True,138,1,0,True,True,True,86,1,0,8.84885155908429,52,0
user_002384,32,30k-50k,tablet,returning,South,54,True,43,2,0,False,False,True,59,1,1,9.704400516561309,-16,1
user_002385,69,75k-100k,desktop,returning,Midwest,36,True,140,1,0,True,True,True,166,2,0,9.022468729963492,-26,-1
user_002386,72,30k-50k,mobile,returning,East,41,True,56,2,1,False,True,True,40,1,0,9.166888148896883,16,1
user_002387,54,>150k,mobile,returning,South,72,True,101,3,0,True,True,True,105,3,0,5.720975063999785,-4,0
user_002388,27,50k-75k,mobile,returning,South,28,True,96,1,1,True,False,True,72,1,0,6.044529152434507,24,0
user_002389,31,>150k,desktop,returning,West,97,True,30,4,0,True,True,True,45,4,0,7.090460317869226,-15,0
user_002390,40,100k-150k,desktop,returning,East,73,True,46,4,0,True,True,True,44,5,1,6.8040430688520575,2,-1
user_002391,39,30k-50k,desktop,returning,South,40,True,113,1,0,False,True,True,79,1,0,7.932309808627271,34,0
user_002392,31,<30k,mobile,returning,West,82,False,0,0,0,True,True,True,116,1,0,8.054647339681582,-116,-1
user_002393,35,50k-75k,tablet,new,East,45,True,110,2,0,False,False,True,106,2,0,7.9761506583844115,4,0
user_002394,37,50k-75k,mobile,returning,South,45,True,88,4,2,True,True,True,59,1,0,8.041741847269355,29,3
user_002395,52,75k-100k,mobile,returning,Midwest,37,True,111,4,0,True,False,True,108,7,1,6.851190305140951,3,-3
user_002396,41,100k-150k,desktop,new,Midwest,68,True,92,4,0,False,True,True,78,2,0,8.434232349644322,14,2
user_002397,56,100k-150k,mobile,new,South,55,True,127,5,0,False,False,True,92,3,0,7.550905492485344,35,2
user_002398,53,100k-150k,mobile,new,South,45,True,122,1,0,False,False,True,128,2,0,5.780989515127266,-6,-1
user_002399,51,50k-75k,mobile,new,East,61,True,96,5,0,False,False,True,130,5,0,7.718761172142847,-34,0
user_002400,39,75k-100k,desktop,new,West,58,True,101,2,0,False,False,True,120,1,1,8.270627432221605,-19,1
user_002401,63,30k-50k,mobile,returning,West,78,True,79,2,0,False,True,True,26,3,0,8.75847924932996,53,-1
user_002402,65,<30k,desktop,new,South,8,False,0,0,0,True,False,True,88,1,0,9.921094748295785,-88,-1
user_002403,71,50k-75k,mobile,returning,West,42,True,33,2,0,False,False,True,62,2,0,7.405632487855631,-29,0
user_002404,41,50k-75k,mobile,returning,South,55,True,134,3,0,True,True,True,127,2,0,8.223236677508199,7,1
user_002405,32,50k-75k,mobile,new,South,37,True,120,1,0,False,True,True,72,2,0,7.401248587447158,48,-1
user_002406,67,50k-75k,desktop,returning,Midwest,27,True,116,4,0,False,False,True,183,5,1,7.265776811493533,-67,-1
user_002407,64,75k-100k,mobile,new,West,42,False,0,0,0,False,False,True,99,2,0,9.163797793626301,-99,-2
user_002408,26,30k-50k,mobile,returning,South,77,True,68,2,0,False,True,True,25,1,0,7.8507594534797045,43,1
user_002409,34,<30k,mobile,new,East,61,False,0,0,0,False,True,False,0,0,0,,0,0
user_002410,20,<30k,mobile,returning,Midwest,59,False,0,0,0,True,True,True,109,1,0,7.273951468508656,-109,-1
user_002411,48,50k-75k,mobile,new,South,55,True,88,3,0,False,True,True,69,5,0,8.566807982455643,19,-2
user_002412,35,<30k,tablet,new,Midwest,13,True,119,3,0,True,False,True,134,2,0,5.900139165380809,-15,1
user_002413,49,75k-100k,mobile,new,East,48,True,64,1,0,False,True,True,78,1,0,8.527558131947286,-14,0
user_002414,38,75k-100k,desktop,new,South,37,False,0,0,0,True,False,True,146,3,0,7.923164511836541,-146,-3
user_002415,18,50k-75k,desktop,new,West,79,True,129,4,1,True,True,True,76,4,0,7.6505620441211795,53,0
user_002416,48,50k-75k,desktop,returning,West,55,True,117,3,0,False,True,True,53,1,0,7.215619867349933,64,2
user_002417,67,100k-150k,mobile,new,West,71,True,126,6,0,False,False,True,147,4,0,4.960062530114629,-21,2
user_002418,50,50k-75k,desktop,returning,South,65,False,0,0,0,True,False,True,84,1,0,6.130063517310449,-84,-1
user_002419,41,<30k,mobile,new,Midwest,32,False,0,0,0,True,True,True,92,1,0,9.284747455828345,-92,-1
user_002420,49,75k-100k,mobile,returning,West,80,False,0,0,0,True,False,True,124,1,1,7.561397122946412,-124,-1
user_002421,55,100k-150k,desktop,returning,South,61,True,79,1,0,True,False,True,60,2,0,7.332554535324746,19,-1
user_002422,58,30k-50k,mobile,new,Midwest,41,False,0,0,0,False,True,True,98,1,0,8.18889612959547,-98,-1
user_002423,33,<30k,mobile,new,Midwest,40,True,142,5,0,True,True,True,152,1,1,8.163228290294247,-10,4
user_002424,22,100k-150k,desktop,new,East,93,True,110,2,0,False,True,True,98,1,0,8.283643461050218,12,1
user_002425,39,50k-75k,mobile,returning,South,57,True,88,1,0,False,False,True,108,1,0,7.541627514051001,-20,0
user_002426,58,30k-50k,mobile,returning,East,33,True,70,4,0,True,True,True,64,2,0,8.495017008636529,6,2
user_002427,45,30k-50k,mobile,new,West,52,False,0,0,0,True,True,True,95,1,0,4.3780101726443075,-95,-1
user_002428,28,30k-50k,mobile,returning,West,99,True,43,1,0,True,True,True,27,1,0,7.46040910015572,16,0
user_002429,49,50k-75k,desktop,new,East,66,True,106,1,0,True,True,True,76,1,0,7.644078612857622,30,0
user_002430,28,30k-50k,mobile,returning,South,53,True,60,1,0,False,True,True,44,1,0,8.548093584409482,16,0
user_002431,35,30k-50k,mobile,new,West,48,False,0,0,0,False,True,True,96,1,0,9.24956927804542,-96,-1
user_002432,40,100k-150k,desktop,returning,West,92,True,68,4,0,False,True,True,59,4,0,8.42199807146998,9,0
user_002433,38,30k-50k,desktop,returning,South,22,False,0,0,0,False,False,True,141,1,0,7.110732067345096,-141,-1
user_002434,28,<30k,desktop,new,South,33,True,106,4,0,False,True,True,58,2,0,8.857359559493348,48,2
user_002435,38,<30k,mobile,returning,West,48,True,66,3,0,False,False,True,93,3,0,7.784051681875379,-27,0
user_002436,19,50k-75k,mobile,new,South,57,True,96,6,1,False,True,True,104,4,0,6.485752748334477,-8,2
user_002437,56,50k-75k,mobile,new,East,18,True,193,1,0,True,False,True,195,2,0,6.022403769592653,-2,-1
user_002438,26,50k-75k,desktop,returning,West,62,True,97,2,0,True,True,True,110,1,0,10.0,-13,1
user_002439,34,30k-50k,desktop,returning,East,70,True,90,2,0,True,False,False,0,0,0,,90,2
user_002440,27,50k-75k,desktop,returning,East,91,False,0,0,0,False,True,True,129,1,0,7.313820501664323,-129,-1
user_002441,45,50k-75k,desktop,returning,Midwest,56,True,148,3,1,False,False,True,134,3,0,6.126175867788611,14,0
user_002442,39,75k-100k,desktop,returning,South,39,True,116,4,0,True,True,True,86,3,0,8.088661795259695,30,1
user_002443,18,75k-100k,desktop,returning,Midwest,69,False,0,0,0,True,False,True,93,2,0,8.879060175766586,-93,-2
user_002444,22,>150k,mobile,returning,East,100,True,93,5,0,False,False,True,97,7,1,7.438144665196956,-4,-2
user_002445,70,>150k,desktop,returning,West,68,True,30,5,1,False,True,True,20,2,0,5.509671913002722,10,3
user_002446,37,75k-100k,desktop,new,West,59,True,96,1,1,False,False,True,108,2,0,7.974082716368325,-12,-1
user_002447,18,>150k,mobile,returning,West,100,True,105,3,0,True,True,True,113,2,0,9.044790440211901,-8,1
user_002448,48,<30k,mobile,returning,South,13,True,91,4,0,True,True,True,71,1,0,7.240239678956645,20,3
user_002449,73,>150k,desktop,returning,South,43,True,69,4,0,False,True,True,73,4,0,8.036561150699121,-4,0
user_002450,60,<30k,mobile,returning,East,37,False,0,0,0,True,False,True,72,1,0,5.12049393373589,-72,-1
user_002451,41,30k-50k,desktop,returning,West,75,True,145,1,0,True,True,True,148,1,0,6.261566405874959,-3,0
user_002452,18,75k-100k,desktop,returning,South,85,False,0,0,0,True,True,True,111,1,0,8.724172812796155,-111,-1
user_002453,65,<30k,desktop,new,South,0,False,0,0,0,False,False,True,123,3,0,7.931111901514599,-123,-3
user_002454,47,100k-150k,mobile,returning,South,84,True,33,4,0,True,True,True,20,3,0,9.06400966168821,13,1
user_002455,38,75k-100k,desktop,returning,South,44,True,69,2,0,True,True,True,44,2,0,8.390549787833033,25,0
user_002456,47,50k-75k,mobile,new,East,45,True,146,1,0,False,True,True,121,1,0,6.935277264458251,25,0
user_002457,52,<30k,mobile,new,West,25,False,0,0,0,True,True,True,82,1,0,6.336327166357698,-82,-1
user_002458,40,>150k,desktop,returning,West,72,True,97,3,0,True,True,True,45,5,0,8.664603798601574,52,-2
user_002459,54,75k-100k,mobile,returning,West,67,True,56,6,1,False,False,True,44,10,0,7.364333744583155,12,-4
user_002460,55,50k-75k,desktop,returning,South,21,True,114,2,1,False,False,True,132,4,0,8.049407210597597,-18,-2
user_002461,18,75k-100k,mobile,returning,South,62,True,85,1,1,True,True,True,72,1,0,6.610015030962468,13,0
user_002462,39,50k-75k,desktop,returning,West,60,True,79,3,0,True,False,True,82,2,0,6.954254992035536,-3,1
user_002463,24,75k-100k,mobile,returning,South,57,True,96,3,0,False,True,True,73,2,0,7.424799431046741,23,1
user_002464,42,30k-50k,tablet,returning,South,52,True,90,2,1,True,False,True,82,3,0,7.429966369347016,8,-1
user_002465,35,30k-50k,mobile,returning,Midwest,25,True,178,7,0,False,True,True,147,14,0,6.781832861638939,31,-7
user_002466,43,50k-75k,desktop,returning,East,63,True,68,1,0,True,True,False,0,0,0,,68,1
user_002467,43,75k-100k,desktop,returning,West,38,True,94,4,0,False,True,True,58,5,0,6.019597764328067,36,-1
user_002468,24,50k-75k,desktop,returning,West,76,True,113,2,0,True,True,True,116,1,0,7.343157159471783,-3,1
user_002469,55,100k-150k,tablet,returning,West,89,True,69,4,1,True,True,True,83,3,1,7.203193155623362,-14,1
user_002470,18,50k-75k,desktop,returning,Midwest,73,True,69,1,0,False,False,False,0,0,0,,69,1
user_002471,33,50k-75k,mobile,new,West,70,True,109,1,0,False,True,True,99,1,0,9.06646180416997,10,0
user_002472,62,50k-75k,desktop,returning,East,30,True,70,5,0,False,False,True,85,4,0,6.239636163306483,-15,1
user_002473,47,50k-75k,tablet,returning,Midwest,38,True,84,6,0,True,True,True,68,3,0,7.355267313847233,16,3
user_002474,23,100k-150k,desktop,returning,East,100,False,0,0,0,True,True,True,108,1,0,10.0,-108,-1
user_002475,18,50k-75k,mobile,returning,South,59,True,103,2,0,False,True,True,56,1,0,7.605431155208007,47,1
user_002476,62,<30k,desktop,new,South,40,True,129,2,0,False,True,False,0,0,0,,129,2
user_002477,45,50k-75k,mobile,returning,Midwest,47,True,94,7,0,False,False,True,120,10,0,7.646317128121087,-26,-3
user_002478,55,75k-100k,mobile,returning,South,55,True,90,7,1,False,True,True,50,8,0,7.764934327736727,40,-1
user_002479,42,30k-50k,tablet,returning,West,64,True,109,1,0,False,False,True,134,1,0,7.425656973609735,-25,0
user_002480,18,75k-100k,mobile,returning,West,78,True,72,5,0,True,True,True,43,3,0,8.795205448938686,29,2
user_002481,39,30k-50k,desktop,new,Midwest,59,True,122,2,0,False,False,True,98,1,0,8.472435206657842,24,1
user_002482,30,30k-50k,desktop,new,South,79,True,110,1,0,False,True,True,95,1,0,7.845431300780713,15,0
user_002483,70,75k-100k,desktop,new,South,24,False,0,0,0,False,False,True,94,1,0,8.466275354092074,-94,-1
user_002484,18,50k-75k,desktop,new,West,100,True,99,2,0,True,True,True,78,1,0,6.95867444105227,21,1
user_002485,30,50k-75k,desktop,returning,West,53,True,70,2,0,True,True,True,55,2,0,7.45697215877508,15,0
user_002486,39,<30k,mobile,new,South,38,True,134,4,1,False,False,True,173,2,0,6.98228936395458,-39,2
user_002487,47,<30k,desktop,returning,South,45,False,0,0,0,False,True,True,97,1,0,8.141276530205799,-97,-1
user_002488,28,30k-50k,desktop,returning,Midwest,83,True,30,2,0,False,True,True,26,2,0,9.056292170213426,4,0
user_002489,36,50k-75k,desktop,returning,Midwest,52,True,150,4,0,False,True,True,111,1,0,4.888518191277707,39,3
user_002490,59,30k-50k,desktop,new,Midwest,19,True,144,4,0,False,False,True,152,4,0,7.871576846369954,-8,0
user_002491,29,100k-150k,desktop,new,Midwest,71,True,60,3,0,False,True,True,81,3,0,9.975709540934725,-21,0
user_002492,49,100k-150k,desktop,new,East,62,True,138,4,0,True,False,True,107,7,0,9.020995253567666,31,-3
user_002493,21,50k-75k,desktop,returning,Midwest,48,False,0,0,0,False,False,True,120,2,0,6.585538438044737,-120,-2
user_002494,27,75k-100k,desktop,new,West,52,True,152,2,0,True,False,True,155,4,1,7.547765729627548,-3,-2
user_002495,45,75k-100k,desktop,new,West,38,True,128,4,1,True,False,True,98,2,0,6.9425579742422245,30,2
user_002496,42,50k-75k,desktop,new,Midwest,49,False,0,0,0,False,False,True,150,1,0,6.035214584319688,-150,-1
user_002497,52,30k-50k,mobile,returning,South,28,True,123,4,0,True,True,True,107,7,0,7.162367408768604,16,-3
user_002498,25,75k-100k,desktop,returning,South,45,True,67,2,1,False,True,True,44,4,0,5.949889156574918,23,-2
user_002499,57,50k-75k,mobile,new,Midwest,42,True,125,6,1,False,False,True,123,6,0,7.2727075350730574,2,0
user_002500,29,30k-50k,desktop,returning,West,82,True,78,4,1,False,True,True,67,1,0,7.318461025826681,11,3
user_002501,50,<30k,desktop,new,South,35,True,94,3,0,False,False,True,79,2,0,4.528695769235292,15,1
user_002502,25,<30k,desktop,new,South,43,True,119,2,0,True,True,True,71,1,0,8.806402154577325,48,1
user_002503,26,100k-150k,mobile,new,East,96,True,130,1,0,True,True,True,103,1,0,10.0,27,0
user_002504,20,50k-75k,mobile,returning,South,38,True,117,1,0,True,True,True,69,1,0,7.8399695524005,48,0
user_002505,54,<30k,mobile,new,East,40,False,0,0,0,True,False,True,152,1,0,6.449952526468186,-152,-1
user_002506,40,<30k,desktop,returning,East,45,True,133,2,0,True,True,True,116,3,0,8.041112965882375,17,-1
user_002507,32,<30k,desktop,new,West,53,False,0,0,0,False,False,False,0,0,0,,0,0
user_002508,51,75k-100k,mobile,returning,East,49,True,43,6,0,False,False,True,53,5,0,7.307119741352619,-10,1
user_002509,22,<30k,tablet,returning,South,21,True,140,4,0,True,True,True,96,6,0,10.0,44,-2
user_002510,59,100k-150k,desktop,new,West,59,True,119,5,0,False,True,True,82,4,0,9.147854734782806,37,1
user_002511,18,30k-50k,desktop,returning,South,84,True,78,5,0,False,True,True,58,7,0,10.0,20,-2
user_002512,27,>150k,desktop,returning,East,97,True,32,1,0,True,True,True,47,1,0,6.691318594615107,-15,0
user_002513,54,30k-50k,desktop,returning,Midwest,22,True,122,4,0,True,True,True,106,1,0,8.248647436988954,16,3
user_002514,35,50k-75k,desktop,new,Midwest,56,True,179,1,0,False,False,True,170,1,0,8.136076603484375,9,0
user_002515,30,30k-50k,desktop,returning,Midwest,88,True,42,3,0,True,True,True,36,3,0,8.650066676140813,6,0
user_002516,48,50k-75k,mobile,new,Midwest,48,False,0,0,0,False,True,True,110,1,0,7.554299541703677,-110,-1
user_002517,62,100k-150k,mobile,returning,West,71,True,50,1,0,True,True,True,40,1,0,8.91445145933055,10,0
user_002518,52,30k-50k,desktop,new,South,31,True,165,2,0,False,False,True,145,1,0,6.971175696205223,20,1
user_002519,31,30k-50k,mobile,returning,West,91,True,75,4,0,True,True,False,0,0,0,,75,4
user_002520,38,30k-50k,desktop,new,East,56,True,127,4,0,False,False,True,157,3,0,8.722984667113362,-30,1
user_002521,63,<30k,mobile,returning,East,16,False,0,0,0,False,False,False,0,0,0,,0,0
user_002522,45,<30k,mobile,returning,Midwest,42,True,96,1,0,False,True,True,99,2,0,7.112033477530866,-3,-1
user_002523,20,>150k,mobile,new,West,81,True,99,3,1,True,True,True,68,4,0,9.62565646659259,31,-1
user_002524,54,<30k,mobile,new,West,44,True,168,4,0,False,True,True,160,3,0,8.903308969884304,8,1
user_002525,35,30k-50k,desktop,returning,East,30,True,77,1,0,False,True,True,65,1,1,7.462289789671478,12,0
user_002526,42,50k-75k,mobile,new,West,75,True,79,5,0,False,True,True,73,5,0,9.217091912207827,6,0
user_002527,57,75k-100k,desktop,returning,East,34,True,120,1,0,False,False,True,89,1,0,8.851466680291795,31,0
user_002528,47,75k-100k,mobile,new,South,63,True,71,6,0,False,True,True,53,4,0,7.510879191957396,18,2
user_002529,55,50k-75k,desktop,returning,Midwest,65,True,113,2,0,False,False,True,102,5,1,5.907192864647823,11,-3
user_002530,24,30k-50k,mobile,returning,Midwest,87,False,0,0,0,True,True,True,82,1,0,5.789575205840368,-82,-1
user_002531,49,75k-100k,desktop,new,East,73,True,59,2,0,True,True,True,58,6,0,9.760913499533867,1,-4
user_002532,31,75k-100k,desktop,returning,West,79,True,51,3,0,True,True,True,33,1,0,8.793817377553422,18,2
user_002533,42,30k-50k,mobile,new,South,51,False,0,0,0,False,False,False,0,0,0,,0,0
user_002534,45,75k-100k,desktop,returning,Midwest,70,True,107,2,0,False,True,True,64,2,0,8.639369611750302,43,0
user_002535,30,100k-150k,desktop,returning,Midwest,71,False,0,0,0,True,True,True,109,1,0,8.582691990614292,-109,-1
user_002536,55,100k-150k,desktop,new,South,66,True,112,4,1,True,True,True,96,6,1,7.618327307496303,16,-2
user_002537,60,<30k,desktop,returning,East,33,False,0,0,0,False,True,True,109,1,0,6.03416594175976,-109,-1
user_002538,43,50k-75k,desktop,new,East,43,True,136,2,0,False,True,True,112,1,0,7.967601298963109,24,1
user_002539,38,50k-75k,desktop,returning,East,52,True,76,1,0,False,True,True,68,2,0,9.536682597554663,8,-1
user_002540,68,30k-50k,desktop,returning,South,19,True,162,4,0,True,False,True,158,6,0,8.065538409055423,4,-2
user_002541,46,75k-100k,tablet,new,Midwest,23,True,160,2,0,False,False,True,175,4,0,6.064845112385819,-15,-2
user_002542,18,30k-50k,desktop,new,West,92,True,154,1,0,True,True,True,100,1,0,7.864538030228873,54,0
user_002543,64,30k-50k,mobile,new,South,34,True,146,3,0,False,True,True,128,4,0,7.833572190189507,18,-1
user_002544,71,50k-75k,desktop,returning,Midwest,29,True,181,5,2,True,True,True,104,2,0,8.378182834655062,77,3
user_002545,31,50k-75k,mobile,new,Midwest,64,False,0,0,0,True,True,False,0,0,0,,0,0
user_002546,60,50k-75k,desktop,returning,West,37,True,84,6,0,False,False,True,86,15,0,7.390318595060813,-2,-9
user_002547,51,75k-100k,mobile,returning,East,49,True,82,4,1,True,True,True,20,1,0,6.627554275066596,62,3
user_002548,54,100k-150k,mobile,new,East,62,True,106,2,1,True,True,True,82,3,0,8.806870215547175,24,-1
user_002549,36,100k-150k,desktop,returning,West,81,True,65,2,0,False,False,True,57,1,0,6.392193780429446,8,1
user_002550,56,100k-150k,desktop,new,West,63,True,174,3,0,False,True,True,140,3,0,9.220295626118943,34,0
user_002551,26,75k-100k,mobile,returning,East,98,True,30,1,2,True,True,True,39,1,0,9.05140595227412,-9,0
user_002552,47,75k-100k,mobile,new,East,59,True,100,3,0,False,False,True,136,2,0,8.31983398951678,-36,1
user_002553,54,<30k,desktop,new,West,24,True,146,2,1,True,True,True,141,2,1,7.774181901101397,5,0
user_002554,36,50k-75k,desktop,returning,East,57,False,0,0,0,True,True,True,74,1,0,6.568166467467747,-74,-1
user_002555,36,75k-100k,desktop,returning,East,53,True,77,6,0,False,True,True,81,1,0,7.361912637648145,-4,5
user_002556,40,100k-150k,mobile,new,Midwest,62,True,123,5,0,True,True,True,91,1,0,7.573502021940084,32,4
user_002557,32,100k-150k,tablet,returning,East,100,True,103,1,0,False,True,True,105,2,0,7.373980735278859,-2,-1
user_002558,32,50k-75k,desktop,returning,South,53,True,83,3,0,True,True,True,88,3,0,8.791270174720253,-5,0
user_002559,65,30k-50k,mobile,new,East,44,True,131,2,0,False,False,True,147,2,0,8.845289607444077,-16,0
user_002560,47,75k-100k,desktop,new,West,81,True,99,2,0,False,False,True,76,3,0,7.099253925232626,23,-1
user_002561,80,50k-75k,mobile,new,Midwest,30,True,109,5,0,True,False,True,126,6,0,6.877326837891686,-17,-1
user_002562,46,100k-150k,desktop,returning,South,37,True,113,3,0,False,True,False,0,0,0,,113,3
user_002563,51,100k-150k,mobile,returning,West,93,True,71,2,0,True,True,True,77,2,0,8.770936282078027,-6,0
user_002564,58,30k-50k,desktop,returning,Midwest,27,True,59,1,0,True,False,True,49,1,0,8.16515591587709,10,0
user_002565,46,50k-75k,desktop,new,South,25,True,130,1,0,True,True,True,106,1,0,7.471235476925267,24,0
user_002566,50,100k-150k,mobile,returning,West,98,True,86,2,1,False,True,True,101,1,0,6.4640675054427765,-15,1
user_002567,18,100k-150k,desktop,returning,Midwest,93,False,0,0,0,True,True,True,74,1,0,7.072687140098839,-74,-1
user_002568,27,75k-100k,desktop,returning,East,39,True,116,5,0,True,True,True,100,8,0,8.595389549796588,16,-3
user_002569,64,<30k,desktop,returning,Midwest,0,True,172,3,1,True,True,True,150,4,0,4.761830111557011,22,-1
user_002570,31,100k-150k,tablet,returning,West,88,True,30,3,0,False,True,True,34,5,0,7.728670998499039,-4,-2
user_002571,72,<30k,mobile,new,South,25,True,120,5,0,False,False,True,132,6,0,8.123280195051496,-12,-1
user_002572,54,100k-150k,desktop,returning,South,58,True,75,1,0,True,True,True,89,1,0,9.105673047638325,-14,0
user_002573,41,75k-100k,mobile,returning,Midwest,56,True,113,4,1,True,True,True,68,3,0,9.828884736283259,45,1
user_002574,65,50k-75k,mobile,new,West,46,True,122,1,0,False,False,True,108,1,0,7.134061265544477,14,0
user_002575,32,30k-50k,desktop,new,West,80,True,97,4,0,True,True,True,58,5,0,9.149921170065744,39,-1
user_002576,39,50k-75k,mobile,new,East,51,False,0,0,0,False,False,True,100,1,0,7.3677509075316445,-100,-1
user_002577,70,50k-75k,desktop,returning,West,58,True,142,1,0,False,True,True,132,1,0,8.53875942650139,10,0
user_002578,53,<30k,desktop,returning,South,45,True,142,2,0,True,True,True,119,2,0,10.0,23,0
user_002579,28,75k-100k,desktop,returning,Midwest,42,True,90,2,0,True,False,True,113,1,0,8.6434985003576,-23,1
user_002580,36,100k-150k,mobile,returning,South,72,True,30,4,1,True,True,True,48,3,0,9.264791278659487,-18,1
user_002581,67,50k-75k,mobile,new,East,14,True,140,1,0,False,False,True,158,1,0,6.859449311407669,-18,0
user_002582,55,100k-150k,mobile,new,Midwest,64,True,94,4,0,False,True,True,99,2,0,9.649244852034379,-5,2
user_002583,42,<30k,desktop,returning,Midwest,22,True,111,5,0,True,False,True,77,4,0,5.4707555786087685,34,1
user_002584,53,30k-50k,mobile,returning,South,67,True,80,3,0,True,True,True,40,2,0,6.568851126044259,40,1
user_002585,32,50k-75k,mobile,returning,Midwest,53,True,127,1,0,True,True,True,88,1,0,7.241802351874549,39,0
user_002586,60,75k-100k,desktop,new,South,48,False,0,0,0,False,False,False,0,0,0,,0,0
user_002587,33,<30k,mobile,returning,South,47,False,0,0,0,True,True,True,96,1,0,6.969764571052542,-96,-1
user_002588,36,50k-75k,mobile,returning,South,42,True,85,3,0,False,True,True,71,5,0,7.597562825960723,14,-2
user_002589,44,100k-150k,mobile,returning,Midwest,51,True,131,4,0,False,True,True,103,5,0,7.410550490122434,28,-1
user_002590,30,50k-75k,mobile,returning,South,71,True,90,2,1,False,True,True,84,3,2,6.869660288953974,6,-1
user_002591,37,75k-100k,desktop,returning,South,33,True,121,4,0,False,True,True,106,3,0,7.735050139942269,15,1
user_002592,42,<30k,desktop,returning,East,21,True,182,2,0,False,False,True,183,2,0,5.485955633382741,-1,0
user_002593,39,30k-50k,mobile,returning,East,16,True,204,6,0,False,False,True,191,6,0,4.572586363079805,13,0
user_002594,41,30k-50k,mobile,returning,South,35,False,0,0,0,False,True,True,95,2,0,8.430675808847745,-95,-2
user_002595,44,>150k,mobile,returning,South,66,True,119,3,0,False,True,True,108,2,0,8.1808435095728,11,1
user_002596,65,30k-50k,mobile,returning,South,38,True,83,5,0,False,False,True,87,8,0,7.827602912371696,-4,-3
user_002597,21,75k-100k,desktop,returning,Midwest,68,True,115,4,0,True,True,True,93,3,0,6.68835650789385,22,1
user_002598,50,75k-100k,desktop,new,South,47,True,115,3,0,False,False,True,82,3,1,8.1561106556695,33,0
user_002599,49,30k-50k,desktop,new,South,34,False,0,0,0,False,False,True,92,1,0,7.809032273804036,-92,-1
user_002600,29,75k-100k,mobile,returning,South,50,True,30,2,1,False,False,True,37,3,0,6.718371442035167,-7,-1
user_002601,31,100k-150k,tablet,new,East,86,True,78,1,0,True,True,True,51,1,0,8.099094236115272,27,0
user_002602,33,50k-75k,mobile,returning,Midwest,71,True,33,1,0,True,True,True,20,1,0,8.028543173115063,13,0
user_002603,18,100k-150k,desktop,returning,East,69,True,113,3,0,True,True,True,83,6,0,8.727246646620129,30,-3
user_002604,31,100k-150k,desktop,returning,South,83,True,30,2,0,True,True,True,20,2,0,8.943129013318309,10,0
user_002605,60,30k-50k,tablet,new,West,58,True,121,1,0,False,False,True,123,1,0,7.9358272315499745,-2,0
user_002606,35,30k-50k,mobile,returning,West,75,True,60,5,0,False,True,True,57,2,0,9.9371847239211,3,3
user_002607,18,100k-150k,desktop,returning,East,97,True,70,2,0,True,True,True,49,1,0,9.373417125759577,21,1
user_002608,45,30k-50k,desktop,returning,South,50,True,100,2,0,False,False,True,124,1,0,6.483422027371552,-24,1
user_002609,47,50k-75k,desktop,new,Midwest,32,False,0,0,0,False,True,True,105,1,0,7.412454579676089,-105,-1
user_002610,32,50k-75k,desktop,returning,West,82,True,89,2,0,True,True,True,67,3,0,9.15112956180342,22,-1
user_002611,56,30k-50k,mobile,returning,West,44,True,106,2,1,False,False,True,99,3,0,7.09370341244462,7,-1
user_002612,48,75k-100k,mobile,new,Midwest,64,True,127,3,0,False,True,True,53,2,0,8.589297070156006,74,1
user_002613,56,50k-75k,tablet,returning,South,0,True,118,5,0,True,False,True,89,3,0,7.442678308233736,29,2
user_002614,39,75k-100k,mobile,returning,West,45,True,132,6,0,False,True,True,128,1,0,7.955021821022165,4,5
user_002615,66,75k-100k,desktop,returning,Midwest,35,True,90,3,0,False,False,True,153,3,0,5.446878447252615,-63,0
user_002616,48,75k-100k,mobile,returning,South,36,True,81,4,0,True,True,True,60,1,0,8.948132737603904,21,3
user_002617,32,>150k,mobile,returning,South,91,True,47,5,0,True,True,True,33,8,0,7.732892659999741,14,-3
user_002618,23,30k-50k,mobile,returning,South,84,False,0,0,0,True,True,True,104,1,0,7.415554950019722,-104,-1
user_002619,56,<30k,desktop,returning,South,28,False,0,0,0,True,False,True,117,2,0,6.1310610741366345,-117,-2
user_002620,28,75k-100k,desktop,returning,South,90,True,124,2,1,True,True,True,74,1,0,6.086016756491539,50,1
user_002621,47,<30k,mobile,returning,East,17,False,0,0,0,False,False,True,127,1,0,5.992742274612946,-127,-1
user_002622,38,30k-50k,desktop,returning,Midwest,31,True,94,8,0,False,True,True,103,7,0,9.422354795364312,-9,1
user_002623,24,50k-75k,desktop,returning,West,89,True,59,3,1,True,True,True,38,2,0,7.379796425356487,21,1
user_002624,54,>150k,tablet,returning,Midwest,73,True,97,2,0,True,True,True,95,1,0,9.598833304789332,2,1
user_002625,51,75k-100k,tablet,returning,Midwest,58,True,131,4,0,False,False,True,165,2,0,6.125600532655976,-34,2
user_002626,18,75k-100k,mobile,returning,West,86,True,81,3,0,False,False,True,122,2,0,7.124498563820533,-41,1
user_002627,50,>150k,desktop,returning,East,81,True,83,2,0,False,True,True,60,1,0,9.42916578035782,23,1
user_002628,56,75k-100k,mobile,returning,Midwest,32,True,165,2,0,True,True,True,114,3,0,7.102519431078443,51,-1
user_002629,37,100k-150k,tablet,returning,South,71,True,55,3,0,True,True,True,35,6,0,8.193824824272948,20,-3
user_002630,18,50k-75k,mobile,new,West,69,True,102,2,0,True,True,True,38,2,0,6.759669772926278,64,0
user_002631,18,75k-100k,desktop,returning,Midwest,59,True,124,4,1,False,True,True,94,4,0,6.127729918676113,30,0
user_002632,53,30k-50k,mobile,returning,South,32,True,117,6,0,False,True,True,123,4,1,6.730220035698869,-6,2
user_002633,46,50k-75k,desktop,new,East,35,True,101,4,0,False,True,True,69,1,0,7.232863732398861,32,3
user_002634,18,<30k,desktop,returning,Midwest,36,True,85,2,0,True,True,True,68,2,0,6.763928281446403,17,0
user_002635,55,<30k,desktop,returning,East,47,False,0,0,0,True,True,False,0,0,0,,0,0
user_002636,31,75k-100k,mobile,returning,West,100,True,98,1,0,False,True,True,85,1,1,6.388331282202449,13,0
user_002637,45,<30k,desktop,returning,East,32,True,47,4,0,False,True,True,44,2,0,4.5832701363003405,3,2
user_002638,65,100k-150k,desktop,returning,West,64,False,0,0,0,True,True,True,101,2,0,8.244647930258605,-101,-2
user_002639,58,50k-75k,mobile,returning,Midwest,41,True,129,1,0,False,True,True,52,1,0,8.159741462233319,77,0
user_002640,46,75k-100k,desktop,new,East,37,True,78,3,0,False,False,True,98,4,1,6.336542180233488,-20,-1
user_002641,50,30k-50k,mobile,returning,Midwest,26,True,96,4,0,True,True,True,80,4,0,8.475107234902708,16,0
user_002642,53,50k-75k,mobile,returning,South,56,True,110,3,0,True,True,True,66,1,0,8.36818130208553,44,2
user_002643,51,75k-100k,mobile,returning,East,23,True,168,7,1,True,True,True,96,5,0,6.532830069091599,72,2
user_002644,18,30k-50k,mobile,returning,South,70,True,87,3,0,True,True,True,78,2,0,8.91983919034617,9,1
user_002645,40,30k-50k,mobile,returning,Midwest,39,True,77,4,0,False,True,True,41,4,0,10.0,36,0
user_002646,45,50k-75k,mobile,returning,South,14,False,0,0,0,True,True,True,116,1,0,6.739897730918918,-116,-1
user_002647,65,75k-100k,mobile,returning,East,31,True,52,1,0,False,False,True,48,2,0,5.728710085078094,4,-1
user_002648,47,30k-50k,desktop,returning,Midwest,48,True,122,3,1,True,True,False,0,0,0,,122,3
user_002649,51,75k-100k,desktop,returning,East,42,True,63,3,0,False,False,True,96,5,1,9.206379960373264,-33,-2
user_002650,45,<30k,mobile,returning,Midwest,58,True,142,2,0,False,True,True,85,1,0,9.207936762437667,57,1
user_002651,41,50k-75k,desktop,returning,Midwest,57,True,151,3,0,True,False,True,149,3,0,7.399906349341689,2,0
user_002652,66,50k-75k,mobile,returning,West,45,False,0,0,0,False,True,True,85,1,0,7.079581238317802,-85,-1
user_002653,55,50k-75k,mobile,returning,East,72,False,0,0,0,True,True,True,102,1,0,8.82984786386442,-102,-1
user_002654,58,30k-50k,desktop,new,South,46,False,0,0,0,False,False,True,96,1,0,3.9169101280113128,-96,-1
user_002655,71,75k-100k,mobile,returning,Midwest,21,True,163,5,1,False,False,True,153,5,0,8.160197465499499,10,0
user_002656,30,75k-100k,mobile,returning,Midwest,71,True,70,1,1,True,True,True,45,2,0,8.791535353693446,25,-1
user_002657,52,30k-50k,mobile,new,West,77,True,107,5,0,False,False,True,109,7,0,10.0,-2,-2
user_002658,27,50k-75k,mobile,returning,West,89,True,53,1,3,True,True,True,48,1,0,6.80974350930702,5,0
user_002659,56,30k-50k,mobile,new,Midwest,21,False,0,0,0,False,False,True,157,1,0,3.9869211213588662,-157,-1
user_002660,59,50k-75k,desktop,returning,West,57,True,85,5,1,False,True,True,39,1,0,8.869096482540858,46,4
user_002661,38,30k-50k,desktop,returning,South,79,True,87,5,1,True,True,True,52,3,0,8.457693530564432,35,2
user_002662,49,75k-100k,mobile,returning,South,50,True,49,5,0,False,True,True,69,3,0,7.709736826728701,-20,2
user_002663,60,50k-75k,tablet,returning,Midwest,42,True,100,2,0,True,False,True,86,2,0,8.913556764972249,14,0
user_002664,43,<30k,desktop,returning,Midwest,6,True,121,3,0,True,False,True,135,4,0,8.309059866612118,-14,-1
user_002665,37,<30k,desktop,new,East,31,True,159,2,0,False,False,True,153,2,0,6.42276871294622,6,0
user_002666,78,<30k,desktop,returning,East,34,True,61,6,0,True,False,False,0,0,0,,61,6
user_002667,41,100k-150k,mobile,new,South,59,True,120,5,0,False,True,True,116,5,0,9.047746951849739,4,0
user_002668,38,<30k,mobile,returning,East,41,True,80,2,0,False,False,False,0,0,0,,80,2
user_002669,55,<30k,desktop,returning,Midwest,33,False,0,0,0,True,True,True,109,1,0,7.626376749653173,-109,-1
user_002670,39,50k-75k,desktop,returning,West,56,True,40,1,1,True,True,True,34,2,0,6.6386946658377655,6,-1
user_002671,31,<30k,desktop,new,East,61,True,110,1,0,False,False,True,124,1,0,5.463772632352527,-14,0
user_002672,42,30k-50k,desktop,returning,East,40,True,78,2,1,False,False,True,94,3,0,4.590562232760309,-16,-1
user_002673,79,<30k,mobile,returning,West,23,False,0,0,0,False,False,False,0,0,0,,0,0
user_002674,34,50k-75k,mobile,returning,East,86,True,92,1,0,True,True,True,65,4,0,8.508985909356074,27,-3
user_002675,57,50k-75k,mobile,new,West,40,True,130,3,0,False,False,True,88,4,0,6.157900483537048,42,-1
user_002676,32,75k-100k,mobile,returning,South,71,True,41,5,2,False,True,True,26,3,0,6.786949695537424,15,2
user_002677,46,100k-150k,mobile,returning,East,38,True,114,2,0,False,False,True,89,1,0,9.737743108461833,25,1
user_002678,32,50k-75k,desktop,returning,South,51,True,103,1,0,False,False,True,96,1,0,4.682606408046064,7,0
user_002679,74,100k-150k,mobile,returning,Midwest,45,True,96,3,0,False,False,True,111,3,0,8.016106374693088,-15,0
user_002680,46,30k-50k,desktop,new,East,38,True,105,1,0,False,False,True,119,1,0,5.694751323132149,-14,0
user_002681,44,75k-100k,desktop,returning,East,61,True,74,3,0,True,True,True,74,1,0,8.214619981423299,0,2
user_002682,48,50k-75k,desktop,returning,South,25,False,0,0,0,True,True,True,91,1,0,10.0,-91,-1
user_002683,26,75k-100k,desktop,returning,East,94,True,87,2,0,True,True,True,48,2,0,8.95027330594854,39,0
user_002684,42,50k-75k,desktop,returning,South,52,True,68,2,0,True,False,True,53,1,1,7.65696303026505,15,1
user_002685,71,50k-75k,desktop,returning,South,24,True,157,2,1,False,False,True,142,1,0,7.434944545655604,15,1
user_002686,31,75k-100k,desktop,returning,East,66,True,95,2,0,False,False,True,94,2,0,10.0,1,0
user_002687,30,50k-75k,desktop,returning,East,63,True,44,1,0,False,True,True,26,1,0,8.670935697829286,18,0
user_002688,32,75k-100k,tablet,returning,Midwest,66,True,107,5,0,True,True,True,59,4,0,9.267024869604752,48,1
user_002689,54,75k-100k,desktop,returning,South,55,True,103,4,0,False,False,True,104,6,0,7.6162408783735485,-1,-2
user_002690,66,100k-150k,tablet,returning,West,56,True,139,1,0,False,True,True,126,2,0,8.520312357075403,13,-1
user_002691,18,<30k,mobile,new,Midwest,55,False,0,0,0,False,True,True,67,3,0,9.623388521722289,-67,-3
user_002692,56,<30k,desktop,new,East,54,True,126,5,0,True,False,True,153,3,1,8.990839822954088,-27,2
user_002693,36,50k-75k,desktop,new,South,38,True,131,2,0,False,False,True,113,2,0,5.400534110970785,18,0
user_002694,51,75k-100k,desktop,new,West,68,True,118,2,0,False,True,True,83,2,0,10.0,35,0
user_002695,44,30k-50k,desktop,new,East,46,True,148,6,0,False,True,False,0,0,0,,148,6
user_002696,43,<30k,desktop,returning,East,33,True,94,3,0,True,True,True,61,3,0,8.626748452775674,33,0
user_002697,69,75k-100k,mobile,returning,East,5,True,196,4,1,False,True,True,156,3,0,7.854966891501699,40,1
user_002698,18,>150k,mobile,new,Midwest,58,True,106,2,0,True,True,True,92,2,0,7.320890634691319,14,0
user_002699,44,75k-100k,desktop,returning,South,70,True,70,3,0,True,True,True,47,2,0,5.6064367518936775,23,1
user_002700,64,50k-75k,desktop,returning,East,34,True,99,3,0,True,True,True,64,2,0,8.141033281454831,35,1
user_002701,48,30k-50k,desktop,new,West,54,True,130,1,0,False,True,True,90,1,0,8.6859943652484,40,0
user_002702,63,30k-50k,tablet,new,West,48,True,117,1,1,False,False,True,142,1,0,5.063472986041197,-25,0
user_002703,18,30k-50k,desktop,new,South,57,True,69,1,1,False,True,True,20,1,0,6.846725913158113,49,0
user_002704,80,>150k,tablet,returning,West,70,True,100,1,0,True,True,True,57,2,0,8.164071312859424,43,-1
user_002705,35,50k-75k,desktop,new,Midwest,50,True,110,3,0,False,False,True,132,1,0,7.790174126537432,-22,2
user_002706,23,50k-75k,desktop,returning,West,92,False,0,0,0,False,False,False,0,0,0,,0,0
user_002707,51,50k-75k,desktop,returning,West,61,True,98,4,1,False,False,True,140,1,0,5.71979099570545,-42,3
user_002708,30,30k-50k,desktop,returning,South,49,True,61,6,0,True,True,True,68,5,1,8.176419466045397,-7,1
user_002709,48,100k-150k,mobile,new,Midwest,55,False,0,0,0,False,False,True,127,3,0,8.519335089255339,-127,-3
user_002710,64,75k-100k,desktop,returning,West,36,True,54,6,0,True,False,True,77,4,3,5.768165896296503,-23,2
user_002711,51,50k-75k,tablet,returning,West,50,False,0,0,0,True,True,True,120,1,0,7.643933355294253,-120,-1
user_002712,25,100k-150k,desktop,new,East,67,True,95,3,0,True,True,True,78,1,1,8.727496896049475,17,2
user_002713,51,30k-50k,desktop,returning,East,44,True,62,1,0,False,True,True,72,1,0,6.519790680981431,-10,0
user_002714,78,75k-100k,desktop,new,West,57,False,0,0,0,True,False,True,151,1,0,7.996344993594824,-151,-1
user_002715,32,50k-75k,desktop,new,East,98,False,0,0,0,True,True,True,76,1,0,7.996253726034385,-76,-1
user_002716,39,75k-100k,desktop,new,East,49,True,83,3,0,False,False,True,101,7,0,6.490545813595502,-18,-4
user_002717,40,75k-100k,desktop,returning,West,46,True,68,2,1,False,True,True,108,1,0,8.294750745070566,-40,1
user_002718,39,75k-100k,mobile,returning,East,38,True,100,4,0,False,False,True,120,7,2,7.801743695998302,-20,-3
user_002719,61,75k-100k,desktop,new,West,52,True,166,4,0,True,True,True,164,4,0,7.096432044644515,2,0
user_002720,63,30k-50k,desktop,new,East,29,True,167,3,1,False,False,True,184,4,0,6.3154409505964,-17,-1
user_002721,64,75k-100k,desktop,new,West,33,False,0,0,0,False,True,True,126,1,0,6.70016673764958,-126,-1
user_002722,33,<30k,desktop,returning,West,55,True,102,1,0,False,True,True,88,1,0,7.289172549708334,14,0
user_002723,43,<30k,desktop,new,East,54,True,111,1,0,True,False,True,115,2,0,6.874585151291653,-4,-1
user_002724,77,50k-75k,desktop,returning,West,29,True,102,6,1,False,False,True,138,4,0,7.62667721900058,-36,2
user_002725,31,30k-50k,desktop,returning,South,53,True,95,7,0,False,True,True,67,6,1,8.455478082193311,28,1
user_002726,30,>150k,desktop,new,Midwest,66,True,137,2,1,False,True,True,132,1,0,7.42521557534675,5,1
user_002727,30,100k-150k,mobile,new,East,89,True,76,2,0,False,True,True,56,1,0,9.089684252768086,20,1
user_002728,36,50k-75k,desktop,returning,West,70,True,129,3,0,True,True,True,93,2,0,6.382284542178577,36,1
user_002729,36,75k-100k,mobile,new,Midwest,37,True,92,1,0,False,False,True,88,1,0,6.780492214230537,4,0
user_002730,44,50k-75k,desktop,new,West,55,True,109,1,0,False,False,False,0,0,0,,109,1
user_002731,55,50k-75k,mobile,new,East,63,True,127,3,0,False,False,True,132,2,0,7.7328597669550065,-5,1
user_002732,18,100k-150k,mobile,returning,East,78,True,98,4,0,False,True,True,86,5,0,8.35207565057842,12,-1
user_002733,33,50k-75k,desktop,returning,South,99,True,89,1,1,False,True,True,63,1,0,9.083745413746634,26,0
user_002734,62,<30k,tablet,returning,Midwest,0,True,109,1,1,False,True,True,52,1,0,7.656778890132233,57,0
user_002735,41,100k-150k,mobile,new,West,67,True,131,1,0,True,True,True,94,2,0,7.6031349056857085,37,-1
user_002736,53,50k-75k,mobile,new,South,69,True,119,1,0,False,True,True,88,1,0,7.36127975134718,31,0
user_002737,58,30k-50k,mobile,returning,East,25,True,99,7,0,False,True,True,97,8,0,10.0,2,-1
user_002738,49,50k-75k,desktop,new,East,20,False,0,0,0,True,True,True,104,2,0,8.54779388613062,-104,-2
user_002739,47,75k-100k,desktop,returning,Midwest,53,True,71,3,1,False,False,True,60,3,0,5.022165493564883,11,0
user_002740,18,<30k,desktop,new,South,60,True,122,1,1,False,False,True,114,1,0,7.5617180077272215,8,0
user_002741,56,<30k,mobile,returning,West,34,True,86,1,0,False,False,True,102,1,0,6.918998595936503,-16,0
user_002742,55,50k-75k,mobile,returning,East,52,True,59,2,0,False,True,True,57,2,0,9.39569215105326,2,0
user_002743,53,<30k,mobile,returning,South,29,False,0,0,0,True,True,True,90,1,0,8.00605818145977,-90,-1
user_002744,63,<30k,desktop,returning,Midwest,11,True,119,1,0,True,False,True,126,1,0,8.23121838702087,-7,0
user_002745,46,30k-50k,mobile,returning,South,69,True,66,1,1,True,False,True,73,3,0,5.674772088561006,-7,-2
user_002746,38,50k-75k,mobile,returning,South,76,True,60,3,0,False,True,True,59,7,0,8.763900121325364,1,-4
user_002747,63,>150k,desktop,returning,East,78,True,36,3,1,True,True,True,25,1,0,7.963646912953511,11,2
user_002748,20,50k-75k,mobile,returning,Midwest,57,True,111,1,0,True,True,True,128,1,0,9.281364790926537,-17,0
user_002749,49,75k-100k,desktop,new,East,57,True,108,5,0,False,False,True,116,3,0,7.5086037951330304,-8,2
user_002750,18,30k-50k,desktop,new,South,51,True,181,3,0,False,True,True,118,4,0,9.020846395171063,63,-1
user_002751,28,50k-75k,desktop,returning,East,66,True,100,2,0,True,True,True,34,1,0,8.551877344833247,66,1
user_002752,24,<30k,desktop,new,Midwest,57,False,0,0,0,True,True,False,0,0,0,,0,0
user_002753,27,50k-75k,mobile,returning,South,63,True,80,2,0,True,True,True,57,1,0,7.657105905655554,23,1
user_002754,62,75k-100k,mobile,returning,East,32,True,97,7,0,False,False,True,97,9,2,8.028845825820515,0,-2
user_002755,45,75k-100k,mobile,new,South,39,True,122,5,0,True,False,True,102,8,0,6.9407581122662485,20,-3
user_002756,58,75k-100k,desktop,returning,Midwest,38,True,136,6,0,True,True,True,123,5,0,6.103439515389866,13,1
user_002757,39,75k-100k,mobile,returning,Midwest,54,True,66,6,0,True,True,True,20,7,0,8.927088905893347,46,-1
user_002758,53,30k-50k,desktop,returning,West,70,True,81,2,1,False,True,True,78,1,1,6.756862667873987,3,1
user_002759,38,30k-50k,desktop,returning,South,42,True,103,2,0,False,True,True,82,1,0,6.782080460485943,21,1
user_002760,55,50k-75k,mobile,returning,South,50,True,107,2,0,True,False,True,90,1,0,8.736302509968011,17,1
user_002761,80,50k-75k,desktop,returning,Midwest,32,True,116,4,1,True,False,True,146,3,0,7.949278000995365,-30,1
user_002762,72,75k-100k,mobile,returning,South,25,True,181,10,1,False,False,True,191,10,0,6.554074820677361,-10,0
user_002763,34,75k-100k,desktop,returning,South,63,True,88,5,2,True,True,True,64,3,0,8.035129734129512,24,2
user_002764,50,100k-150k,desktop,returning,West,69,True,109,3,0,True,False,True,104,1,0,6.484638748931286,5,2
user_002765,42,100k-150k,desktop,new,Midwest,74,True,89,3,0,False,True,True,90,2,0,9.675359358213521,-1,1
user_002766,67,50k-75k,mobile,new,South,37,True,109,1,0,True,False,False,0,0,0,,109,1
user_002767,21,30k-50k,desktop,returning,South,86,True,33,3,0,True,True,True,34,5,1,8.542050472697465,-1,-2
user_002768,53,<30k,desktop,new,East,43,True,109,2,0,False,False,True,66,1,0,6.541644171800645,43,1
user_002769,32,100k-150k,desktop,returning,West,90,True,118,5,0,False,True,True,71,3,0,5.760466655959416,47,2
user_002770,70,>150k,desktop,new,East,86,True,64,3,0,False,True,True,84,4,0,8.91294893049533,-20,-1
user_002771,47,<30k,tablet,new,West,38,True,65,7,0,False,False,False,0,0,0,,65,7
user_002772,39,<30k,mobile,returning,Midwest,24,True,141,4,0,False,False,True,162,6,0,7.422396193786625,-21,-2
user_002773,45,50k-75k,mobile,returning,West,50,True,105,3,0,True,True,True,83,2,0,8.004419954514827,22,1
user_002774,57,30k-50k,mobile,returning,South,38,True,68,2,2,False,True,True,62,1,1,8.603837118691283,6,1
user_002775,28,100k-150k,tablet,returning,Midwest,72,True,48,5,0,True,True,True,40,4,0,9.632191225279035,8,1
user_002776,18,75k-100k,tablet,returning,Midwest,61,True,102,2,0,True,True,True,99,2,0,8.1266308926201,3,0
user_002777,49,50k-75k,desktop,returning,Midwest,41,True,122,3,0,True,True,True,76,2,0,7.361349318560112,46,1
user_002778,42,30k-50k,mobile,returning,East,42,False,0,0,0,False,False,False,0,0,0,,0,0
user_002779,52,75k-100k,mobile,returning,Midwest,49,True,93,4,0,True,False,True,54,5,0,5.687894116561775,39,-1
user_002780,60,50k-75k,mobile,new,East,24,True,213,10,1,False,False,True,183,9,0,6.256625730695729,30,1
user_002781,35,75k-100k,desktop,returning,South,72,True,77,2,0,True,True,True,65,2,0,9.53608117437129,12,0
user_002782,52,>150k,desktop,new,East,68,True,108,5,0,False,False,True,127,4,0,6.567031238055384,-19,1
user_002783,33,30k-50k,mobile,returning,South,43,True,120,4,0,True,True,False,0,0,0,,120,4
user_002784,35,75k-100k,mobile,returning,West,54,True,62,1,0,False,True,True,24,1,0,7.846106833147204,38,0
user_002785,66,<30k,desktop,new,South,3,True,234,6,1,True,True,True,164,9,0,9.930128528608508,70,-3
user_002786,56,30k-50k,mobile,returning,Midwest,41,True,156,1,0,False,False,True,188,1,0,5.471464094535061,-32,0
user_002787,43,75k-100k,mobile,returning,Midwest,40,True,81,1,0,True,True,True,73,1,1,6.6055404848241945,8,0
user_002788,32,50k-75k,desktop,returning,South,56,True,66,3,0,True,True,True,80,3,0,6.60593075403151,-14,0
user_002789,36,<30k,desktop,returning,East,42,True,30,1,0,False,True,True,20,2,0,6.537215915629312,10,-1
user_002790,48,<30k,desktop,returning,Midwest,38,True,97,3,0,False,True,True,52,1,0,7.238211304953325,45,2
user_002791,34,30k-50k,desktop,returning,South,75,True,70,1,0,True,True,True,57,1,0,8.99531008848461,13,0
user_002792,49,30k-50k,desktop,returning,East,41,True,30,2,0,False,True,True,26,1,0,8.33147209821101,4,1
user_002793,18,30k-50k,mobile,new,East,87,True,129,2,2,True,True,True,53,1,0,7.976704377644962,76,1
user_002794,47,<30k,mobile,new,Midwest,21,True,141,5,0,True,False,True,140,6,0,7.6550258243977245,1,-1
user_002795,38,<30k,mobile,new,West,80,False,0,0,0,False,False,True,92,1,0,7.339640601974165,-92,-1
user_002796,33,100k-150k,mobile,new,East,100,True,122,5,1,True,True,True,99,4,0,6.964623375585845,23,1
user_002797,66,50k-75k,mobile,new,South,33,False,0,0,0,False,True,True,86,1,0,10.0,-86,-1
user_002798,40,75k-100k,desktop,new,Midwest,27,True,156,9,0,True,False,True,123,8,0,5.837589767439636,33,1
user_002799,38,75k-100k,desktop,returning,Midwest,30,False,0,0,0,False,False,True,122,1,0,5.8482590402549155,-122,-1
user_002800,44,<30k,desktop,returning,East,26,True,124,4,0,False,False,True,154,2,0,6.310997086679752,-30,2
user_002801,42,100k-150k,desktop,new,South,62,True,161,5,0,True,True,True,133,3,0,8.673705320965698,28,2
user_002802,52,100k-150k,desktop,returning,East,79,False,0,0,0,False,True,True,81,1,0,7.024431341045109,-81,-1
user_002803,27,<30k,tablet,new,Midwest,62,True,84,3,0,False,True,True,53,4,0,9.513855414140432,31,-1
user_002804,71,30k-50k,desktop,returning,Midwest,30,False,0,0,0,True,True,True,129,1,0,7.142224522903789,-129,-1
user_002805,22,50k-75k,mobile,returning,South,62,True,140,3,0,False,True,True,110,4,0,9.179550772680612,30,-1
user_002806,32,100k-150k,desktop,new,South,87,True,80,1,1,True,True,True,88,1,0,5.781219684417885,-8,0
user_002807,32,30k-50k,desktop,returning,West,63,True,104,1,0,True,True,True,95,1,0,10.0,9,0
user_002808,45,50k-75k,mobile,new,Midwest,67,True,123,1,0,True,True,True,90,1,0,8.516950771257056,33,0
user_002809,34,50k-75k,mobile,returning,South,74,True,72,3,0,True,True,True,64,1,0,7.763084635692375,8,2
user_002810,53,50k-75k,desktop,returning,East,60,True,84,1,0,True,False,True,90,1,0,7.1724833712903555,-6,0
user_002811,53,50k-75k,desktop,returning,South,40,True,119,2,0,False,False,True,121,2,0,7.779779047527998,-2,0
user_002812,45,75k-100k,desktop,new,Midwest,27,True,144,4,1,True,False,True,173,1,1,7.567651913734365,-29,3
user_002813,33,30k-50k,mobile,new,Midwest,60,True,47,6,0,False,False,True,34,10,0,6.186432762722039,13,-4
user_002814,59,30k-50k,mobile,returning,East,28,True,149,1,0,False,False,True,131,1,0,5.332055139682604,18,0
user_002815,49,75k-100k,desktop,returning,South,62,True,128,2,1,True,True,True,92,1,0,8.129718948107856,36,1
user_002816,45,75k-100k,desktop,new,West,68,True,106,2,0,True,True,True,115,3,1,6.932602157058358,-9,-1
user_002817,58,50k-75k,desktop,returning,West,58,True,133,5,3,False,False,True,132,6,0,6.179758030993327,1,-1
user_002818,48,30k-50k,tablet,new,East,36,True,96,3,1,False,False,True,97,2,0,5.480695680740437,-1,1
user_002819,49,50k-75k,mobile,returning,West,80,False,0,0,0,False,True,True,109,2,0,6.751332973866507,-109,-2
user_002820,62,>150k,desktop,new,West,36,True,118,3,0,False,True,True,57,2,0,7.716107192487333,61,1
user_002821,53,50k-75k,tablet,returning,South,37,True,99,5,0,False,False,True,101,2,0,4.8529483236122255,-2,3
user_002822,69,75k-100k,tablet,returning,West,57,True,109,2,0,False,True,True,80,2,0,9.267940139669152,29,0
user_002823,30,30k-50k,mobile,returning,East,65,True,84,4,0,False,True,True,29,1,0,8.961206392286199,55,3
user_002824,64,100k-150k,desktop,new,South,20,True,136,2,0,False,False,True,160,1,0,6.181439836000235,-24,1
user_002825,34,50k-75k,desktop,returning,West,86,True,71,5,0,True,True,True,88,3,0,8.856628200958845,-17,2
user_002826,48,30k-50k,mobile,new,East,32,True,124,3,0,False,True,True,98,3,0,8.727834635235812,26,0
user_002827,55,75k-100k,mobile,returning,West,42,True,166,1,0,True,True,True,147,1,0,9.9456829930195,19,0
user_002828,30,50k-75k,desktop,new,South,69,True,61,2,0,True,True,True,20,1,0,8.095433683860435,41,1
user_002829,24,50k-75k,desktop,returning,West,70,True,85,3,1,True,True,True,61,5,0,7.159669198041327,24,-2
user_002830,47,50k-75k,desktop,returning,East,62,True,66,4,1,True,True,True,62,2,0,8.871983867977246,4,2
user_002831,49,50k-75k,mobile,returning,Midwest,52,False,0,0,0,True,True,True,121,1,1,7.539950713628965,-121,-1
user_002832,41,50k-75k,desktop,new,East,72,False,0,0,0,False,False,True,106,3,1,7.143221143664712,-106,-3
user_002833,59,100k-150k,mobile,returning,Midwest,45,True,91,3,0,False,False,True,117,5,0,8.196441319606988,-26,-2
user_002834,29,>150k,mobile,new,West,100,False,0,0,0,False,True,True,71,1,0,9.413006250692929,-71,-1
user_002835,72,75k-100k,mobile,returning,South,63,False,0,0,0,False,False,True,125,3,0,7.1572360878118495,-125,-3
user_002836,38,<30k,mobile,returning,East,57,True,137,5,0,True,True,False,0,0,0,,137,5
user_002837,41,75k-100k,mobile,new,East,42,True,101,4,1,False,False,True,109,6,1,5.4695263751269385,-8,-2
user_002838,35,50k-75k,tablet,new,South,36,True,106,5,0,False,True,True,71,2,0,7.090500206582014,35,3
user_002839,18,50k-75k,desktop,new,West,72,True,87,2,2,False,True,True,34,1,0,9.695357291346856,53,1
user_002840,60,75k-100k,desktop,new,South,16,True,107,4,0,False,True,True,98,3,0,6.813688170077289,9,1
user_002841,63,75k-100k,tablet,returning,Midwest,12,False,0,0,0,False,False,True,127,1,1,7.435811032170248,-127,-1
user_002842,18,50k-75k,mobile,returning,West,100,True,60,3,0,False,True,True,25,1,0,10.0,35,2
user_002843,51,50k-75k,tablet,new,Midwest,47,True,131,2,0,False,False,True,144,1,0,6.804456581557963,-13,1
user_002844,57,75k-100k,desktop,new,East,47,True,109,5,0,False,False,True,96,8,1,8.91899955675313,13,-3
user_002845,51,75k-100k,desktop,new,East,39,True,96,1,0,False,False,True,107,4,1,7.06645759378195,-11,-3
user_002846,38,30k-50k,desktop,returning,East,38,True,112,1,0,True,True,True,92,1,0,6.532346319374432,20,0
user_002847,34,30k-50k,desktop,new,South,73,False,0,0,0,False,True,True,140,2,0,5.732380768607621,-140,-2
user_002848,38,75k-100k,desktop,returning,West,50,True,106,5,0,True,False,True,103,5,0,7.078925213288108,3,0
user_002849,28,50k-75k,desktop,returning,South,79,False,0,0,0,False,False,True,128,1,1,6.757345866065192,-128,-1
user_002850,61,30k-50k,desktop,new,Midwest,8,True,153,6,0,False,False,True,143,4,0,6.72014200231374,10,2
user_002851,22,100k-150k,mobile,returning,East,100,True,31,1,0,False,True,True,20,2,0,6.926851383981785,11,-1
user_002852,25,75k-100k,desktop,returning,South,56,True,50,4,1,True,True,True,42,4,0,9.390721767146323,8,0
user_002853,41,75k-100k,desktop,returning,East,45,True,33,5,0,False,True,True,20,1,0,10.0,13,4
user_002854,58,>150k,desktop,returning,East,64,True,92,3,0,False,True,True,69,2,0,6.813894246117,23,1
user_002855,50,30k-50k,desktop,returning,East,55,True,86,2,0,True,True,True,22,2,0,9.328988513660562,64,0
user_002856,44,100k-150k,desktop,returning,East,84,True,65,4,0,False,True,True,60,3,0,8.104910372854368,5,1
user_002857,26,30k-50k,desktop,new,Midwest,52,True,146,3,0,False,True,True,122,1,0,7.7846657524560445,24,2
user_002858,52,>150k,desktop,returning,Midwest,69,True,71,3,1,True,True,True,83,4,0,10.0,-12,-1
user_002859,55,50k-75k,tablet,new,South,8,False,0,0,0,False,False,True,140,1,0,9.390604981211954,-140,-1
user_002860,62,<30k,desktop,returning,South,17,True,133,1,1,True,False,False,0,0,0,,133,1
user_002861,60,30k-50k,desktop,returning,South,39,True,108,1,0,True,True,True,126,1,0,7.6440102318227865,-18,0
user_002862,34,30k-50k,desktop,returning,West,86,True,106,4,0,False,True,True,88,3,1,8.544383584900697,18,1
user_002863,47,50k-75k,mobile,returning,Midwest,74,True,119,1,1,False,True,True,100,4,0,7.301588034731501,19,-3
user_002864,58,50k-75k,mobile,returning,East,22,True,139,5,1,True,True,False,0,0,0,,139,5
user_002865,43,50k-75k,desktop,new,Midwest,37,True,148,7,0,True,True,True,110,9,0,7.803821169554608,38,-2
user_002866,53,30k-50k,desktop,returning,East,63,True,103,4,0,True,False,True,113,2,0,9.397070839192248,-10,2
user_002867,39,>150k,desktop,new,Midwest,60,True,105,1,1,False,True,True,73,1,0,6.799500705434226,32,0
user_002868,45,30k-50k,desktop,returning,South,22,False,0,0,0,False,False,True,87,1,0,5.655337250804223,-87,-1
user_002869,60,100k-150k,desktop,returning,South,45,True,136,2,0,True,True,True,120,2,0,8.792223191835507,16,0
user_002870,18,50k-75k,mobile,returning,East,70,True,87,2,0,False,True,True,87,1,0,9.005256074496929,0,1
user_002871,52,75k-100k,tablet,new,South,35,True,94,2,0,False,True,True,74,1,0,7.8007673335624155,20,1
user_002872,34,<30k,desktop,new,West,80,False,0,0,0,True,True,False,0,0,0,,0,0
user_002873,18,30k-50k,mobile,returning,Midwest,53,True,87,3,1,True,True,True,34,1,0,8.210725347859505,53,2
user_002874,57,100k-150k,desktop,returning,East,57,True,55,1,0,False,True,True,66,1,1,7.3169848374685555,-11,0
user_002875,61,50k-75k,desktop,returning,Midwest,17,True,124,4,0,False,False,True,79,4,0,8.119535966789478,45,0
user_002876,24,30k-50k,desktop,returning,South,63,True,117,3,0,False,True,True,75,2,0,8.765156305876125,42,1
user_002877,44,<30k,desktop,returning,Midwest,38,False,0,0,0,False,True,True,97,2,0,7.813132775652047,-97,-2
user_002878,48,50k-75k,desktop,returning,South,30,True,99,3,0,False,True,True,69,3,0,7.8177475153991915,30,0
user_002879,64,75k-100k,desktop,returning,South,30,True,109,2,0,False,False,True,114,3,0,7.4388507002939095,-5,-1
user_002880,51,50k-75k,mobile,new,South,46,True,120,2,0,False,False,False,0,0,0,,120,2
user_002881,36,30k-50k,mobile,returning,West,54,True,101,3,0,False,False,True,94,1,0,10.0,7,2
user_002882,58,30k-50k,mobile,returning,East,33,True,75,7,0,True,False,True,96,10,0,6.923799823127962,-21,-3
user_002883,49,75k-100k,desktop,returning,South,57,True,73,3,0,True,True,True,55,5,0,8.334931152808862,18,-2
user_002884,58,100k-150k,desktop,new,South,46,True,97,4,0,True,True,False,0,0,0,,97,4
user_002885,47,<30k,mobile,returning,West,64,True,132,1,0,True,False,True,144,1,1,6.188961584313847,-12,0
user_002886,42,75k-100k,desktop,returning,Midwest,28,True,150,1,0,False,False,True,141,1,1,7.158095304125231,9,0
user_002887,34,50k-75k,desktop,new,South,38,True,147,5,0,True,True,True,108,3,0,8.835822872387393,39,2
user_002888,33,30k-50k,desktop,new,West,88,True,87,4,0,True,True,True,58,4,0,7.896415868665955,29,0
user_002889,36,30k-50k,desktop,new,East,53,True,117,1,0,False,False,True,115,1,0,4.27759059903102,2,0
user_002890,37,100k-150k,desktop,new,South,56,True,193,2,0,False,False,True,195,4,0,6.265005514856175,-2,-2
user_002891,52,<30k,mobile,returning,East,51,False,0,0,0,False,True,True,86,1,0,7.323643316259825,-86,-1
user_002892,39,50k-75k,desktop,returning,West,31,True,104,2,0,False,True,True,93,1,0,9.035727547975059,11,1
user_002893,59,50k-75k,desktop,new,Midwest,57,True,128,4,0,False,False,True,128,4,0,8.04686639330249,0,0
user_002894,44,<30k,desktop,returning,East,52,True,119,2,0,False,False,True,128,4,0,7.241221972410419,-9,-2
user_002895,20,<30k,mobile,returning,South,56,True,132,1,0,False,True,False,0,0,0,,132,1
user_002896,43,50k-75k,desktop,returning,Midwest,74,True,87,1,2,False,True,True,77,1,0,6.152916576845265,10,0
user_002897,33,50k-75k,desktop,returning,South,63,True,79,6,0,True,True,True,41,3,0,6.883390531623223,38,3
user_002898,44,75k-100k,mobile,new,East,75,False,0,0,0,False,True,True,110,2,0,7.934823465146982,-110,-2
user_002899,73,<30k,desktop,returning,South,19,True,166,4,0,True,True,False,0,0,0,,166,4
user_002900,44,30k-50k,desktop,returning,South,37,True,102,8,0,False,False,True,107,10,0,5.4575757356362775,-5,-2
user_002901,49,75k-100k,mobile,returning,South,44,True,113,1,0,True,True,False,0,0,0,,113,1
user_002902,49,<30k,desktop,returning,East,49,True,38,3,0,True,False,True,34,3,0,8.459321902566979,4,0
user_002903,60,30k-50k,desktop,returning,South,24,False,0,0,0,True,False,False,0,0,0,,0,0
user_002904,27,75k-100k,mobile,returning,West,75,True,30,5,0,False,True,True,48,2,1,7.884010330062587,-18,3
user_002905,20,<30k,mobile,returning,East,60,False,0,0,0,False,True,True,109,1,0,8.338259951723431,-109,-1
user_002906,65,75k-100k,desktop,returning,South,43,True,121,1,0,True,False,True,139,1,0,8.249782268293245,-18,0
user_002907,40,30k-50k,mobile,returning,South,31,True,95,7,0,False,False,True,74,3,1,7.73422596525087,21,4
user_002908,31,75k-100k,desktop,returning,West,77,True,62,1,0,True,True,True,41,1,0,7.196016731292297,21,0
user_002909,33,50k-75k,mobile,returning,East,57,True,82,1,0,True,True,True,61,2,0,7.525482842649171,21,-1
user_002910,40,50k-75k,desktop,returning,West,83,True,66,2,0,True,True,True,38,2,0,6.229322986871251,28,0
user_002911,57,75k-100k,desktop,new,West,59,True,77,6,1,True,False,True,68,4,0,7.74345378658847,9,2
user_002912,30,50k-75k,mobile,new,East,66,True,87,4,0,True,True,True,126,1,0,9.135949407116376,-39,3
user_002913,64,<30k,desktop,returning,South,2,True,116,6,0,False,False,True,110,9,0,5.9055909575995615,6,-3
user_002914,46,30k-50k,desktop,new,West,71,False,0,0,0,False,True,True,113,1,0,9.542141549442853,-113,-1
user_002915,53,100k-150k,mobile,new,East,91,True,122,3,0,True,True,True,112,5,0,8.135451664990525,10,-2
user_002916,45,100k-150k,mobile,returning,East,44,True,84,4,0,True,True,True,61,1,1,9.748563744964645,23,3
user_002917,19,50k-75k,mobile,new,East,57,False,0,0,0,True,True,True,65,1,0,7.955794254427041,-65,-1
user_002918,47,<30k,mobile,returning,South,34,True,94,4,1,True,True,True,35,3,0,8.392383931742822,59,1
user_002919,60,75k-100k,mobile,new,South,35,True,113,3,0,False,False,True,126,1,0,5.827528613861452,-13,2
user_002920,30,100k-150k,mobile,new,West,91,False,0,0,0,False,True,True,100,1,0,6.511044801446018,-100,-1
user_002921,73,30k-50k,mobile,new,East,20,True,152,3,1,True,False,True,150,1,0,6.74067095598204,2,2
user_002922,68,100k-150k,mobile,new,South,45,True,92,6,2,True,False,True,74,8,0,8.10832316685894,18,-2
user_002923,54,30k-50k,desktop,returning,Midwest,56,True,112,7,0,True,True,True,88,5,0,5.593517441017743,24,2
user_002924,21,<30k,desktop,new,West,77,True,54,3,0,False,True,True,39,2,0,7.626346475117355,15,1
user_002925,19,75k-100k,desktop,new,Midwest,80,True,149,1,1,True,True,True,122,1,0,7.632772449313146,27,0
user_002926,45,50k-75k,mobile,returning,West,62,True,103,1,0,True,True,False,0,0,0,,103,1
user_002927,36,50k-75k,mobile,returning,East,17,True,99,8,0,False,False,True,114,10,0,6.296525137471621,-15,-2
user_002928,50,30k-50k,mobile,returning,South,62,True,101,5,0,False,False,True,133,3,0,7.980806218704043,-32,2
user_002929,55,100k-150k,mobile,returning,East,45,True,52,3,0,True,True,True,90,1,0,6.881546739088427,-38,2
user_002930,54,50k-75k,desktop,new,Midwest,72,False,0,0,0,True,True,False,0,0,0,,0,0
user_002931,72,<30k,mobile,new,South,22,False,0,0,0,False,False,True,131,1,0,5.360642688020629,-131,-1
user_002932,31,<30k,mobile,returning,East,50,True,73,1,0,False,False,True,88,1,1,7.089773358950183,-15,0
user_002933,29,<30k,mobile,returning,East,62,True,84,4,0,True,True,True,93,2,0,8.732851448097795,-9,2
user_002934,51,100k-150k,desktop,new,East,68,True,94,2,0,False,False,True,76,2,0,9.01528136832158,18,0
user_002935,34,30k-50k,desktop,new,East,70,True,159,1,0,True,True,False,0,0,0,,159,1
user_002936,49,75k-100k,desktop,returning,East,69,True,76,6,0,False,False,True,97,4,0,7.817442783671569,-21,2
user_002937,19,30k-50k,desktop,returning,South,69,True,102,2,0,True,False,False,0,0,0,,102,2
user_002938,25,75k-100k,tablet,new,East,72,True,83,1,0,True,True,True,85,1,0,9.574509266407391,-2,0
user_002939,67,<30k,mobile,returning,West,28,False,0,0,0,True,False,True,125,1,0,5.3743714854974005,-125,-1
user_002940,25,>150k,tablet,returning,South,91,True,69,1,0,True,True,True,29,1,0,10.0,40,0
user_002941,29,50k-75k,mobile,returning,East,75,True,71,1,0,False,True,True,61,2,0,8.576795697508645,10,-1
user_002942,32,30k-50k,tablet,returning,South,57,True,105,2,0,False,False,True,121,1,0,7.434686005302469,-16,1
user_002943,28,50k-75k,desktop,new,Midwest,57,True,99,5,0,True,True,True,66,8,0,7.292186098188225,33,-3
user_002944,27,30k-50k,desktop,returning,East,71,True,69,1,0,True,True,True,65,2,0,8.25888284742791,4,-1
user_002945,78,100k-150k,desktop,returning,West,69,True,77,2,0,True,False,True,89,3,1,10.0,-12,-1
user_002946,46,>150k,tablet,returning,West,82,True,30,2,0,True,True,True,37,1,0,8.777509963618455,-7,1
user_002947,39,100k-150k,mobile,new,East,50,True,98,4,0,False,False,True,116,1,0,5.450332936112556,-18,3
user_002948,40,100k-150k,mobile,new,West,71,True,151,4,0,False,True,False,0,0,0,,151,4
user_002949,62,100k-150k,desktop,new,South,55,False,0,0,0,False,True,True,108,1,0,7.657297152790967,-108,-1
user_002950,29,50k-75k,tablet,new,West,47,True,161,4,0,False,False,True,169,3,0,7.635725703195754,-8,1
user_002951,51,100k-150k,desktop,new,East,63,True,102,2,0,True,True,True,71,1,0,7.297808230018604,31,1
user_002952,25,50k-75k,desktop,returning,South,74,True,66,1,0,False,True,True,28,1,0,8.738017987200184,38,0
user_002953,52,100k-150k,desktop,returning,South,66,True,59,2,0,True,False,True,69,4,0,7.407733934925062,-10,-2
user_002954,59,>150k,mobile,returning,Midwest,37,False,0,0,0,True,True,True,94,1,0,5.8570833073390185,-94,-1
user_002955,50,75k-100k,desktop,returning,East,75,True,121,2,0,True,True,True,88,2,0,7.399062038858346,33,0
user_002956,47,30k-50k,mobile,returning,Midwest,64,True,97,2,0,True,True,True,104,1,0,6.49160092418718,-7,1
user_002957,53,30k-50k,mobile,returning,South,44,True,96,3,0,False,False,True,124,1,0,6.664244322938366,-28,2
user_002958,45,50k-75k,mobile,new,South,40,True,134,2,0,False,False,True,150,1,0,6.296454798267605,-16,1
user_002959,57,<30k,mobile,new,South,22,True,185,8,1,True,False,False,0,0,0,,185,8
user_002960,36,75k-100k,tablet,returning,Midwest,85,True,75,3,0,False,False,True,123,2,0,9.243241438583356,-48,1
user_002961,53,100k-150k,desktop,returning,South,43,True,140,2,1,True,True,True,145,1,0,6.197544397695446,-5,1
user_002962,42,30k-50k,desktop,returning,South,34,True,115,2,1,False,True,True,131,1,0,9.013582924544762,-16,1
user_002963,35,100k-150k,desktop,returning,South,56,True,48,5,0,False,True,True,20,6,1,9.382154299011557,28,-1
user_002964,27,<30k,desktop,returning,Midwest,32,False,0,0,0,False,True,False,0,0,0,,0,0
user_002965,63,>150k,mobile,returning,East,36,True,96,1,0,True,True,True,57,1,0,8.465325186369402,39,0
user_002966,59,75k-100k,desktop,returning,Midwest,16,True,138,5,0,True,False,True,140,6,0,8.635063083968554,-2,-1
user_002967,51,50k-75k,mobile,returning,East,5,True,125,5,0,True,True,True,88,4,0,8.362335979319148,37,1
user_002968,49,50k-75k,mobile,returning,South,30,True,65,4,0,True,True,True,34,2,0,7.417670637343654,31,2
user_002969,26,>150k,desktop,returning,South,58,True,121,1,0,True,True,True,115,2,0,7.440893285637324,6,-1
user_002970,34,75k-100k,desktop,returning,Midwest,78,True,52,3,0,True,True,True,20,4,0,7.760284119852084,32,-1
user_002971,35,<30k,mobile,returning,East,41,True,124,4,0,False,True,True,68,1,0,7.4386522993478374,56,3
user_002972,52,50k-75k,mobile,returning,East,45,True,83,3,1,False,True,True,60,3,0,8.538240546074087,23,0
user_002973,18,30k-50k,desktop,returning,East,63,True,84,1,0,False,True,True,77,1,0,6.798938455587732,7,0
user_002974,35,<30k,mobile,returning,Midwest,6,True,112,3,2,False,True,True,115,2,0,6.670207666305265,-3,1
user_002975,54,50k-75k,desktop,returning,West,65,True,101,1,0,False,True,True,90,1,0,9.31411882735126,11,0
user_002976,39,50k-75k,desktop,new,West,37,True,165,1,0,False,True,True,142,1,0,9.546823096677539,23,0
user_002977,67,100k-150k,desktop,new,East,28,True,205,1,0,True,True,False,0,0,0,,205,1
user_002978,39,50k-75k,mobile,returning,West,56,True,67,4,0,True,True,True,43,3,0,8.387811775168935,24,1
user_002979,38,30k-50k,desktop,returning,Midwest,56,True,65,4,0,False,True,True,56,1,0,6.717169589868616,9,3
user_002980,39,100k-150k,mobile,returning,East,51,True,138,4,0,False,True,True,69,1,0,9.219300501812299,69,3
user_002981,55,30k-50k,mobile,new,West,53,True,114,3,0,False,True,False,0,0,0,,114,3
user_002982,33,30k-50k,mobile,returning,South,50,True,128,4,0,False,False,True,105,5,0,6.288320620666495,23,-1
user_002983,36,>150k,mobile,returning,West,89,True,103,1,0,True,True,True,65,1,1,8.361891620155973,38,0
user_002984,72,50k-75k,mobile,returning,South,15,True,113,1,0,True,True,True,95,1,0,6.395455126598378,18,0
user_002985,47,30k-50k,mobile,returning,East,52,True,121,1,0,False,True,True,94,2,0,7.107428737975886,27,-1
user_002986,62,>150k,desktop,returning,East,67,True,89,2,0,True,False,True,70,2,0,7.324577796578531,19,0
user_002987,49,100k-150k,mobile,new,Midwest,70,True,100,3,1,True,True,True,85,1,0,8.890479010017728,15,2
user_002988,21,50k-75k,mobile,returning,Midwest,76,True,128,2,0,False,True,True,111,1,0,7.722080450878443,17,1
user_002989,57,100k-150k,desktop,returning,West,54,True,90,3,0,False,True,True,40,1,0,6.575871339413861,50,2
user_002990,31,<30k,desktop,returning,South,44,True,80,2,1,False,False,True,80,4,1,6.482056986028674,0,-2
user_002991,24,100k-150k,desktop,new,West,100,True,88,4,1,True,True,True,84,8,0,7.786831678834002,4,-4
user_002992,42,100k-150k,desktop,returning,West,90,True,82,4,0,True,True,True,50,8,0,8.628939386344152,32,-4
user_002993,32,100k-150k,desktop,returning,West,100,True,30,1,0,True,True,True,20,2,1,10.0,10,-1
user_002994,55,50k-75k,mobile,new,West,55,True,166,5,0,False,False,True,162,7,0,5.462785389022227,4,-2
user_002995,51,50k-75k,desktop,new,Midwest,44,True,100,1,0,False,True,True,79,1,0,7.638981372126724,21,0
user_002996,33,100k-150k,desktop,returning,West,96,True,121,3,0,True,True,True,87,4,0,7.516790283745916,34,-1
user_002997,46,30k-50k,mobile,returning,East,74,True,86,4,0,False,True,True,47,6,0,8.559822707494437,39,-2
user_002998,68,<30k,desktop,returning,South,26,True,140,2,0,False,False,True,154,1,0,5.701537779107322,-14,1
user_002999,40,75k-100k,mobile,new,West,30,True,127,6,0,False,True,True,149,7,0,8.564275787815752,-22,-1
user_003000,72,>150k,mobile,returning,Midwest,51,True,84,3,0,False,False,True,84,2,0,6.504717008124379,0,1
user_003001,57,>150k,mobile,returning,East,74,True,94,6,0,False,True,True,79,7,0,7.635724284728334,15,-1
user_003002,34,<30k,mobile,new,East,68,True,110,4,0,False,True,True,115,4,0,8.079652333567827,-5,0
user_003003,47,75k-100k,mobile,returning,South,67,True,93,3,0,True,True,True,76,2,0,8.159850473747397,17,1
user_003004,53,30k-50k,desktop,new,East,34,True,131,2,0,True,False,True,136,2,0,8.866206164071192,-5,0
user_003005,45,75k-100k,desktop,returning,West,73,True,36,3,0,True,False,True,28,4,1,5.554274358902989,8,-1
user_003006,23,50k-75k,desktop,new,West,72,False,0,0,0,False,True,True,82,1,0,7.921570136901938,-82,-1
user_003007,48,30k-50k,desktop,returning,East,51,True,120,2,0,False,True,True,63,1,0,6.982417694749937,57,1
user_003008,42,<30k,desktop,returning,West,21,True,106,5,1,False,False,True,99,6,0,6.42576938057461,7,-1
user_003009,61,75k-100k,mobile,returning,Midwest,27,True,80,4,0,False,True,True,90,1,0,6.104087198375953,-10,3
user_003010,69,100k-150k,desktop,returning,West,79,True,30,4,0,False,True,True,31,5,0,8.573765285538064,-1,-1
user_003011,50,50k-75k,mobile,new,South,57,True,152,2,0,False,False,True,131,1,0,9.304911844217168,21,1
user_003012,50,75k-100k,desktop,new,East,78,True,57,2,0,False,True,True,36,1,0,8.029164970580466,21,1
user_003013,55,<30k,tablet,returning,East,42,True,66,2,0,False,False,True,76,3,0,6.040567622239873,-10,-1
user_003014,39,<30k,desktop,returning,East,56,True,149,2,0,True,True,True,141,1,0,9.104984211802224,8,1
user_003015,31,<30k,mobile,new,East,69,True,130,3,0,False,False,True,124,5,0,6.165046825154841,6,-2
user_003016,39,75k-100k,desktop,new,Midwest,74,True,112,3,0,False,True,True,66,5,0,8.176891182168333,46,-2
user_003017,33,30k-50k,desktop,returning,East,35,True,82,4,0,True,True,True,112,7,0,8.527111532241411,-30,-3
user_003018,42,<30k,desktop,new,West,49,True,139,4,0,True,False,True,118,2,0,7.425768672959081,21,2
user_003019,18,50k-75k,mobile,new,South,69,False,0,0,0,False,True,True,129,1,0,7.861367657821931,-129,-1
user_003020,55,50k-75k,mobile,new,Midwest,62,True,101,4,0,False,True,True,106,4,0,7.799203985720598,-5,0
user_003021,44,50k-75k,desktop,returning,East,12,True,60,1,0,False,False,True,34,1,0,8.931517788597006,26,0
user_003022,18,50k-75k,desktop,returning,East,51,True,136,1,0,True,True,True,74,1,1,7.220341212126832,62,0
user_003023,49,50k-75k,desktop,returning,Midwest,53,True,30,4,0,True,False,True,58,4,0,9.251489725590675,-28,0
user_003024,46,>150k,desktop,returning,West,65,True,70,3,0,False,True,True,53,4,0,7.482995598857266,17,-1
user_003025,24,>150k,mobile,new,East,100,False,0,0,0,False,True,True,91,2,0,6.403872122221291,-91,-2
user_003026,28,75k-100k,tablet,returning,East,47,True,58,2,0,True,True,True,60,1,0,8.30011913595266,-2,1
user_003027,47,50k-75k,mobile,returning,East,77,True,32,3,0,False,True,True,35,4,0,7.661100207107481,-3,-1
user_003028,48,50k-75k,desktop,new,Midwest,33,True,127,3,0,True,True,True,99,1,0,6.854765652598113,28,2
user_003029,33,30k-50k,mobile,returning,Midwest,63,True,44,3,0,True,True,True,20,1,0,8.263409648880232,24,2
user_003030,34,100k-150k,desktop,new,East,84,False,0,0,0,False,True,True,64,3,0,10.0,-64,-3
user_003031,39,75k-100k,desktop,returning,West,73,True,30,5,0,False,True,True,39,4,0,9.901882738024462,-9,1
user_003032,57,100k-150k,mobile,returning,Midwest,33,True,32,5,0,True,False,True,40,1,0,8.295181605504089,-8,4
user_003033,40,75k-100k,mobile,returning,East,58,True,133,5,0,True,True,True,124,4,0,7.571561343771499,9,1
user_003034,62,50k-75k,mobile,returning,South,22,True,115,7,1,False,True,True,91,5,0,8.341095118182205,24,2
user_003035,75,50k-75k,mobile,returning,East,29,True,138,1,0,False,False,True,196,2,0,7.5024303261147995,-58,-1
user_003036,36,30k-50k,mobile,returning,Midwest,56,True,51,3,0,True,True,True,41,2,0,6.074593128881951,10,1
user_003037,18,50k-75k,tablet,new,West,83,False,0,0,0,True,True,True,85,1,1,8.115379696294537,-85,-1
user_003038,52,30k-50k,desktop,returning,Midwest,50,True,69,1,0,True,True,True,65,1,0,7.780508795229553,4,0
user_003039,23,75k-100k,mobile,new,West,71,False,0,0,0,False,True,True,82,1,0,8.700923892398905,-82,-1
user_003040,48,<30k,desktop,new,South,36,False,0,0,0,False,True,False,0,0,0,,0,0
user_003041,55,30k-50k,tablet,returning,Midwest,13,True,145,6,0,False,False,False,0,0,0,,145,6
user_003042,31,75k-100k,desktop,returning,West,50,True,70,3,0,False,True,True,23,3,0,6.296644351560807,47,0
user_003043,33,30k-50k,mobile,new,East,69,False,0,0,0,True,True,True,107,1,0,9.94750094122551,-107,-1
user_003044,55,100k-150k,desktop,returning,West,100,True,93,3,0,True,True,True,58,3,0,7.908461545783242,35,0
user_003045,35,>150k,desktop,returning,South,64,True,135,2,0,True,True,True,144,1,0,7.499361757849069,-9,1
user_003046,41,<30k,desktop,new,Midwest,43,True,180,4,0,False,False,True,176,9,0,6.35027968577249,4,-5
user_003047,42,30k-50k,mobile,new,West,47,True,136,7,1,True,True,True,79,9,0,9.109018712622607,57,-2
user_003048,30,30k-50k,desktop,returning,South,66,True,129,2,0,False,False,True,146,2,0,7.1462631846566795,-17,0
user_003049,27,75k-100k,mobile,new,South,55,True,85,2,0,False,True,True,67,1,0,6.895601130005345,18,1
user_003050,68,100k-150k,desktop,new,East,58,True,139,3,0,False,False,True,167,5,0,4.478063850560672,-28,-2
user_003051,58,<30k,desktop,returning,East,12,False,0,0,0,True,False,True,109,1,0,6.573962178408424,-109,-1
user_003052,57,30k-50k,desktop,returning,West,53,True,95,1,0,True,True,True,70,1,0,8.925646567930567,25,0
user_003053,65,50k-75k,mobile,new,Midwest,0,True,163,5,0,False,False,False,0,0,0,,163,5
user_003054,54,30k-50k,mobile,returning,East,50,True,42,1,0,True,True,True,40,1,0,8.996044735217186,2,0
user_003055,51,75k-100k,desktop,new,South,49,True,92,1,1,False,True,False,0,0,0,,92,1
user_003056,54,50k-75k,desktop,returning,West,64,True,110,3,0,True,False,True,104,1,0,7.68629745636177,6,2
user_003057,67,30k-50k,mobile,returning,East,49,False,0,0,0,False,False,True,118,1,0,6.049117759716206,-118,-1
user_003058,52,30k-50k,desktop,returning,South,50,False,0,0,0,False,False,True,136,1,0,8.826819538523418,-136,-1
user_003059,43,<30k,mobile,new,East,54,True,82,3,0,True,True,False,0,0,0,,82,3
user_003060,65,100k-150k,mobile,new,South,39,True,120,3,1,False,False,True,90,3,0,7.784792659089115,30,0
user_003061,44,30k-50k,desktop,returning,South,31,True,51,2,1,True,True,True,47,2,0,5.849712712071565,4,0
user_003062,26,100k-150k,desktop,new,East,81,True,100,3,0,True,True,True,83,4,0,9.443613017715728,17,-1
user_003063,70,75k-100k,mobile,new,Midwest,28,True,170,3,1,False,True,True,133,4,0,5.817848056751372,37,-1
user_003064,38,>150k,mobile,returning,West,73,True,78,3,0,True,True,True,67,2,0,8.99254928113486,11,1
user_003065,23,<30k,mobile,new,South,63,False,0,0,0,True,True,False,0,0,0,,0,0
user_003066,18,30k-50k,mobile,new,Midwest,74,True,133,3,0,True,True,True,100,3,0,10.0,33,0
user_003067,40,<30k,mobile,new,West,53,True,173,3,0,False,False,True,135,6,0,6.555562022974069,38,-3
user_003068,22,75k-100k,mobile,new,South,71,True,64,1,0,True,True,True,59,1,0,9.234411148449103,5,0
user_003069,29,100k-150k,mobile,new,South,95,True,132,3,1,False,True,True,129,2,0,7.2097487676956415,3,1
user_003070,58,<30k,desktop,new,West,35,False,0,0,0,False,False,True,135,1,0,7.479903408474044,-135,-1
user_003071,37,<30k,desktop,returning,East,33,True,42,7,0,False,True,True,20,10,0,9.197985552108728,22,-3
user_003072,57,100k-150k,desktop,returning,Midwest,56,True,30,1,0,False,False,True,20,1,0,9.29651369464495,10,0
user_003073,71,100k-150k,mobile,new,Midwest,21,True,120,6,0,False,False,True,156,6,0,7.074829264655107,-36,0
user_003074,44,50k-75k,mobile,returning,Midwest,66,True,85,5,0,True,True,True,81,5,0,7.952107170287495,4,0
user_003075,46,30k-50k,mobile,returning,East,78,True,30,1,0,False,False,True,20,1,0,6.070313989657442,10,0
user_003076,34,30k-50k,desktop,new,East,100,False,0,0,0,True,True,True,117,1,0,8.833380191370143,-117,-1
user_003077,61,75k-100k,desktop,returning,East,63,True,79,3,0,False,True,True,63,2,0,7.095908782020937,16,1
user_003078,28,50k-75k,desktop,returning,West,64,False,0,0,0,False,True,True,71,1,0,8.965558499763626,-71,-1
user_003079,36,75k-100k,mobile,returning,South,76,True,100,1,0,False,True,False,0,0,0,,100,1
user_003080,74,100k-150k,desktop,returning,Midwest,67,False,0,0,0,False,False,False,0,0,0,,0,0
user_003081,48,30k-50k,desktop,new,East,51,True,154,3,1,False,False,True,146,2,1,6.5105713854322955,8,1
user_003082,38,>150k,desktop,returning,West,77,True,136,1,0,True,True,True,101,1,0,6.617751160135308,35,0
user_003083,37,30k-50k,desktop,new,West,73,True,65,2,0,True,True,True,66,4,0,9.755867825104742,-1,-2
user_003084,34,<30k,mobile,new,West,86,False,0,0,0,True,False,True,133,1,1,8.307336449768401,-133,-1
user_003085,61,100k-150k,mobile,returning,Midwest,70,True,84,2,0,True,True,True,52,4,0,7.0060866062030644,32,-2
user_003086,54,100k-150k,mobile,returning,South,40,True,123,4,0,True,True,True,94,3,0,8.045737766021926,29,1
user_003087,32,30k-50k,mobile,returning,Midwest,49,True,132,2,1,False,True,True,107,4,1,7.841174639006883,25,-2
user_003088,24,75k-100k,desktop,returning,South,52,True,107,1,1,True,True,True,52,1,0,8.027575378813996,55,0
user_003089,30,50k-75k,desktop,returning,South,60,True,108,3,0,True,True,True,85,3,0,7.2004478456605945,23,0
user_003090,48,100k-150k,mobile,new,West,82,True,98,1,1,False,True,True,102,1,0,10.0,-4,0
user_003091,36,100k-150k,tablet,returning,West,65,True,87,1,1,True,False,True,79,3,0,6.568661197357909,8,-2
user_003092,65,75k-100k,mobile,new,Midwest,47,True,77,4,0,True,True,True,86,1,0,8.262782301615532,-9,3
user_003093,42,50k-75k,desktop,returning,West,50,True,106,4,0,True,False,True,80,2,0,8.271603483693836,26,2
user_003094,54,50k-75k,mobile,returning,East,66,True,117,1,0,True,True,True,103,2,0,10.0,14,-1
user_003095,34,50k-75k,mobile,new,West,61,True,113,5,0,False,False,True,100,4,0,7.161936375454396,13,1
user_003096,53,100k-150k,mobile,returning,East,59,True,30,2,0,False,True,True,40,1,0,7.044852415490738,-10,1
user_003097,48,75k-100k,desktop,returning,East,50,True,94,3,0,False,True,True,65,3,0,8.16729984507565,29,0
user_003098,37,75k-100k,mobile,returning,South,57,True,119,4,0,False,False,True,158,1,0,5.665778081953971,-39,3
user_003099,23,30k-50k,desktop,returning,South,73,True,75,4,0,True,True,True,75,3,0,8.582271933765352,0,1
user_003100,39,50k-75k,mobile,returning,East,66,True,51,2,0,True,True,True,39,1,1,10.0,12,1
user_003101,49,100k-150k,mobile,returning,Midwest,100,True,67,4,0,True,True,True,56,1,0,10.0,11,3
user_003102,19,100k-150k,desktop,returning,South,96,True,108,4,0,True,True,True,59,2,0,9.934073928288841,49,2
user_003103,34,50k-75k,mobile,returning,South,78,True,118,3,0,True,True,True,70,4,0,10.0,48,-1
user_003104,49,30k-50k,mobile,returning,West,57,True,71,4,0,False,False,True,47,4,1,9.632179164044786,24,0
user_003105,40,75k-100k,mobile,new,South,52,True,102,1,0,True,True,True,81,1,0,8.828722651365108,21,0
user_003106,58,50k-75k,desktop,returning,South,30,False,0,0,0,True,True,True,107,1,0,9.708787504087885,-107,-1
user_003107,37,30k-50k,mobile,returning,East,62,True,80,5,0,True,True,True,20,4,0,7.636788031286579,60,1
user_003108,26,75k-100k,mobile,returning,Midwest,56,True,152,4,0,False,False,True,124,2,0,5.619524945950164,28,2
user_003109,55,50k-75k,desktop,new,East,64,True,142,4,0,False,False,False,0,0,0,,142,4
user_003110,57,<30k,tablet,returning,East,21,False,0,0,0,True,True,True,93,1,0,7.7439560971179775,-93,-1
user_003111,70,30k-50k,mobile,new,South,51,True,126,4,1,False,True,True,96,1,0,6.320098004586316,30,3
user_003112,36,30k-50k,desktop,returning,East,66,True,128,3,0,True,True,True,97,1,0,8.986039363443712,31,2
user_003113,34,75k-100k,mobile,returning,South,63,True,105,1,0,True,True,True,78,2,1,8.464565514496215,27,-1
user_003114,45,100k-150k,desktop,returning,West,84,True,69,3,0,False,True,True,34,1,0,9.5661848770717,35,2
user_003115,64,30k-50k,mobile,new,Midwest,27,True,146,1,0,False,False,True,171,1,1,6.147854015705516,-25,0
user_003116,50,50k-75k,mobile,returning,East,42,True,99,5,0,True,False,True,111,5,0,7.516373287097718,-12,0
user_003117,41,100k-150k,desktop,new,East,50,True,76,3,0,False,False,True,39,3,0,7.540614744011892,37,0
user_003118,61,75k-100k,mobile,returning,Midwest,33,True,64,1,0,True,False,True,60,1,0,7.401656999788415,4,0
user_003119,30,30k-50k,desktop,returning,East,49,True,90,3,0,True,True,True,20,2,0,7.1286391296680005,70,1
user_003120,55,75k-100k,mobile,returning,Midwest,38,True,88,4,1,True,True,True,50,3,0,6.518128330194626,38,1
user_003121,50,<30k,mobile,new,East,56,False,0,0,0,True,True,False,0,0,0,,0,0
user_003122,19,75k-100k,mobile,returning,Midwest,37,True,103,6,0,True,False,True,83,10,0,6.721123933691274,20,-4
user_003123,56,100k-150k,desktop,returning,East,36,True,68,3,0,False,True,True,55,4,0,8.490758653741164,13,-1
user_003124,40,75k-100k,desktop,returning,West,70,True,96,4,0,True,False,True,57,5,0,7.587502067399377,39,-1
user_003125,45,50k-75k,desktop,returning,East,61,True,113,1,0,True,False,True,107,1,0,5.968248909777036,6,0
user_003126,42,50k-75k,mobile,new,West,71,True,77,4,0,True,True,True,88,3,0,10.0,-11,1
user_003127,57,50k-75k,desktop,returning,Midwest,22,True,121,3,1,False,False,True,132,5,0,5.961956215189482,-11,-2
user_003128,59,30k-50k,mobile,new,East,16,True,146,6,0,False,True,False,0,0,0,,146,6
user_003129,57,30k-50k,desktop,new,West,45,False,0,0,0,True,True,True,85,1,0,8.468328361434873,-85,-1
user_003130,66,100k-150k,tablet,returning,Midwest,66,False,0,0,0,True,True,True,105,1,0,8.743625680356478,-105,-1
user_003131,28,<30k,desktop,returning,East,61,True,87,3,0,True,True,True,88,1,0,8.43518873474393,-1,2
user_003132,52,50k-75k,mobile,returning,West,55,True,169,2,0,True,False,True,172,3,0,5.744004367009508,-3,-1
user_003133,65,50k-75k,mobile,returning,West,40,True,145,1,0,False,True,True,146,1,0,6.781121711035976,-1,0
user_003134,44,50k-75k,desktop,new,East,67,True,95,1,0,False,True,True,67,1,0,7.626063331233122,28,0
user_003135,34,100k-150k,mobile,new,South,90,True,60,1,1,False,True,True,44,1,0,8.307750195743186,16,0
user_003136,39,>150k,mobile,new,Midwest,58,True,120,5,0,False,True,True,94,3,0,8.570054544792049,26,2
user_003137,44,75k-100k,mobile,returning,East,38,True,122,2,1,False,False,True,129,1,0,5.644474639627774,-7,1
user_003138,35,50k-75k,desktop,returning,West,48,True,72,4,1,True,True,True,28,1,0,7.7639339327571895,44,3
user_003139,23,30k-50k,desktop,returning,Midwest,90,True,123,3,0,True,True,False,0,0,0,,123,3
user_003140,59,30k-50k,desktop,returning,East,23,True,124,2,0,True,False,True,174,3,0,6.554986835386265,-50,-1
user_003141,44,<30k,desktop,returning,West,61,True,73,2,0,True,True,True,49,1,0,8.242461167036474,24,1
user_003142,72,30k-50k,desktop,returning,West,32,False,0,0,0,False,True,True,85,1,0,7.48790120369049,-85,-1
user_003143,36,<30k,mobile,new,Midwest,37,True,96,5,1,False,True,True,69,4,0,9.404663211323859,27,1
user_003144,32,>150k,mobile,returning,South,100,True,87,4,0,True,True,True,88,1,0,9.836243293190458,-1,3
user_003145,69,<30k,desktop,returning,South,6,True,124,4,0,True,False,True,109,4,0,8.205940895231732,15,0
user_003146,66,<30k,mobile,new,West,38,False,0,0,0,True,False,False,0,0,0,,0,0
user_003147,23,75k-100k,desktop,returning,East,54,True,72,2,0,False,False,True,102,1,0,7.853697252488898,-30,1
user_003148,47,75k-100k,mobile,new,Midwest,53,True,174,10,0,True,True,True,168,5,0,9.875817507086348,6,5
user_003149,37,75k-100k,desktop,returning,Midwest,54,True,105,1,0,True,True,True,99,1,0,10.0,6,0
user_003150,26,30k-50k,mobile,returning,South,42,True,52,8,0,False,True,True,58,5,0,8.003609225496946,-6,3
user_003151,75,100k-150k,desktop,returning,South,43,True,147,4,0,False,True,True,95,2,0,6.336636752839961,52,2
user_003152,38,<30k,mobile,returning,East,52,True,141,2,0,False,False,True,130,1,0,6.718980895446779,11,1
user_003153,51,>150k,desktop,returning,Midwest,75,True,73,2,0,True,False,True,53,1,0,6.060793559530437,20,1
user_003154,30,50k-75k,desktop,returning,Midwest,61,False,0,0,0,True,True,True,113,1,0,8.871246015515776,-113,-1
user_003155,60,30k-50k,tablet,returning,East,34,True,101,2,0,True,True,True,91,1,0,8.42906255985526,10,1
user_003156,53,75k-100k,desktop,returning,West,74,True,30,3,0,True,True,True,29,1,0,8.426408801800433,1,2
user_003157,44,100k-150k,desktop,new,East,68,True,134,1,1,True,False,False,0,0,0,,134,1
user_003158,51,100k-150k,mobile,new,East,58,True,101,5,0,True,True,True,57,1,0,6.808201986225554,44,4
user_003159,67,<30k,mobile,new,Midwest,38,True,102,1,0,False,False,True,133,1,0,9.370704329015835,-31,0
user_003160,44,50k-75k,mobile,returning,South,27,True,123,3,0,False,False,True,100,2,0,6.398255303244469,23,1
user_003161,34,30k-50k,mobile,returning,East,54,True,105,2,0,True,True,True,93,1,1,9.095325555349545,12,1
user_003162,23,>150k,desktop,returning,East,100,True,100,3,0,False,True,True,97,1,0,10.0,3,2
user_003163,42,<30k,mobile,returning,East,42,True,87,2,0,True,True,True,70,3,0,6.536000529030149,17,-1
user_003164,34,50k-75k,mobile,returning,West,56,True,57,2,0,False,True,True,58,1,0,7.848191002459702,-1,1
user_003165,18,50k-75k,desktop,new,East,71,False,0,0,0,True,True,True,110,1,0,10.0,-110,-1
user_003166,30,100k-150k,desktop,new,South,100,False,0,0,0,True,True,True,86,1,0,7.054372769884532,-86,-1
user_003167,39,30k-50k,desktop,returning,Midwest,56,True,70,3,0,False,True,True,61,1,0,8.36564326815303,9,2
user_003168,40,50k-75k,desktop,returning,South,67,True,75,1,0,True,False,True,55,1,0,7.9604783971033815,20,0
user_003169,55,50k-75k,desktop,returning,East,8,True,118,1,0,False,False,True,124,1,0,8.088646556291847,-6,0
user_003170,42,<30k,desktop,new,East,60,True,76,3,0,False,True,True,54,5,0,6.629962263169927,22,-2
user_003171,32,100k-150k,mobile,returning,West,100,True,57,3,0,True,True,True,33,1,0,9.591074026256003,24,2
user_003172,18,>150k,desktop,returning,East,63,True,73,1,1,True,True,True,110,1,0,8.611835561536198,-37,0
user_003173,32,30k-50k,desktop,returning,West,69,True,71,4,1,False,True,True,53,3,0,6.476821386137797,18,1
user_003174,30,100k-150k,desktop,returning,South,71,True,30,1,0,True,True,True,20,1,0,9.617954315106102,10,0
user_003175,60,50k-75k,desktop,returning,Midwest,16,True,165,4,0,False,False,True,161,2,0,6.195270599121864,4,2
user_003176,49,50k-75k,mobile,returning,South,62,True,40,2,0,True,True,True,47,3,0,9.99232923180644,-7,-1
user_003177,25,50k-75k,mobile,returning,South,54,True,78,5,1,True,True,True,54,3,0,5.853444080392273,24,2
user_003178,31,100k-150k,desktop,returning,West,99,False,0,0,0,True,True,True,96,2,0,10.0,-96,-2
user_003179,49,100k-150k,tablet,returning,East,67,True,107,3,0,True,True,True,104,1,0,6.933972684055346,3,2
user_003180,33,100k-150k,mobile,new,South,86,True,92,5,0,True,True,True,35,2,0,6.731509472402798,57,3
user_003181,21,50k-75k,desktop,new,South,79,True,70,1,0,True,True,True,46,1,0,7.914197442532505,24,0
user_003182,58,75k-100k,desktop,returning,East,59,True,85,4,0,True,True,True,61,6,0,8.580259965609889,24,-2
user_003183,25,50k-75k,desktop,new,East,72,False,0,0,0,True,True,False,0,0,0,,0,0
user_003184,76,100k-150k,desktop,returning,South,18,False,0,0,0,False,False,True,115,1,0,6.098904903333118,-115,-1
user_003185,18,<30k,mobile,new,Midwest,51,True,142,1,1,False,True,True,130,1,0,7.542189207220145,12,0
user_003186,45,50k-75k,mobile,returning,West,76,True,35,5,2,False,False,True,20,5,1,6.627448134784705,15,0
user_003187,46,75k-100k,mobile,returning,East,65,False,0,0,0,True,True,True,65,1,0,9.238760988945593,-65,-1
user_003188,26,>150k,desktop,new,East,65,True,101,4,0,False,True,True,76,9,0,10.0,25,-5
user_003189,36,75k-100k,desktop,new,South,54,True,110,1,0,False,True,True,97,3,0,6.0433471933189375,13,-2
user_003190,41,50k-75k,mobile,new,Midwest,55,True,158,4,0,False,False,True,179,3,0,9.036206046194923,-21,1
user_003191,38,50k-75k,desktop,returning,Midwest,19,True,149,4,0,True,False,True,116,4,0,8.951287624454784,33,0
user_003192,45,50k-75k,tablet,new,West,76,True,145,3,0,True,True,True,81,3,0,5.121106249796898,64,0
user_003193,42,75k-100k,desktop,new,Midwest,51,False,0,0,0,False,False,True,149,1,0,8.328002191063753,-149,-1
user_003194,45,100k-150k,mobile,new,Midwest,84,True,99,1,0,True,True,True,78,1,1,8.778720369162933,21,0
user_003195,41,100k-150k,mobile,returning,West,88,True,94,5,1,True,True,True,73,4,0,8.174845212910338,21,1
user_003196,32,100k-150k,desktop,new,South,67,True,159,2,0,False,True,True,118,2,0,7.99179609363865,41,0
user_003197,40,100k-150k,mobile,new,East,68,True,61,1,0,True,True,True,20,1,0,8.542410079293985,41,0
user_003198,54,50k-75k,desktop,returning,South,62,True,126,5,0,False,False,True,113,3,0,7.643751307245749,13,2
user_003199,80,50k-75k,mobile,returning,South,28,True,123,7,0,True,True,False,0,0,0,,123,7
user_003200,47,75k-100k,desktop,returning,West,64,True,85,3,0,False,True,True,85,1,0,9.16386520953356,0,2
user_003201,37,30k-50k,mobile,returning,South,43,True,56,4,0,True,True,True,39,2,0,9.110398089144375,17,2
user_003202,65,<30k,mobile,returning,Midwest,32,False,0,0,0,True,True,True,101,1,0,8.48172097767611,-101,-1
user_003203,48,<30k,mobile,returning,West,40,True,93,4,0,True,True,True,83,1,1,6.466000033243398,10,3
user_003204,31,100k-150k,desktop,returning,Midwest,93,True,101,2,0,False,True,True,101,4,0,9.051703417293272,0,-2
user_003205,52,>150k,mobile,new,East,83,True,72,2,0,False,False,True,31,2,0,8.931307910430464,41,0
user_003206,28,50k-75k,tablet,returning,South,46,True,89,2,1,False,False,True,115,2,0,6.354349817701431,-26,0
user_003207,41,100k-150k,mobile,returning,East,73,False,0,0,0,True,True,True,85,1,0,8.449144127541652,-85,-1
user_003208,50,75k-100k,desktop,returning,East,46,True,62,4,1,True,True,True,31,3,0,4.909503495936732,31,1
user_003209,30,30k-50k,mobile,new,South,51,True,83,1,0,True,True,True,53,2,0,6.294444292406988,30,-1
user_003210,47,100k-150k,desktop,new,South,79,True,116,3,0,True,True,True,106,8,0,10.0,10,-5
user_003211,27,75k-100k,desktop,returning,West,77,True,58,1,0,False,True,True,25,1,0,8.352795548556063,33,0
user_003212,43,100k-150k,mobile,returning,East,88,True,30,1,0,True,True,True,26,2,0,9.461088755811476,4,-1
user_003213,27,75k-100k,mobile,new,Midwest,90,True,116,2,1,True,True,True,92,1,0,8.11635323307544,24,1
user_003214,67,100k-150k,mobile,new,East,65,True,137,2,0,False,True,True,126,2,0,7.588415593309778,11,0
user_003215,22,<30k,desktop,new,Midwest,56,True,94,5,0,False,False,True,99,6,0,7.352379551636918,-5,-1
user_003216,57,100k-150k,desktop,returning,Midwest,28,True,167,3,0,True,True,True,116,2,0,7.943069545290054,51,1
user_003217,32,30k-50k,desktop,new,West,70,True,57,5,0,True,True,True,68,3,0,7.706039697147014,-11,2
user_003218,54,50k-75k,mobile,returning,West,85,True,88,1,0,False,False,True,117,2,0,6.557889759755548,-29,-1
user_003219,66,>150k,tablet,returning,South,35,True,105,2,0,True,True,True,72,1,0,6.692072715069967,33,1
user_003220,23,>150k,mobile,returning,West,100,True,44,2,0,True,True,True,42,4,0,7.557658653323903,2,-2
user_003221,38,50k-75k,desktop,returning,Midwest,58,True,91,1,0,True,False,True,61,1,1,8.091537063087205,30,0
user_003222,67,50k-75k,desktop,new,East,62,True,112,2,0,True,True,True,101,2,1,10.0,11,0
user_003223,39,75k-100k,mobile,new,Midwest,36,True,109,4,0,False,False,True,108,2,1,5.561375312056129,1,2
user_003224,56,<30k,mobile,new,West,16,True,168,7,0,False,False,True,150,13,0,7.433480045554796,18,-6
user_003225,52,<30k,mobile,returning,South,31,True,115,2,0,False,False,True,112,2,0,8.887534155580177,3,0
user_003226,75,30k-50k,mobile,returning,South,23,True,145,1,1,True,False,True,134,1,0,6.092126635239257,11,0
user_003227,78,75k-100k,mobile,new,East,29,True,189,1,0,True,True,True,128,1,0,8.478185844140569,61,0
user_003228,49,75k-100k,mobile,returning,Midwest,76,True,82,4,0,False,True,True,101,1,0,8.862947560573591,-19,3
user_003229,35,30k-50k,desktop,returning,West,63,True,132,4,0,False,False,True,142,9,0,5.830793270756154,-10,-5
user_003230,57,<30k,mobile,returning,South,0,True,122,4,0,False,False,False,0,0,0,,122,4
user_003231,49,50k-75k,mobile,returning,South,49,True,33,4,0,False,False,True,43,1,0,9.468632027070887,-10,3
user_003232,74,30k-50k,desktop,new,Midwest,17,False,0,0,0,False,False,False,0,0,0,,0,0
user_003233,48,75k-100k,mobile,returning,Midwest,28,True,178,3,1,False,False,True,187,3,0,6.004320222260681,-9,0
user_003234,51,75k-100k,desktop,returning,South,47,True,103,3,0,True,True,True,83,4,0,8.589199491920898,20,-1
user_003235,71,75k-100k,desktop,new,East,43,True,117,2,0,False,True,True,83,1,0,7.502227166627854,34,1
user_003236,35,>150k,mobile,new,West,81,True,133,4,0,False,True,False,0,0,0,,133,4
user_003237,48,75k-100k,mobile,returning,West,75,True,96,3,0,False,False,True,111,3,0,9.30869681096712,-15,0
user_003238,46,100k-150k,desktop,new,West,72,True,140,2,0,True,True,True,139,3,0,9.873897732193946,1,-1
user_003239,42,50k-75k,mobile,new,South,40,True,126,3,0,True,True,True,76,1,0,5.3330519424137,50,2
user_003240,50,30k-50k,mobile,returning,West,57,True,79,4,0,True,True,True,22,4,0,6.849159156863525,57,0
user_003241,37,30k-50k,mobile,returning,Midwest,52,True,102,1,0,False,False,True,105,1,0,6.404769094407944,-3,0
user_003242,45,100k-150k,desktop,returning,West,70,True,54,4,1,False,True,True,54,2,0,5.8109395110508615,0,2
user_003243,61,100k-150k,desktop,new,West,74,True,93,2,0,True,True,True,56,1,0,10.0,37,1
user_003244,58,30k-50k,mobile,returning,Midwest,39,True,88,3,0,False,False,True,98,2,0,5.082923503014702,-10,1
user_003245,60,75k-100k,mobile,returning,South,17,True,102,5,0,True,True,True,55,4,0,7.508677587462025,47,1
user_003246,28,100k-150k,desktop,new,South,77,True,64,2,0,False,True,True,74,2,0,7.976528059664074,-10,0
user_003247,57,<30k,desktop,returning,West,44,False,0,0,0,True,False,False,0,0,0,,0,0
user_003248,32,75k-100k,mobile,returning,West,55,True,93,5,0,False,True,True,99,3,0,7.110965910816297,-6,2
user_003249,54,100k-150k,mobile,new,East,64,True,140,4,0,False,True,True,108,7,0,9.391819728882432,32,-3
user_003250,46,100k-150k,mobile,new,West,58,True,112,2,0,True,True,True,101,4,0,6.390359041936117,11,-2
user_003251,51,30k-50k,mobile,returning,East,50,True,65,6,0,True,False,True,77,11,1,5.5679008242079915,-12,-5
user_003252,68,<30k,mobile,returning,South,7,False,0,0,0,True,False,True,81,2,0,7.571826706240941,-81,-2
user_003253,24,<30k,desktop,returning,East,59,False,0,0,0,False,True,False,0,0,0,,0,0
user_003254,78,75k-100k,desktop,returning,West,62,True,88,5,0,False,False,True,62,3,0,6.616295067099151,26,2
user_003255,61,30k-50k,mobile,new,Midwest,35,True,151,2,0,True,False,True,104,2,0,9.012516120259239,47,0
user_003256,41,30k-50k,desktop,returning,East,43,True,50,3,1,True,True,True,20,4,0,8.825385950375496,30,-1
user_003257,35,>150k,mobile,new,West,87,True,59,3,1,False,True,True,56,2,0,9.39810601612585,3,1
user_003258,65,30k-50k,mobile,returning,East,35,True,137,3,0,False,True,True,128,3,0,10.0,9,0
user_003259,60,100k-150k,desktop,new,South,47,False,0,0,0,False,False,True,104,1,0,9.241836825402334,-104,-1
user_003260,35,>150k,desktop,returning,South,52,True,48,5,0,False,False,True,55,7,0,6.533439622429619,-7,-2
user_003261,49,75k-100k,mobile,new,East,48,True,174,5,0,False,False,True,132,7,0,5.519929471047087,42,-2
user_003262,58,75k-100k,desktop,returning,South,30,True,30,6,0,False,False,True,21,6,0,7.433569096866353,9,0
user_003263,77,50k-75k,mobile,new,Midwest,30,True,103,6,0,False,False,True,89,7,0,5.966894794298787,14,-1
user_003264,52,75k-100k,mobile,new,East,32,True,98,8,0,False,True,True,54,6,0,8.863317878869543,44,2
user_003265,48,50k-75k,desktop,new,Midwest,63,True,81,3,0,True,True,True,70,4,0,7.039145039834592,11,-1
user_003266,35,30k-50k,desktop,returning,West,53,True,119,5,0,False,True,True,72,2,0,6.589038303951571,47,3
user_003267,18,75k-100k,mobile,new,South,74,True,91,3,0,True,True,True,77,3,0,8.515238885223019,14,0
user_003268,67,30k-50k,mobile,returning,East,38,False,0,0,0,False,False,False,0,0,0,,0,0
user_003269,75,75k-100k,mobile,returning,South,42,True,47,1,0,False,False,True,60,3,0,7.886420012187896,-13,-2
user_003270,52,30k-50k,desktop,returning,South,34,True,64,3,0,False,True,True,31,3,0,8.832376894270338,33,0
user_003271,22,<30k,desktop,returning,East,61,False,0,0,0,True,True,False,0,0,0,,0,0
user_003272,40,75k-100k,mobile,returning,South,49,False,0,0,0,False,False,True,127,1,0,5.93874136513354,-127,-1
user_003273,71,75k-100k,mobile,returning,Midwest,33,True,122,4,0,True,False,True,117,4,0,8.483394182478389,5,0
user_003274,51,<30k,desktop,new,South,45,True,161,1,0,True,True,True,137,1,0,5.480446249435775,24,0
user_003275,58,100k-150k,mobile,returning,East,63,False,0,0,0,False,True,True,122,1,0,6.927722524630337,-122,-1
user_003276,46,<30k,mobile,new,South,19,True,151,1,0,False,False,True,172,1,0,7.393159538187313,-21,0
user_003277,51,75k-100k,mobile,returning,Midwest,36,True,132,6,0,True,True,True,94,7,0,9.664953661308784,38,-1
user_003278,18,30k-50k,mobile,returning,East,66,True,60,1,1,True,True,False,0,0,0,,60,1
user_003279,30,30k-50k,mobile,returning,South,56,False,0,0,0,False,True,True,106,1,0,9.676423146615154,-106,-1
user_003280,18,50k-75k,mobile,returning,East,69,True,81,3,2,True,True,True,49,1,0,6.38293242111976,32,2
user_003281,50,100k-150k,mobile,returning,East,73,True,59,1,1,True,True,True,73,1,0,7.803617506438998,-14,0
user_003282,50,<30k,desktop,returning,West,36,True,111,7,0,False,False,True,100,7,0,6.517798455593295,11,0
user_003283,51,75k-100k,desktop,returning,Midwest,67,True,63,3,0,True,True,True,71,5,0,9.29811127331871,-8,-2
user_003284,37,30k-50k,desktop,new,East,74,False,0,0,0,False,False,True,111,1,0,6.1702413901948265,-111,-1
user_003285,50,<30k,mobile,returning,South,79,True,88,4,1,False,True,True,63,2,0,8.277372670022826,25,2
user_003286,24,30k-50k,mobile,new,East,66,True,170,1,0,True,True,True,167,1,0,9.567279285310587,3,0
user_003287,36,<30k,desktop,returning,South,37,True,100,3,1,False,False,True,119,3,0,7.51033443853548,-19,0
user_003288,58,75k-100k,mobile,returning,South,46,True,85,3,0,True,True,True,38,7,0,7.298039278753939,47,-4
user_003289,33,30k-50k,desktop,new,South,59,True,96,6,0,False,True,True,90,5,0,8.816029681980684,6,1
user_003290,50,100k-150k,mobile,returning,East,75,True,46,1,0,True,False,True,29,1,0,8.64218915476667,17,0
user_003291,38,75k-100k,mobile,new,South,28,True,134,4,0,False,False,True,137,4,0,8.651863438538316,-3,0
user_003292,42,75k-100k,desktop,new,West,57,True,120,2,1,True,True,True,79,4,0,10.0,41,-2
user_003293,28,50k-75k,mobile,returning,South,59,False,0,0,0,True,True,True,57,1,0,7.2182986781969225,-57,-1
user_003294,36,30k-50k,desktop,new,South,45,True,103,5,0,False,False,True,98,4,0,7.550015367648995,5,1
user_003295,58,50k-75k,desktop,returning,East,43,True,83,1,1,True,True,True,64,1,0,6.67894934742493,19,0
user_003296,21,50k-75k,desktop,returning,East,76,True,90,1,0,False,True,True,44,1,0,7.200040705849703,46,0
user_003297,39,50k-75k,mobile,new,East,65,True,147,2,1,True,False,True,138,1,0,6.763150398324357,9,1
user_003298,49,75k-100k,mobile,returning,West,45,True,93,4,0,True,False,True,94,4,0,4.777891674781265,-1,0
user_003299,38,75k-100k,mobile,returning,South,47,True,176,8,0,False,True,False,0,0,0,,176,8
user_003300,32,>150k,desktop,returning,East,87,True,68,1,0,True,True,True,38,3,0,10.0,30,-2
user_003301,66,100k-150k,desktop,new,Midwest,64,True,120,5,0,False,False,True,121,5,1,7.528287062337689,-1,0
user_003302,60,50k-75k,mobile,returning,West,76,True,51,1,0,False,True,True,50,1,0,7.891474226219065,1,0
user_003303,39,75k-100k,desktop,returning,South,47,True,63,2,0,True,True,True,64,1,0,7.142245318437953,-1,1
user_003304,31,<30k,desktop,returning,South,30,True,84,5,1,True,True,True,85,8,0,10.0,-1,-3
user_003305,35,75k-100k,desktop,new,South,60,True,142,1,0,False,True,True,103,1,0,7.286015861007427,39,0
user_003306,48,50k-75k,mobile,new,East,67,True,117,3,0,False,False,True,114,1,0,8.376737964833852,3,2
user_003307,58,75k-100k,mobile,returning,South,30,True,90,3,0,True,True,True,75,3,0,7.472707286745759,15,0
user_003308,41,100k-150k,desktop,returning,West,73,False,0,0,0,True,True,True,111,1,2,6.718803353115029,-111,-1
user_003309,46,<30k,mobile,returning,West,55,True,106,2,0,False,False,True,120,1,0,9.322798742892196,-14,1
user_003310,45,30k-50k,desktop,new,South,45,True,121,1,0,False,False,True,94,2,0,5.8778963163304505,27,-1
user_003311,40,<30k,desktop,returning,West,52,False,0,0,0,True,True,False,0,0,0,,0,0
user_003312,38,50k-75k,mobile,returning,South,30,True,129,1,0,False,True,True,71,1,2,7.360805887161564,58,0
user_003313,47,30k-50k,desktop,new,South,51,True,116,1,0,False,False,False,0,0,0,,116,1
user_003314,54,30k-50k,mobile,returning,Midwest,74,True,88,1,0,True,True,True,43,1,0,8.325916935479066,45,0
user_003315,58,50k-75k,desktop,new,East,43,False,0,0,0,False,False,True,136,1,0,8.584020715294248,-136,-1
user_003316,25,75k-100k,mobile,new,East,84,False,0,0,0,True,True,True,96,1,0,7.868455724171701,-96,-1
user_003317,59,100k-150k,desktop,new,East,50,True,127,2,0,False,False,False,0,0,0,,127,2
user_003318,41,30k-50k,desktop,new,South,55,True,80,3,0,True,True,True,74,3,0,6.3522426993708425,6,0
user_003319,61,75k-100k,desktop,returning,East,33,True,60,3,0,False,False,True,53,5,1,8.04096094012367,7,-2
user_003320,35,75k-100k,mobile,returning,West,69,True,113,2,0,True,True,True,90,1,0,9.245523404139128,23,1
user_003321,18,30k-50k,desktop,returning,East,77,True,59,1,0,True,True,True,50,1,0,8.69636575560513,9,0
user_003322,55,30k-50k,desktop,returning,East,53,True,50,3,0,True,True,True,45,6,0,5.942532609832292,5,-3
user_003323,52,75k-100k,mobile,returning,South,44,True,67,3,0,False,True,True,58,2,0,8.41202212186342,9,1
user_003324,39,50k-75k,desktop,new,Midwest,41,False,0,0,0,True,False,True,106,1,0,8.564459400765639,-106,-1
user_003325,37,<30k,mobile,returning,Midwest,8,True,102,1,1,True,False,False,0,0,0,,102,1
user_003326,33,<30k,mobile,new,Midwest,64,True,141,4,0,False,False,True,159,7,0,8.824813263439442,-18,-3
user_003327,42,50k-75k,mobile,returning,South,36,True,89,2,1,False,False,True,91,2,1,7.681133729871265,-2,0
user_003328,49,>150k,mobile,returning,East,65,True,85,5,1,True,True,True,53,3,0,6.327964611044743,32,2
user_003329,38,>150k,desktop,returning,East,91,True,90,2,0,True,True,True,99,2,0,7.306465189841925,-9,0
user_003330,54,<30k,desktop,returning,East,36,True,97,3,0,True,False,True,89,3,0,6.174570590225024,8,0
user_003331,60,>150k,desktop,returning,Midwest,80,False,0,0,0,False,True,True,127,1,0,8.289441379714281,-127,-1
user_003332,55,75k-100k,mobile,returning,West,52,True,86,3,0,True,True,True,78,4,0,7.901403183110612,8,-1
user_003333,34,100k-150k,desktop,new,South,100,True,72,2,0,False,True,True,60,1,0,7.990967549526146,12,1
user_003334,38,50k-75k,mobile,returning,South,37,True,61,5,0,True,False,True,29,9,1,5.923795296384086,32,-4
user_003335,63,<30k,mobile,new,West,64,False,0,0,0,True,False,True,109,2,0,7.291190194777385,-109,-2
user_003336,36,<30k,desktop,returning,South,32,True,105,1,0,True,True,True,40,1,0,8.17634877281449,65,0
user_003337,32,30k-50k,mobile,returning,Midwest,77,False,0,0,0,True,True,True,85,1,0,7.796318438848849,-85,-1
user_003338,32,30k-50k,mobile,returning,South,89,True,60,2,0,False,True,True,20,1,0,8.048175503838506,40,1
user_003339,18,50k-75k,desktop,returning,South,60,False,0,0,0,False,True,False,0,0,0,,0,0
user_003340,45,75k-100k,desktop,returning,Midwest,34,True,88,5,0,False,True,True,97,3,0,7.801702497564721,-9,2
user_003341,51,<30k,mobile,returning,East,44,True,146,2,0,True,True,True,82,5,0,7.240286506092328,64,-3
user_003342,62,<30k,desktop,returning,West,59,False,0,0,0,False,False,True,129,1,0,6.68270882669023,-129,-1
user_003343,29,50k-75k,desktop,returning,South,65,True,133,3,0,True,True,True,109,1,0,7.643521519203214,24,2
user_003344,31,50k-75k,mobile,returning,Midwest,63,False,0,0,0,True,True,True,93,4,0,10.0,-93,-4
user_003345,80,50k-75k,mobile,returning,South,47,True,78,4,1,True,False,True,83,3,0,7.605370390859992,-5,1
user_003346,64,100k-150k,desktop,new,East,65,True,116,4,0,False,True,True,95,5,0,9.58173781757615,21,-1
user_003347,63,100k-150k,mobile,returning,West,72,True,110,2,0,True,True,True,93,1,0,6.315654282864473,17,1
user_003348,23,<30k,mobile,new,West,73,True,112,5,0,True,True,True,105,5,0,9.28585080694811,7,0
user_003349,28,100k-150k,mobile,returning,Midwest,68,True,113,1,0,True,True,True,64,1,0,8.064924220438751,49,0
user_003350,36,30k-50k,desktop,returning,East,76,True,46,3,0,True,True,False,0,0,0,,46,3
user_003351,50,75k-100k,desktop,returning,East,43,True,72,2,0,False,True,True,44,1,0,7.475120549153414,28,1
user_003352,18,50k-75k,mobile,returning,East,67,True,112,1,0,True,True,True,83,1,0,8.846354239681855,29,0
user_003353,34,75k-100k,desktop,new,Midwest,74,True,60,2,0,False,True,True,35,4,0,8.542324801066862,25,-2
user_003354,34,50k-75k,mobile,returning,South,82,True,67,5,0,True,True,True,62,3,0,6.080072072573744,5,2
user_003355,67,75k-100k,mobile,returning,Midwest,46,True,90,1,1,False,False,True,57,1,0,6.4003495672422765,33,0
user_003356,26,50k-75k,desktop,returning,South,69,True,52,1,0,True,True,True,78,3,0,7.1076696247348625,-26,-2
user_003357,43,100k-150k,desktop,returning,South,48,True,73,1,0,True,True,True,37,1,0,8.80083603893684,36,0
user_003358,66,30k-50k,desktop,returning,South,26,True,143,2,0,True,True,True,93,1,0,9.39031685207995,50,1
user_003359,57,100k-150k,desktop,new,Midwest,49,True,144,4,0,False,False,False,0,0,0,,144,4
user_003360,39,30k-50k,mobile,returning,West,40,True,112,3,0,True,False,True,133,7,0,7.8601967189492346,-21,-4
user_003361,42,50k-75k,desktop,new,South,56,False,0,0,0,False,False,False,0,0,0,,0,0
user_003362,18,50k-75k,desktop,returning,East,54,True,127,4,1,False,True,True,96,4,0,9.058694051797008,31,0
user_003363,36,30k-50k,desktop,returning,Midwest,64,False,0,0,0,True,True,True,95,1,0,7.128889707216826,-95,-1
user_003364,38,75k-100k,mobile,returning,South,78,True,64,4,1,True,False,True,34,2,0,8.65958483189701,30,2
user_003365,37,75k-100k,desktop,returning,South,46,True,137,1,0,True,False,True,164,2,1,6.27108951217813,-27,-1
user_003366,37,50k-75k,desktop,returning,East,73,True,34,8,0,False,True,True,29,8,0,7.7239905540654314,5,0
user_003367,80,50k-75k,desktop,new,West,73,True,133,4,0,False,True,True,91,3,0,6.013064034580573,42,1
user_003368,46,75k-100k,tablet,new,Midwest,48,True,105,2,0,False,False,True,108,4,0,8.122224258531741,-3,-2
user_003369,57,50k-75k,mobile,returning,Midwest,50,True,131,3,0,False,False,True,114,2,0,6.859317847296598,17,1
user_003370,40,75k-100k,mobile,returning,West,55,True,125,4,0,True,False,True,105,4,0,6.618556425370699,20,0
user_003371,57,100k-150k,mobile,returning,West,59,True,96,4,0,True,True,True,77,4,0,6.993256074487046,19,0
user_003372,73,50k-75k,mobile,new,South,6,True,203,3,0,True,False,False,0,0,0,,203,3
user_003373,30,50k-75k,mobile,new,Midwest,79,True,71,6,0,False,True,False,0,0,0,,71,6
user_003374,56,75k-100k,desktop,returning,West,38,True,130,7,0,False,False,True,104,4,0,7.275019229364934,26,3
user_003375,24,30k-50k,mobile,returning,East,37,True,41,1,1,True,False,True,37,3,0,5.040617978818337,4,-2
user_003376,18,100k-150k,mobile,returning,Midwest,84,True,36,2,1,False,True,False,0,0,0,,36,2
user_003377,80,30k-50k,desktop,returning,South,0,True,133,2,1,True,True,True,120,2,0,5.869285708317936,13,0
user_003378,49,50k-75k,desktop,returning,East,65,True,111,3,1,False,True,True,102,3,0,8.807527347483417,9,0
user_003379,50,50k-75k,desktop,returning,East,40,True,79,1,0,True,True,True,76,1,0,8.20273409051061,3,0
user_003380,29,<30k,mobile,new,East,67,False,0,0,0,False,True,False,0,0,0,,0,0
user_003381,40,50k-75k,desktop,returning,South,54,True,96,1,0,False,True,False,0,0,0,,96,1
user_003382,43,>150k,desktop,returning,West,76,True,49,5,0,False,True,True,50,5,0,7.206396599615618,-1,0
user_003383,18,30k-50k,tablet,returning,East,51,True,84,5,0,False,True,True,40,3,0,9.833216371429764,44,2
user_003384,54,30k-50k,mobile,new,West,63,False,0,0,0,False,False,True,119,1,0,5.100158629618552,-119,-1
user_003385,44,50k-75k,mobile,new,South,47,True,110,1,0,True,True,True,77,1,0,7.224736674417081,33,0
user_003386,66,30k-50k,desktop,returning,East,47,True,86,2,2,False,False,True,86,2,0,5.43381966927865,0,0
user_003387,53,>150k,mobile,returning,East,89,True,98,1,0,False,True,True,40,1,0,7.352065118956398,58,0
user_003388,80,50k-75k,desktop,returning,West,21,False,0,0,0,False,False,True,113,2,0,7.791386630039814,-113,-2
user_003389,46,30k-50k,desktop,new,East,31,False,0,0,0,False,False,False,0,0,0,,0,0
user_003390,54,30k-50k,desktop,new,West,78,True,85,1,0,True,False,True,72,1,0,7.86476843150114,13,0
user_003391,44,30k-50k,mobile,returning,West,71,False,0,0,0,True,True,True,124,1,0,9.410035846809999,-124,-1
user_003392,23,30k-50k,desktop,returning,East,40,True,32,2,0,False,False,False,0,0,0,,32,2
user_003393,33,100k-150k,desktop,new,West,81,True,106,3,0,True,True,True,82,3,0,7.854139326718255,24,0
user_003394,23,30k-50k,desktop,new,East,83,False,0,0,0,False,True,True,90,1,0,9.51976185815309,-90,-1
user_003395,37,<30k,mobile,new,South,37,True,120,3,0,False,True,True,107,1,0,6.4293404467871085,13,2
user_003396,18,50k-75k,mobile,returning,East,66,True,58,4,0,False,True,True,27,2,0,10.0,31,2
user_003397,57,<30k,desktop,returning,South,6,False,0,0,0,False,False,True,119,1,1,8.123751583697334,-119,-1
user_003398,39,<30k,desktop,returning,South,49,False,0,0,0,True,True,False,0,0,0,,0,0
user_003399,50,50k-75k,mobile,returning,East,35,True,132,7,0,False,False,True,146,6,0,7.0643956547658915,-14,1
user_003400,36,100k-150k,desktop,returning,West,87,True,70,2,0,True,True,True,60,1,0,7.431632539447187,10,1
user_003401,63,100k-150k,desktop,returning,West,64,True,114,5,0,True,True,True,73,6,0,8.086838819081846,41,-1
user_003402,68,100k-150k,mobile,returning,West,73,True,30,2,1,True,True,True,20,2,1,6.520093435474041,10,0
user_003403,48,<30k,mobile,returning,East,34,True,115,5,0,False,False,True,101,5,0,7.053362779859559,14,0
user_003404,51,100k-150k,desktop,new,West,100,True,80,2,0,False,True,True,55,1,0,6.419168815436376,25,1
user_003405,46,75k-100k,desktop,returning,West,70,True,61,2,0,False,False,True,83,3,0,7.71804769104281,-22,-1
user_003406,32,75k-100k,desktop,returning,Midwest,90,True,81,3,1,True,True,True,57,5,0,7.376730894756969,24,-2
user_003407,50,50k-75k,mobile,returning,East,55,True,55,3,0,True,True,True,40,1,1,7.933872677562852,15,2
user_003408,28,100k-150k,desktop,returning,East,84,True,41,1,0,False,True,True,26,1,0,7.986904462803842,15,0
user_003409,51,<30k,mobile,returning,Midwest,29,True,165,1,0,False,False,True,188,1,0,7.768459747544405,-23,0
user_003410,21,30k-50k,desktop,returning,Midwest,47,True,95,5,0,False,True,True,78,8,0,8.078938293212968,17,-3
user_003411,74,100k-150k,mobile,returning,Midwest,29,True,130,3,0,False,False,True,147,5,0,7.409796963235085,-17,-2
user_003412,37,<30k,desktop,returning,West,75,True,103,4,0,True,False,True,107,9,0,6.503912891558801,-4,-5
user_003413,52,75k-100k,mobile,returning,South,27,True,72,3,0,False,False,True,74,1,0,6.7264790290156435,-2,2
user_003414,39,50k-75k,desktop,returning,East,56,True,97,3,0,False,True,True,72,1,0,7.148027118696202,25,2
user_003415,24,50k-75k,desktop,returning,South,40,True,49,4,0,True,True,True,76,4,0,7.720371646255391,-27,0
user_003416,42,50k-75k,desktop,new,West,43,True,155,2,1,False,True,True,143,1,0,7.362005202380542,12,1
user_003417,37,30k-50k,desktop,new,South,49,False,0,0,0,False,True,True,92,2,0,8.980360935049166,-92,-2
user_003418,66,50k-75k,mobile,returning,East,41,True,83,3,0,True,False,True,111,4,0,8.297603614095532,-28,-1
user_003419,32,100k-150k,desktop,returning,East,88,True,61,3,0,True,True,True,76,2,0,8.600554380338892,-15,1
user_003420,61,100k-150k,desktop,new,South,44,True,118,3,0,False,True,True,99,4,0,6.376773913139563,19,-1
user_003421,18,100k-150k,desktop,new,West,71,False,0,0,0,True,True,True,73,1,0,8.328223001289686,-73,-1
user_003422,27,30k-50k,tablet,new,West,91,False,0,0,0,True,True,True,112,1,0,10.0,-112,-1
user_003423,26,100k-150k,mobile,new,East,84,True,91,3,0,False,True,True,62,3,0,8.234548970730254,29,0
user_003424,45,50k-75k,mobile,returning,West,63,True,108,3,0,True,False,True,115,3,0,7.712061663318906,-7,0
user_003425,29,30k-50k,mobile,returning,West,67,True,105,2,0,True,True,True,78,1,0,10.0,27,1
user_003426,47,75k-100k,desktop,new,East,64,True,145,2,0,True,True,True,98,2,0,9.018639918949894,47,0
user_003427,54,>150k,mobile,returning,Midwest,100,True,54,1,0,True,False,True,52,3,0,6.766979805823249,2,-2
user_003428,68,<30k,desktop,returning,West,57,True,59,2,0,False,False,True,77,1,0,7.814897007838624,-18,1
user_003429,55,50k-75k,mobile,returning,East,44,True,95,9,0,False,False,True,85,6,0,5.758115405030222,10,3
user_003430,41,75k-100k,desktop,new,Midwest,49,True,89,2,0,False,False,True,80,2,0,8.806769294168847,9,0
user_003431,35,30k-50k,desktop,returning,Midwest,20,True,84,4,0,True,False,True,72,1,0,6.549419842931954,12,3
user_003432,48,50k-75k,desktop,returning,Midwest,43,True,52,1,0,False,False,True,74,1,0,7.91068355730323,-22,0
user_003433,36,75k-100k,tablet,returning,South,60,True,75,2,0,True,False,True,75,2,0,8.773614468966626,0,0
user_003434,63,>150k,mobile,returning,South,24,True,98,4,1,False,True,True,57,4,0,6.569316224086738,41,0
user_003435,36,50k-75k,desktop,returning,Midwest,59,False,0,0,0,False,False,True,77,1,0,8.133721411543009,-77,-1
user_003436,30,30k-50k,mobile,returning,West,100,True,81,10,0,True,True,True,51,12,0,6.695115528606925,30,-2
user_003437,46,75k-100k,mobile,returning,Midwest,48,True,79,2,0,False,False,True,73,1,1,6.526884477838186,6,1
user_003438,50,75k-100k,desktop,returning,East,58,True,125,2,0,True,True,True,105,1,0,7.701609108668267,20,1
user_003439,43,50k-75k,desktop,returning,South,49,True,69,1,1,False,True,True,31,1,0,7.79828851678003,38,0
user_003440,64,50k-75k,mobile,new,South,7,True,144,2,1,True,True,True,111,4,0,8.406348859815184,33,-2
user_003441,18,75k-100k,desktop,new,East,58,False,0,0,0,True,True,True,70,1,0,5.554165374071281,-70,-1
user_003442,62,>150k,desktop,returning,South,35,True,130,3,0,False,False,True,104,2,0,5.406346191803628,26,1
user_003443,35,30k-50k,desktop,returning,West,36,False,0,0,0,True,True,True,97,1,0,8.27658510104395,-97,-1
user_003444,63,75k-100k,mobile,returning,Midwest,40,True,95,3,0,True,False,True,94,1,0,6.57172680977808,1,2
user_003445,66,30k-50k,desktop,returning,Midwest,40,True,75,1,0,True,False,True,81,1,0,7.389834943466499,-6,0
user_003446,40,30k-50k,desktop,returning,West,66,True,115,4,0,False,True,True,112,5,0,6.863103259951138,3,-1
user_003447,43,50k-75k,desktop,returning,South,55,True,116,2,0,False,True,True,89,3,0,6.172120276307661,27,-1
user_003448,45,75k-100k,mobile,returning,East,75,True,40,4,0,True,True,True,20,3,0,8.884251412561712,20,1
user_003449,21,100k-150k,desktop,new,Midwest,46,True,68,1,0,True,True,True,42,2,0,6.2621048303902365,26,-1
user_003450,68,100k-150k,desktop,returning,Midwest,49,True,133,3,1,True,False,True,122,4,0,6.353618475504549,11,-1
user_003451,75,<30k,mobile,new,East,32,True,111,5,0,False,True,False,0,0,0,,111,5
user_003452,72,30k-50k,mobile,new,Midwest,0,False,0,0,0,True,True,False,0,0,0,,0,0
user_003453,73,50k-75k,desktop,new,South,40,True,129,1,0,True,False,True,141,1,0,6.728817933793755,-12,0
user_003454,47,30k-50k,mobile,new,South,44,True,111,2,1,True,False,True,133,1,0,5.161915375512919,-22,1
user_003455,55,50k-75k,mobile,returning,West,82,True,30,2,0,True,True,False,0,0,0,,30,2
user_003456,50,50k-75k,tablet,new,South,45,True,109,3,0,False,False,True,82,2,0,6.915741981004953,27,1
user_003457,72,100k-150k,tablet,returning,West,60,True,119,4,0,False,True,True,67,5,0,7.792481107548602,52,-1
user_003458,26,75k-100k,mobile,returning,West,92,True,85,1,0,True,True,True,91,1,0,8.651997564417249,-6,0
user_003459,45,50k-75k,desktop,new,West,48,False,0,0,0,False,False,True,101,1,0,8.245065271487254,-101,-1
user_003460,49,75k-100k,mobile,returning,West,64,True,30,3,0,True,True,True,57,1,0,7.998793413343774,-27,2
user_003461,36,>150k,desktop,returning,East,70,True,119,2,0,True,False,True,82,5,0,6.891446112937321,37,-3
user_003462,33,30k-50k,mobile,returning,Midwest,93,True,43,1,0,True,True,True,55,1,0,7.149722432567128,-12,0
user_003463,39,<30k,desktop,returning,South,37,True,118,1,0,False,False,True,119,1,0,7.150752702802811,-1,0
user_003464,45,30k-50k,mobile,new,East,55,True,124,2,0,False,True,True,99,2,0,6.5537367430128715,25,0
user_003465,52,75k-100k,desktop,returning,West,64,True,65,2,1,True,True,True,49,1,0,8.244547939586486,16,1
user_003466,52,30k-50k,mobile,returning,South,19,True,113,1,1,False,False,True,140,1,0,7.446146400955938,-27,0
user_003467,61,50k-75k,desktop,returning,East,45,True,81,3,0,False,False,True,93,4,0,7.69982438606324,-12,-1
user_003468,58,100k-150k,mobile,returning,East,47,True,38,2,0,True,False,True,47,1,0,7.036640653282528,-9,1
user_003469,50,50k-75k,mobile,new,East,54,True,131,5,0,False,False,True,186,6,0,7.491598851677382,-55,-1
user_003470,55,75k-100k,desktop,new,South,42,True,132,3,0,False,True,True,116,1,0,7.454777429761814,16,2
user_003471,36,<30k,desktop,returning,South,55,True,96,1,0,False,True,True,59,1,0,8.23739940529579,37,0
user_003472,48,50k-75k,mobile,new,West,37,True,99,6,0,False,False,True,113,5,0,8.648853478115083,-14,1
user_003473,32,100k-150k,desktop,new,West,82,False,0,0,0,False,True,True,107,1,0,8.51944819660805,-107,-1
user_003474,18,<30k,mobile,returning,Midwest,63,True,56,1,1,True,True,True,53,1,0,8.45654794030245,3,0
user_003475,33,75k-100k,desktop,new,West,73,True,73,3,0,True,True,True,30,5,0,8.904878031996953,43,-2
user_003476,26,50k-75k,mobile,returning,West,83,True,38,2,1,True,True,True,44,2,0,9.054147217215265,-6,0
user_003477,61,<30k,desktop,returning,West,58,True,103,2,0,False,True,True,97,2,0,8.544396568546983,6,0
user_003478,20,50k-75k,mobile,returning,West,65,False,0,0,0,False,False,True,101,1,0,8.179561263679455,-101,-1
user_003479,50,75k-100k,desktop,returning,South,47,True,30,1,0,False,False,True,20,3,0,6.344401202125666,10,-2
user_003480,18,100k-150k,desktop,returning,East,100,False,0,0,0,True,True,True,108,1,0,7.524492142553721,-108,-1
user_003481,18,50k-75k,mobile,returning,East,69,True,57,3,1,True,True,True,20,2,0,10.0,37,1
user_003482,35,75k-100k,desktop,new,West,54,True,44,2,1,False,False,True,31,4,0,7.926376950133576,13,-2
user_003483,52,30k-50k,mobile,returning,South,48,True,102,2,0,False,False,True,75,1,0,6.189356231060466,27,1
user_003484,41,75k-100k,desktop,returning,East,49,True,116,2,0,False,False,True,118,2,0,7.955326990942846,-2,0
user_003485,74,75k-100k,mobile,new,South,32,True,112,4,0,False,True,True,76,5,0,6.800411432035739,36,-1
user_003486,59,100k-150k,desktop,returning,East,40,True,65,4,0,False,True,True,60,4,0,7.171853399067426,5,0
user_003487,76,50k-75k,mobile,new,East,27,True,154,3,0,False,False,True,155,4,0,6.913318066361305,-1,-1
user_003488,52,50k-75k,mobile,returning,South,31,True,86,4,1,True,True,True,65,2,0,5.732545390523457,21,2
user_003489,60,50k-75k,desktop,new,South,35,True,104,1,0,False,False,True,96,3,0,7.076434290939759,8,-2
user_003490,68,30k-50k,desktop,returning,East,17,False,0,0,0,True,False,True,110,1,1,6.213565814980006,-110,-1
user_003491,34,<30k,desktop,new,West,74,False,0,0,0,False,True,True,111,1,0,9.194074699529956,-111,-1
user_003492,40,>150k,desktop,returning,South,67,True,89,5,0,False,False,True,72,4,0,10.0,17,1
user_003493,56,100k-150k,mobile,returning,Midwest,21,False,0,0,0,True,False,True,117,1,0,7.184474827238489,-117,-1
user_003494,50,50k-75k,desktop,returning,West,45,True,83,2,0,False,True,True,72,3,0,8.077607839324882,11,-1
user_003495,46,50k-75k,mobile,new,East,35,True,133,9,0,False,False,True,120,6,0,7.117529645199209,13,3
user_003496,75,75k-100k,desktop,returning,West,27,True,212,1,1,False,False,True,206,2,0,7.6250820979696625,6,-1
user_003497,49,75k-100k,desktop,returning,Midwest,36,True,78,8,0,False,True,True,68,7,0,7.456494222570373,10,1
user_003498,61,75k-100k,tablet,returning,Midwest,30,True,71,2,0,False,True,True,32,1,0,8.868973208046924,39,1
user_003499,59,>150k,desktop,returning,West,75,True,87,2,1,True,True,True,45,4,0,6.579296881043291,42,-2
user_003500,33,75k-100k,mobile,returning,East,81,True,75,1,0,False,True,True,57,1,0,10.0,18,0
user_003501,49,75k-100k,mobile,new,Midwest,33,True,139,5,0,False,False,True,119,4,0,8.188593858191709,20,1
user_003502,56,100k-150k,tablet,new,South,40,True,94,3,0,False,True,True,57,1,0,7.415019154020129,37,2
user_003503,38,75k-100k,mobile,returning,East,70,True,81,3,0,False,False,True,38,5,0,6.480297652583184,43,-2
user_003504,69,75k-100k,desktop,returning,South,21,True,136,1,2,False,False,True,101,1,1,6.752222847263512,35,0
user_003505,34,100k-150k,desktop,new,East,57,True,120,2,0,True,True,True,63,4,0,9.43654067324673,57,-2
user_003506,37,30k-50k,desktop,returning,East,52,False,0,0,0,False,True,True,103,1,0,9.879590063791,-103,-1
user_003507,49,100k-150k,desktop,returning,South,54,True,83,1,0,False,False,True,66,1,0,8.027109062381683,17,0
user_003508,59,<30k,mobile,new,Midwest,0,True,195,3,1,False,False,True,179,4,0,5.238551064202613,16,-1
user_003509,58,50k-75k,desktop,returning,West,38,True,56,2,0,False,False,True,61,3,0,7.776018611761712,-5,-1
user_003510,41,50k-75k,desktop,returning,East,22,True,144,1,0,False,False,True,164,1,0,8.612691595429025,-20,0
user_003511,47,30k-50k,mobile,new,East,48,True,121,3,0,False,False,True,116,2,0,8.035541924036,5,1
user_003512,51,50k-75k,desktop,new,West,77,True,60,5,0,True,True,True,23,1,0,5.905055086689059,37,4
user_003513,47,30k-50k,mobile,returning,South,35,True,46,5,0,True,False,True,32,8,1,9.074038092759976,14,-3
user_003514,59,75k-100k,tablet,returning,East,46,True,116,2,1,True,False,True,91,1,0,8.15166697582474,25,1
user_003515,46,75k-100k,desktop,returning,West,57,True,81,2,0,False,False,True,73,1,0,5.726662332284838,8,1
user_003516,50,30k-50k,mobile,returning,South,32,True,87,3,0,True,False,True,106,4,0,5.716500268074549,-19,-1
user_003517,32,<30k,mobile,returning,West,81,False,0,0,0,False,True,False,0,0,0,,0,0
user_003518,38,50k-75k,mobile,new,East,53,True,160,1,0,False,True,True,97,1,0,7.273671306416814,63,0
user_003519,45,30k-50k,desktop,returning,South,48,True,78,1,0,False,False,True,110,1,0,6.4416756943788345,-32,0
user_003520,40,30k-50k,desktop,new,East,71,True,79,1,0,False,False,True,65,1,0,8.527851804581706,14,0
user_003521,31,30k-50k,desktop,returning,West,69,True,70,6,0,True,True,True,61,6,0,7.745165422241503,9,0
user_003522,33,50k-75k,desktop,returning,Midwest,51,True,78,2,0,False,True,True,80,1,0,10.0,-2,1
user_003523,50,<30k,mobile,new,South,55,False,0,0,0,False,False,False,0,0,0,,0,0
user_003524,57,<30k,desktop,returning,West,42,False,0,0,0,False,False,False,0,0,0,,0,0
user_003525,55,50k-75k,mobile,returning,East,47,True,62,4,0,True,True,True,35,5,0,8.933540689883513,27,-1
user_003526,39,75k-100k,mobile,returning,Midwest,30,True,39,6,0,True,True,True,61,2,0,5.769518915029912,-22,4
user_003527,80,100k-150k,desktop,new,West,76,True,94,8,0,False,False,True,81,13,0,8.233162344220213,13,-5
user_003528,34,30k-50k,desktop,new,West,81,True,98,1,0,False,True,True,80,1,0,7.864375840954874,18,0
user_003529,66,100k-150k,mobile,returning,East,41,True,160,7,0,False,True,True,112,5,0,9.936623415347187,48,2
user_003530,53,50k-75k,desktop,returning,Midwest,65,False,0,0,0,False,False,True,119,1,0,7.045613002945896,-119,-1
user_003531,32,75k-100k,desktop,returning,East,72,True,105,3,1,True,True,False,0,0,0,,105,3
user_003532,58,50k-75k,mobile,returning,East,33,False,0,0,0,True,True,True,88,1,0,8.54165206515171,-88,-1
user_003533,18,30k-50k,mobile,returning,Midwest,32,False,0,0,0,True,True,True,128,3,0,7.281911196884034,-128,-3
user_003534,69,75k-100k,mobile,returning,West,28,True,170,4,1,False,False,True,207,5,1,7.707131676813822,-37,-1
user_003535,40,100k-150k,desktop,returning,East,59,True,129,1,0,True,True,True,133,1,0,7.642280307587283,-4,0
user_003536,76,100k-150k,desktop,returning,West,67,True,98,4,0,False,True,True,26,4,1,8.063460137377369,72,0
user_003537,37,75k-100k,desktop,returning,East,41,True,116,1,0,False,True,True,81,1,0,6.213268122023019,35,0
user_003538,57,<30k,mobile,new,East,29,True,183,8,0,False,False,True,152,16,0,7.621770475583127,31,-8
user_003539,45,100k-150k,mobile,new,West,81,True,91,4,0,False,True,True,88,5,0,7.99434255719488,3,-1
user_003540,35,30k-50k,desktop,returning,South,22,True,145,6,0,True,True,True,154,6,0,6.881571317234517,-9,0
user_003541,37,50k-75k,desktop,returning,Midwest,24,True,106,3,1,True,False,True,84,3,0,6.322333147311931,22,0
user_003542,18,>150k,desktop,returning,East,100,False,0,0,0,True,True,True,91,1,0,8.31360754200512,-91,-1
user_003543,29,75k-100k,desktop,returning,East,62,True,60,1,0,False,True,True,70,1,0,6.3512421807502,-10,0
user_003544,57,100k-150k,mobile,returning,Midwest,48,True,156,6,0,True,True,True,114,6,0,6.545790027291242,42,0
user_003545,57,30k-50k,desktop,returning,East,45,False,0,0,0,False,True,True,122,1,0,7.022589819256578,-122,-1
user_003546,41,100k-150k,mobile,returning,East,90,False,0,0,0,True,True,True,111,1,0,7.982568363192881,-111,-1
user_003547,47,50k-75k,mobile,new,West,49,True,82,3,1,False,False,True,51,4,0,9.664562816007205,31,-1
user_003548,34,100k-150k,mobile,new,East,92,True,140,2,0,False,True,True,129,1,0,6.6730718742358235,11,1
user_003549,64,30k-50k,mobile,returning,West,32,True,94,5,1,True,False,True,85,5,0,6.539402516482206,9,0
user_003550,42,75k-100k,mobile,returning,East,55,True,96,4,0,True,True,True,74,7,0,8.356253389533949,22,-3
user_003551,75,75k-100k,desktop,new,South,28,True,147,1,0,False,False,True,141,2,0,5.982334045930661,6,-1
user_003552,18,<30k,mobile,returning,East,59,True,105,1,0,False,True,True,80,2,0,8.797826589006597,25,-1
user_003553,18,75k-100k,desktop,new,Midwest,51,True,137,3,1,False,True,True,102,1,0,8.248253439808284,35,2
user_003554,36,<30k,mobile,new,South,33,True,155,1,0,True,False,False,0,0,0,,155,1
user_003555,18,<30k,mobile,returning,West,69,True,30,1,0,True,True,True,28,1,0,8.369316342408935,2,0
user_003556,65,100k-150k,mobile,returning,Midwest,40,True,91,3,0,False,True,True,95,3,1,10.0,-4,0
user_003557,55,75k-100k,mobile,returning,South,49,True,57,3,0,False,False,True,71,3,0,6.854539992344097,-14,0
user_003558,43,30k-50k,desktop,returning,East,63,True,65,2,0,True,True,True,90,1,0,10.0,-25,1
user_003559,50,<30k,desktop,new,West,36,True,134,1,0,True,False,True,125,1,0,6.337189609070793,9,0
user_003560,37,>150k,mobile,returning,West,80,True,83,3,0,True,True,True,45,5,0,8.397380583431183,38,-2
user_003561,34,30k-50k,mobile,returning,South,65,True,112,1,0,True,True,True,121,1,0,7.7657065500268665,-9,0
user_003562,53,50k-75k,desktop,new,West,48,True,105,1,0,True,True,True,82,1,0,7.587125158371114,23,0
user_003563,47,50k-75k,desktop,new,East,63,False,0,0,0,True,True,True,57,1,0,8.522597097692975,-57,-1
user_003564,38,<30k,desktop,returning,East,49,True,134,1,0,False,True,True,113,1,0,8.421469001021723,21,0
user_003565,32,50k-75k,desktop,returning,East,55,False,0,0,0,True,False,True,127,2,0,7.890039672690393,-127,-2
user_003566,32,<30k,mobile,new,South,82,True,47,1,0,False,True,True,44,1,0,8.028015917148103,3,0
user_003567,46,>150k,mobile,returning,Midwest,57,True,102,1,0,False,False,True,80,2,2,8.802125709016536,22,-1
user_003568,61,<30k,mobile,new,South,39,False,0,0,0,False,False,False,0,0,0,,0,0
user_003569,51,50k-75k,mobile,returning,East,37,True,89,1,0,True,True,True,69,1,0,10.0,20,0
user_003570,27,<30k,mobile,returning,Midwest,82,True,83,5,0,False,True,True,70,1,0,6.984985110257249,13,4
user_003571,63,50k-75k,desktop,returning,East,29,True,130,4,1,True,False,True,124,7,0,7.5721044425935,6,-3
user_003572,47,50k-75k,desktop,new,Midwest,48,True,118,2,0,False,False,True,143,3,0,5.1043028050934645,-25,-1
user_003573,56,75k-100k,mobile,returning,West,18,False,0,0,0,True,False,True,129,1,0,6.991896261908323,-129,-1
user_003574,49,50k-75k,desktop,returning,East,69,True,87,1,1,True,True,True,86,1,0,7.878268147394802,1,0
user_003575,53,30k-50k,mobile,new,Midwest,31,True,123,4,1,True,True,True,110,2,0,9.900033709307355,13,2
user_003576,32,30k-50k,desktop,new,South,67,False,0,0,0,False,True,True,95,1,0,9.065343779494206,-95,-1
user_003577,20,100k-150k,desktop,returning,South,78,True,65,2,0,True,True,True,59,1,0,7.989314053854831,6,1
user_003578,34,75k-100k,mobile,returning,South,78,True,36,2,0,True,True,True,36,3,0,8.264317348633629,0,-1
user_003579,55,50k-75k,mobile,returning,West,15,True,152,3,0,False,False,True,155,2,0,6.346347643982301,-3,1
user_003580,61,50k-75k,desktop,returning,West,53,True,40,4,0,True,False,True,20,5,0,6.950437539543076,20,-1
user_003581,70,30k-50k,desktop,new,East,44,True,113,2,0,False,False,True,127,1,0,7.691554596697967,-14,1
user_003582,34,100k-150k,tablet,returning,Midwest,77,True,115,3,0,True,True,True,77,4,0,9.445337774225111,38,-1
user_003583,45,50k-75k,desktop,returning,South,35,True,40,2,0,False,True,True,20,2,0,7.859664457299337,20,0
user_003584,71,<30k,mobile,returning,East,12,True,147,2,1,True,False,True,167,1,0,6.551958138698353,-20,1
user_003585,48,<30k,mobile,new,Midwest,51,True,93,1,0,False,True,True,83,1,0,7.6352196076717025,10,0
user_003586,31,50k-75k,mobile,returning,West,97,True,81,3,1,True,True,True,85,1,0,7.934537877608165,-4,2
user_003587,35,75k-100k,desktop,new,South,56,False,0,0,0,True,True,True,157,2,0,8.487169883151507,-157,-2
user_003588,33,<30k,mobile,new,West,91,False,0,0,0,False,True,False,0,0,0,,0,0
user_003589,46,100k-150k,mobile,returning,Midwest,75,False,0,0,0,True,False,True,135,2,0,9.452998000795517,-135,-2
user_003590,66,50k-75k,desktop,new,West,40,True,155,2,0,False,False,True,173,3,0,9.129679817334761,-18,-1
user_003591,29,<30k,desktop,returning,South,40,True,97,4,1,False,True,True,50,2,0,9.46442021644098,47,2
user_003592,55,50k-75k,mobile,returning,Midwest,53,True,80,3,0,False,True,True,83,3,0,8.763584230632114,-3,0
user_003593,49,100k-150k,mobile,returning,West,100,False,0,0,0,True,True,True,81,1,0,7.11596965226353,-81,-1
user_003594,58,100k-150k,desktop,returning,South,56,True,30,1,1,True,True,True,20,1,1,6.000275711780344,10,0
user_003595,18,<30k,mobile,returning,Midwest,68,False,0,0,0,True,True,False,0,0,0,,0,0
user_003596,45,<30k,mobile,returning,West,30,True,90,3,0,False,False,True,101,3,0,7.459249751425062,-11,0
user_003597,62,50k-75k,mobile,returning,South,28,True,68,2,0,True,False,True,96,1,0,8.192366105921467,-28,1
user_003598,21,100k-150k,mobile,new,East,100,True,114,2,0,True,True,True,78,2,0,6.648662043228876,36,0
user_003599,47,30k-50k,desktop,new,South,43,True,144,3,1,True,True,True,116,3,0,10.0,28,0
user_003600,50,<30k,mobile,new,South,47,False,0,0,0,True,True,True,91,1,0,9.82290637639054,-91,-1
user_003601,51,50k-75k,tablet,returning,East,51,True,74,5,0,False,False,True,95,3,0,6.647261281366209,-21,2
user_003602,28,>150k,mobile,returning,East,78,True,75,1,1,True,True,True,84,1,1,9.573513016178765,-9,0
user_003603,19,30k-50k,desktop,returning,West,60,True,78,3,0,False,False,True,62,3,0,7.258754316568682,16,0
user_003604,64,>150k,desktop,returning,South,26,True,109,7,0,False,True,True,102,6,0,5.349297964866475,7,1
user_003605,52,>150k,mobile,returning,East,40,True,154,4,0,False,True,True,89,5,0,6.382192800442005,65,-1
user_003606,36,>150k,desktop,returning,South,37,True,113,6,0,True,True,True,71,3,0,7.203424456068791,42,3
user_003607,39,75k-100k,desktop,new,South,68,True,93,2,0,False,False,True,86,3,0,6.479223462499193,7,-1
user_003608,40,75k-100k,mobile,returning,South,55,True,30,2,0,True,False,False,0,0,0,,30,2
user_003609,80,50k-75k,desktop,new,West,47,True,151,3,0,False,True,True,107,3,0,6.2150177778168505,44,0
user_003610,18,<30k,mobile,new,East,65,True,147,3,0,True,True,False,0,0,0,,147,3
user_003611,46,30k-50k,desktop,new,East,57,False,0,0,0,False,True,True,101,1,0,7.717280662078835,-101,-1
user_003612,32,75k-100k,mobile,new,Midwest,69,True,107,1,0,False,True,True,64,1,0,8.44191438647501,43,0
user_003613,65,50k-75k,desktop,new,East,32,True,109,7,0,True,True,True,61,2,0,8.071674073311433,48,5
user_003614,65,100k-150k,desktop,returning,West,43,True,91,2,0,False,False,True,93,1,0,7.336553987685882,-2,1
user_003615,27,75k-100k,tablet,returning,Midwest,66,True,111,4,0,True,False,True,111,1,0,8.54826454040464,0,3
user_003616,45,50k-75k,desktop,returning,East,55,True,99,5,0,False,False,True,99,2,0,5.9461976662782625,0,3
user_003617,44,30k-50k,mobile,new,East,44,False,0,0,0,True,True,False,0,0,0,,0,0
user_003618,18,>150k,desktop,returning,West,91,True,35,3,1,True,True,True,20,6,0,7.310134479655525,15,-3
user_003619,64,100k-150k,mobile,returning,Midwest,45,True,114,2,0,False,True,True,87,1,0,8.592438197715408,27,1
user_003620,39,30k-50k,mobile,returning,East,48,True,77,1,0,False,True,True,75,1,0,7.535013314869492,2,0
user_003621,21,75k-100k,tablet,returning,South,66,True,113,4,0,True,True,True,112,2,0,6.821931685251736,1,2
user_003622,18,<30k,desktop,returning,South,60,False,0,0,0,False,True,True,111,1,0,6.587486151788989,-111,-1
user_003623,19,30k-50k,desktop,returning,West,94,True,69,6,0,True,True,True,50,5,0,10.0,19,1
user_003624,46,30k-50k,mobile,new,East,46,True,68,1,0,True,True,True,50,1,0,7.008476752045978,18,0
user_003625,43,50k-75k,mobile,returning,South,74,True,75,7,0,False,True,False,0,0,0,,75,7
user_003626,38,75k-100k,desktop,returning,West,71,True,57,4,0,True,True,True,29,7,0,8.753995586653595,28,-3
user_003627,47,100k-150k,mobile,returning,South,59,True,109,2,0,True,True,True,91,1,0,5.944195493225386,18,1
user_003628,34,50k-75k,desktop,returning,South,75,True,30,3,0,True,True,True,22,2,0,8.325940135603917,8,1
user_003629,52,30k-50k,mobile,returning,West,55,True,116,2,0,False,False,False,0,0,0,,116,2
user_003630,27,30k-50k,desktop,returning,West,53,True,79,1,0,False,True,False,0,0,0,,79,1
user_003631,55,100k-150k,mobile,returning,South,69,True,96,3,0,True,True,True,92,3,0,8.454233990382715,4,0
user_003632,18,>150k,desktop,returning,South,81,True,30,1,0,False,True,True,24,1,0,6.310937907617875,6,0
user_003633,47,30k-50k,mobile,new,West,70,True,60,1,0,True,True,True,30,1,0,7.293795557623618,30,0
user_003634,42,100k-150k,mobile,returning,East,63,True,101,2,0,False,True,True,81,2,0,7.442664383712239,20,0
user_003635,56,30k-50k,mobile,new,East,18,True,149,7,1,True,False,True,129,6,0,5.47867351622048,20,1
user_003636,36,100k-150k,mobile,returning,East,49,True,78,3,0,False,False,True,79,4,1,8.392411788696979,-1,-1
user_003637,30,75k-100k,mobile,returning,West,99,True,30,5,0,True,True,True,20,4,0,10.0,10,1
user_003638,52,50k-75k,desktop,returning,West,71,True,77,3,0,True,True,True,48,5,0,6.9267285070044196,29,-2
user_003639,46,30k-50k,tablet,returning,East,31,True,111,3,0,True,True,True,73,4,1,9.49651773318425,38,-1
user_003640,52,30k-50k,mobile,returning,Midwest,37,True,103,3,0,True,False,True,118,2,0,7.2073176959256635,-15,1
user_003641,31,30k-50k,mobile,returning,Midwest,41,True,117,3,0,False,True,True,63,5,2,9.96040979957518,54,-2
user_003642,28,30k-50k,desktop,new,Midwest,68,True,94,2,0,False,True,True,75,2,0,9.21174636747028,19,0
user_003643,69,30k-50k,mobile,returning,East,35,True,61,1,0,False,False,False,0,0,0,,61,1
user_003644,59,30k-50k,desktop,new,East,44,True,85,4,0,False,False,True,72,6,0,8.634325201830437,13,-2
user_003645,55,50k-75k,desktop,returning,South,61,True,140,6,1,False,True,False,0,0,0,,140,6
user_003646,35,75k-100k,tablet,returning,West,59,False,0,0,0,False,True,True,61,1,0,8.574951815256442,-61,-1
user_003647,40,30k-50k,desktop,new,Midwest,63,False,0,0,0,True,False,True,135,2,0,7.182493757093333,-135,-2
user_003648,27,100k-150k,mobile,returning,South,64,True,90,2,0,False,True,True,85,2,0,9.352294986347374,5,0
user_003649,29,30k-50k,desktop,returning,East,74,True,130,2,0,False,True,True,74,1,0,6.944342158919653,56,1
user_003650,37,50k-75k,tablet,new,South,36,False,0,0,0,False,False,True,72,1,0,6.7429822806585396,-72,-1
user_003651,34,<30k,desktop,returning,West,84,True,53,2,0,True,True,True,21,1,0,9.100109636754055,32,1
user_003652,60,<30k,mobile,new,East,19,False,0,0,0,True,True,True,70,1,0,7.308532047878384,-70,-1
user_003653,63,75k-100k,mobile,returning,Midwest,16,True,131,2,0,False,False,True,125,1,0,6.780473891265307,6,1
user_003654,59,75k-100k,desktop,returning,Midwest,25,True,129,5,0,True,True,True,89,5,0,8.02147943523605,40,0
user_003655,20,30k-50k,desktop,new,West,100,True,138,1,0,False,True,True,96,1,0,8.988351660298408,42,0
user_003656,37,100k-150k,mobile,returning,East,45,False,0,0,0,True,True,True,96,2,0,6.323810026342286,-96,-2
user_003657,51,75k-100k,desktop,returning,South,47,True,100,1,0,True,False,True,114,2,0,7.262589310426769,-14,-1
user_003658,74,<30k,mobile,new,West,75,True,91,2,0,False,True,True,35,1,0,6.851250087434324,56,1
user_003659,39,50k-75k,desktop,returning,South,33,True,108,4,0,True,True,True,88,3,1,6.168047361984607,20,1
user_003660,56,30k-50k,mobile,returning,Midwest,15,True,184,5,0,False,False,True,162,8,1,7.445270484481921,22,-3
user_003661,18,75k-100k,mobile,returning,South,69,True,75,3,0,True,True,True,85,1,0,7.158517130116846,-10,2
user_003662,41,30k-50k,mobile,new,South,37,True,129,4,0,False,False,True,133,1,0,6.559957367779674,-4,3
user_003663,18,<30k,desktop,new,East,82,True,89,4,0,True,True,True,113,3,0,10.0,-24,1
user_003664,40,30k-50k,mobile,returning,South,43,False,0,0,0,True,True,True,56,1,0,7.181711476686905,-56,-1
user_003665,53,<30k,desktop,returning,South,39,True,164,2,0,False,False,True,177,2,0,7.254735065034962,-13,0
user_003666,62,100k-150k,desktop,returning,East,100,True,96,3,0,True,True,True,100,3,0,7.619912255806446,-4,0
user_003667,24,75k-100k,mobile,returning,East,79,True,38,6,0,True,True,True,46,4,1,9.909219503847337,-8,2
user_003668,28,50k-75k,mobile,returning,East,79,True,80,5,0,False,False,True,82,4,0,6.612640812297716,-2,1
user_003669,57,>150k,desktop,new,Midwest,36,True,83,4,0,False,False,True,63,2,0,7.945803060392135,20,2
user_003670,41,30k-50k,tablet,returning,South,36,True,56,6,0,False,True,True,52,5,0,9.454794561904682,4,1
user_003671,55,75k-100k,desktop,new,East,28,True,125,9,2,False,False,True,116,12,1,6.155886623090571,9,-3
user_003672,18,30k-50k,mobile,new,East,52,True,36,2,0,False,True,True,56,4,0,7.3364189179118195,-20,-2
user_003673,44,30k-50k,desktop,returning,East,55,False,0,0,0,False,True,True,102,1,0,8.147307372934511,-102,-1
user_003674,64,75k-100k,desktop,new,West,42,True,109,5,0,False,False,True,97,5,0,5.4135791495524215,12,0
user_003675,53,<30k,desktop,returning,West,40,True,76,1,0,False,False,True,75,2,0,7.497606483629173,1,-1
user_003676,49,30k-50k,mobile,returning,East,64,True,61,4,0,False,True,True,33,5,0,9.961895880229235,28,-1
user_003677,41,50k-75k,desktop,returning,West,43,True,121,2,0,False,False,True,135,1,1,8.1093905696055,-14,1
user_003678,53,<30k,desktop,new,West,49,False,0,0,0,False,False,True,127,1,0,7.307039628221438,-127,-1
user_003679,23,50k-75k,mobile,returning,East,46,True,76,2,0,False,False,True,110,2,0,8.469758262605396,-34,0
user_003680,37,30k-50k,desktop,returning,East,36,True,133,3,0,True,False,True,137,6,0,5.696691892838711,-4,-3
user_003681,34,50k-75k,mobile,new,South,66,True,79,1,1,True,True,True,73,2,1,6.628685370628548,6,-1
user_003682,64,75k-100k,mobile,returning,Midwest,42,True,117,7,0,False,False,True,111,6,0,5.412036261819338,6,1
user_003683,45,<30k,desktop,new,East,50,True,158,2,0,False,True,True,96,1,0,5.992648151209394,62,1
user_003684,34,>150k,mobile,returning,West,98,True,98,1,0,True,True,False,0,0,0,,98,1
user_003685,43,30k-50k,mobile,returning,West,53,False,0,0,0,True,True,True,90,2,0,9.225847821068056,-90,-2
user_003686,61,>150k,mobile,new,South,30,True,90,5,0,False,False,True,99,5,0,7.161069030442266,-9,0
user_003687,56,30k-50k,desktop,new,East,46,False,0,0,0,False,True,True,75,1,0,8.392221152947224,-75,-1
user_003688,67,50k-75k,desktop,new,West,66,True,112,1,0,True,True,True,75,2,0,7.459768258556466,37,-1
user_003689,48,<30k,desktop,returning,Midwest,55,False,0,0,0,False,False,True,133,1,0,8.808747608168456,-133,-1
user_003690,52,<30k,desktop,returning,West,49,False,0,0,0,True,True,True,97,1,0,8.353749915606022,-97,-1
user_003691,46,30k-50k,mobile,new,Midwest,53,True,77,4,0,False,True,True,105,5,0,8.599584129950044,-28,-1
user_003692,51,30k-50k,desktop,returning,Midwest,29,True,117,2,1,False,False,True,125,1,0,7.311529188420862,-8,1
user_003693,49,50k-75k,mobile,returning,South,43,True,72,2,0,False,False,True,77,1,0,6.955507692580076,-5,1
user_003694,73,<30k,desktop,new,East,46,False,0,0,0,True,True,True,71,1,0,9.313024966760825,-71,-1
user_003695,22,75k-100k,desktop,returning,South,61,False,0,0,0,True,True,False,0,0,0,,0,0
user_003696,22,30k-50k,mobile,returning,West,87,False,0,0,0,True,True,True,107,1,0,9.286457099517726,-107,-1
user_003697,31,30k-50k,desktop,returning,East,72,True,79,2,0,False,True,True,54,2,0,9.574584145853056,25,0
user_003698,32,100k-150k,mobile,returning,South,81,True,97,4,0,False,True,True,94,3,0,9.01227555142714,3,1
user_003699,77,100k-150k,desktop,returning,Midwest,83,True,30,4,0,True,True,True,20,1,0,8.708055654761397,10,3
user_003700,60,50k-75k,desktop,returning,South,34,True,66,5,0,False,False,True,41,4,0,7.848681404107649,25,1
user_003701,32,100k-150k,desktop,new,Midwest,78,True,116,1,0,False,False,True,133,1,0,10.0,-17,0
user_003702,51,50k-75k,tablet,new,Midwest,59,True,179,4,0,True,False,True,165,3,0,6.151186730611561,14,1
user_003703,43,50k-75k,desktop,returning,West,67,True,97,2,0,True,True,True,58,1,0,6.5211403656148175,39,1
user_003704,38,75k-100k,desktop,new,South,50,True,116,2,0,False,False,True,97,3,0,7.90057008589882,19,-1
user_003705,47,>150k,desktop,returning,Midwest,45,True,55,3,0,False,False,True,54,1,0,7.60109966571078,1,2
user_003706,30,<30k,desktop,returning,South,67,True,91,5,1,False,False,True,86,5,0,6.57494252068883,5,0
user_003707,56,100k-150k,desktop,returning,West,53,True,71,2,0,False,False,True,36,3,0,8.262939823743244,35,-1
user_003708,38,50k-75k,mobile,returning,Midwest,25,False,0,0,0,True,True,False,0,0,0,,0,0
user_003709,33,30k-50k,mobile,returning,South,81,True,81,3,0,True,True,True,20,3,1,9.17240104946557,61,0
user_003710,23,>150k,desktop,returning,East,77,True,30,4,1,True,False,True,20,2,0,6.792554090973691,10,2
user_003711,65,50k-75k,desktop,returning,South,16,True,147,3,1,True,False,True,179,5,1,6.315701233963893,-32,-2
user_003712,52,50k-75k,tablet,returning,South,61,True,47,1,0,True,True,True,44,1,0,10.0,3,0
user_003713,18,75k-100k,mobile,returning,West,90,True,30,3,1,True,True,True,38,6,0,8.267781034394341,-8,-3
user_003714,45,50k-75k,desktop,returning,East,52,True,98,2,0,True,True,True,81,2,0,6.534316277506657,17,0
user_003715,27,30k-50k,mobile,returning,West,79,True,55,5,0,True,True,True,44,4,0,7.1899870243758475,11,1
user_003716,34,50k-75k,desktop,returning,West,59,True,72,3,0,False,False,True,54,4,1,8.859533456914301,18,-1
user_003717,22,<30k,desktop,returning,West,43,False,0,0,0,False,False,False,0,0,0,,0,0
user_003718,37,30k-50k,desktop,new,East,56,True,154,1,0,False,False,False,0,0,0,,154,1
user_003719,27,75k-100k,desktop,new,Midwest,100,True,67,2,0,True,True,True,53,1,1,7.620520506134476,14,1
user_003720,22,75k-100k,desktop,returning,Midwest,67,True,111,1,0,True,True,True,69,1,0,8.167323322464307,42,0
user_003721,43,<30k,desktop,returning,East,71,False,0,0,0,False,True,True,100,1,0,8.224154652351544,-100,-1
user_003722,32,50k-75k,mobile,returning,East,74,False,0,0,0,True,False,True,115,1,0,7.45185399448894,-115,-1
user_003723,40,<30k,desktop,returning,East,23,False,0,0,0,True,False,True,67,1,0,7.737412925360628,-67,-1
user_003724,27,75k-100k,desktop,returning,West,91,False,0,0,0,True,True,True,73,1,0,6.249525916583173,-73,-1
user_003725,68,30k-50k,mobile,returning,Midwest,45,True,79,5,0,True,False,False,0,0,0,,79,5
user_003726,34,30k-50k,mobile,returning,Midwest,78,True,84,2,0,False,True,True,80,4,0,7.766824434408906,4,-2
user_003727,56,75k-100k,mobile,returning,East,61,True,129,4,0,False,False,True,125,4,0,6.025021472567221,4,0
user_003728,30,30k-50k,mobile,returning,West,92,True,87,3,0,True,True,True,53,1,0,8.675940905719616,34,2
user_003729,37,50k-75k,desktop,returning,Midwest,53,True,121,5,0,False,True,True,123,4,0,5.497836189261559,-2,1
user_003730,45,75k-100k,mobile,new,Midwest,39,True,93,5,0,False,False,True,119,7,1,6.8503243960111355,-26,-2
user_003731,47,100k-150k,mobile,new,Midwest,65,True,150,7,0,False,False,False,0,0,0,,150,7
user_003732,52,50k-75k,mobile,new,Midwest,39,True,131,4,0,False,True,True,124,3,0,6.095535664478866,7,1
user_003733,53,50k-75k,desktop,returning,South,47,True,95,2,1,False,True,True,65,3,0,7.482252645415158,30,-1
user_003734,34,>150k,desktop,returning,Midwest,84,True,98,1,0,False,True,True,90,1,0,9.561291152537295,8,0
user_003735,55,30k-50k,mobile,new,East,41,True,119,2,0,False,False,True,128,2,0,5.4804672149003855,-9,0
user_003736,22,100k-150k,desktop,returning,South,71,True,31,3,0,True,True,True,20,4,0,7.800094455323376,11,-1
user_003737,35,75k-100k,mobile,returning,East,63,True,83,1,1,True,True,True,77,2,0,9.721621280329522,6,-1
user_003738,57,50k-75k,desktop,returning,East,45,True,80,2,0,False,False,True,99,2,0,7.758760425946062,-19,0
user_003739,31,75k-100k,mobile,new,South,75,True,91,2,0,False,True,True,72,1,0,7.249352899282264,19,1
user_003740,37,75k-100k,mobile,new,East,45,True,149,1,0,True,False,True,176,1,0,7.596814513552484,-27,0
user_003741,52,50k-75k,desktop,new,East,42,True,156,1,0,False,False,True,163,1,0,7.2023686623481735,-7,0
user_003742,36,50k-75k,mobile,new,East,67,True,82,2,0,False,True,True,85,2,0,6.666767041986387,-3,0
user_003743,24,30k-50k,mobile,returning,West,100,True,87,3,0,False,True,True,116,1,0,9.461926367198165,-29,2
user_003744,50,<30k,desktop,returning,Midwest,3,True,126,1,1,True,False,True,133,2,0,8.21485552322735,-7,-1
user_003745,65,50k-75k,desktop,returning,West,60,True,98,1,0,False,False,True,67,1,0,7.060633951474942,31,0
user_003746,43,50k-75k,desktop,returning,West,73,True,85,1,0,True,True,True,57,2,0,8.695833479773379,28,-1
user_003747,43,75k-100k,desktop,returning,East,52,True,136,3,0,False,True,True,93,1,0,8.07531749649962,43,2
user_003748,51,30k-50k,mobile,returning,South,39,True,55,5,0,True,True,True,37,3,0,8.60448021415503,18,2
user_003749,53,30k-50k,tablet,returning,West,49,True,90,1,0,False,True,True,76,1,0,9.154418536643226,14,0
user_003750,49,30k-50k,tablet,returning,Midwest,41,True,107,2,0,False,True,True,75,2,0,6.321323080187865,32,0
user_003751,48,75k-100k,desktop,returning,West,75,True,113,5,1,False,True,True,51,6,1,10.0,62,-1
user_003752,22,50k-75k,desktop,new,West,79,True,73,1,1,True,True,True,20,1,0,6.161878031846274,53,0
user_003753,36,50k-75k,tablet,returning,South,61,True,61,2,0,True,True,True,42,1,0,7.067247171052265,19,1
user_003754,62,100k-150k,desktop,returning,Midwest,43,True,113,2,0,True,False,True,103,1,0,5.710276701881872,10,1
user_003755,74,50k-75k,desktop,new,West,30,True,136,3,0,True,True,True,118,2,0,8.317582499123336,18,1
user_003756,49,30k-50k,desktop,returning,South,35,True,175,4,0,False,False,True,177,3,1,6.189129109225464,-2,1
user_003757,24,30k-50k,desktop,returning,Midwest,79,True,45,3,0,True,True,True,23,4,0,8.038092139169306,22,-1
user_003758,43,50k-75k,mobile,new,East,68,True,131,4,0,False,True,True,100,4,0,8.31065897137042,31,0
user_003759,40,50k-75k,desktop,new,Midwest,50,True,164,3,0,True,False,True,208,1,0,9.226016405891208,-44,2
user_003760,43,50k-75k,tablet,returning,West,56,True,70,1,0,True,True,True,68,1,0,8.413823154283435,2,0
user_003761,58,50k-75k,mobile,returning,South,23,True,143,2,0,False,False,True,149,3,0,6.1736741030175075,-6,-1
user_003762,57,<30k,mobile,returning,West,31,True,45,5,0,True,True,True,85,4,0,7.8735463971439374,-40,1
user_003763,63,30k-50k,desktop,new,West,48,True,126,6,0,False,False,True,132,7,0,7.102874042351404,-6,-1
user_003764,54,50k-75k,desktop,returning,South,32,True,84,3,0,False,True,True,32,4,1,9.678189877604956,52,-1
user_003765,40,50k-75k,desktop,returning,West,100,True,91,5,0,True,True,True,43,5,0,8.000457929937989,48,0
user_003766,59,50k-75k,desktop,returning,East,0,False,0,0,0,False,True,True,124,1,0,9.257993851913294,-124,-1
user_003767,78,50k-75k,tablet,returning,East,43,True,122,4,0,True,True,True,141,3,0,9.576111095042096,-19,1
user_003768,32,75k-100k,desktop,new,West,52,True,169,3,0,False,True,True,143,5,1,8.18741540084674,26,-2
user_003769,24,<30k,desktop,new,South,53,True,90,3,0,True,True,True,52,1,0,8.694937487648724,38,2
user_003770,33,100k-150k,mobile,returning,South,76,True,99,7,0,False,True,True,64,4,0,7.097328139184855,35,3
user_003771,54,30k-50k,desktop,new,East,26,True,187,3,0,False,False,True,170,2,0,10.0,17,1
user_003772,32,50k-75k,desktop,returning,West,84,True,45,3,0,True,True,True,45,1,1,8.630675124458916,0,2
user_003773,26,30k-50k,mobile,new,Midwest,68,True,101,6,0,True,True,True,118,4,1,7.572809418850133,-17,2
user_003774,49,>150k,mobile,new,West,75,True,121,4,0,False,True,True,74,6,0,8.544502902450796,47,-2
user_003775,73,50k-75k,desktop,returning,East,35,True,120,6,0,False,True,True,88,4,0,8.351715851936696,32,2
user_003776,80,50k-75k,desktop,new,East,38,False,0,0,0,False,False,True,101,1,0,5.614655230348027,-101,-1
user_003777,56,30k-50k,mobile,returning,Midwest,42,True,86,4,0,False,True,True,77,7,1,10.0,9,-3
user_003778,35,30k-50k,tablet,returning,East,35,True,81,4,0,True,True,True,80,4,0,10.0,1,0
user_003779,54,50k-75k,desktop,returning,South,21,True,88,3,0,False,False,True,73,4,0,6.515282850526718,15,-1
user_003780,62,30k-50k,mobile,returning,West,65,True,57,3,0,True,True,True,58,1,0,8.786519699339685,-1,2
user_003781,51,100k-150k,mobile,returning,South,69,True,98,4,0,True,True,True,37,6,0,8.724676170325312,61,-2
user_003782,63,75k-100k,mobile,returning,Midwest,38,True,122,4,0,False,False,True,114,3,0,5.688390871840889,8,1
user_003783,42,50k-75k,mobile,returning,East,49,True,81,2,0,True,True,True,58,1,0,9.206790705642138,23,1
user_003784,18,50k-75k,desktop,returning,West,76,True,88,3,0,True,True,True,83,2,0,6.369845305230144,5,1
user_003785,57,50k-75k,mobile,returning,West,51,True,100,2,0,False,False,True,96,1,0,6.4263703449817084,4,1
user_003786,28,>150k,mobile,returning,West,94,True,48,1,0,False,True,True,43,3,0,9.620649220883763,5,-2
user_003787,45,100k-150k,mobile,returning,East,67,True,49,4,0,False,True,True,20,3,0,8.701004167013512,29,1
user_003788,58,30k-50k,mobile,new,South,53,False,0,0,0,True,True,True,95,2,0,7.8857960149090065,-95,-2
user_003789,19,<30k,desktop,returning,South,66,True,82,4,0,True,True,True,92,2,0,7.371991026282203,-10,2
user_003790,38,50k-75k,mobile,returning,Midwest,38,False,0,0,0,True,False,True,93,1,1,7.544934158141675,-93,-1
user_003791,35,<30k,desktop,new,East,15,True,173,6,1,False,False,True,176,11,1,5.729806205039378,-3,-5
user_003792,27,75k-100k,desktop,new,Midwest,65,True,76,2,0,True,True,True,73,1,0,7.2405096189845075,3,1
user_003793,51,<30k,desktop,returning,East,69,False,0,0,0,False,True,True,67,1,0,8.921677582511858,-67,-1
user_003794,38,75k-100k,desktop,returning,West,35,True,81,2,1,False,True,True,69,2,0,7.938755594879812,12,0
user_003795,33,50k-75k,desktop,returning,West,69,True,110,3,0,True,True,True,85,3,0,6.990269280788622,25,0
user_003796,57,75k-100k,desktop,returning,East,40,True,42,3,1,True,True,True,50,4,0,6.937542944820646,-8,-1
user_003797,64,50k-75k,desktop,returning,South,38,True,124,5,0,True,False,True,134,5,1,5.300082222356407,-10,0
user_003798,46,50k-75k,mobile,returning,South,35,False,0,0,0,True,True,True,93,1,0,8.492555978163278,-93,-1
user_003799,21,50k-75k,mobile,returning,South,75,True,30,4,0,True,True,True,41,3,0,6.944360664885605,-11,1
user_003800,18,50k-75k,mobile,returning,West,86,True,93,3,0,True,True,True,40,2,0,9.298699311247058,53,1
user_003801,45,75k-100k,mobile,returning,West,63,True,119,6,1,True,True,True,79,4,0,6.332838003933847,40,2
user_003802,33,<30k,desktop,returning,South,61,True,53,3,0,True,True,True,36,1,0,6.401653981733592,17,2
user_003803,30,75k-100k,desktop,returning,South,52,True,112,3,0,True,True,True,79,1,0,8.557207095975489,33,2
user_003804,80,100k-150k,desktop,new,East,64,True,112,2,0,True,False,True,113,3,0,5.007341496278163,-1,-1
user_003805,79,30k-50k,mobile,returning,West,41,True,65,5,0,True,True,True,66,3,0,6.535466397379348,-1,2
user_003806,33,<30k,desktop,returning,Midwest,40,True,60,2,0,True,False,False,0,0,0,,60,2
user_003807,57,50k-75k,tablet,new,South,38,True,129,1,0,True,False,True,139,1,0,6.917884398390227,-10,0
user_003808,43,<30k,mobile,new,East,40,True,85,4,0,False,False,True,68,6,0,7.035368298680463,17,-2
user_003809,39,75k-100k,mobile,new,East,53,True,145,6,0,False,True,True,104,6,0,8.285087636983066,41,0
user_003810,58,30k-50k,mobile,returning,Midwest,49,True,76,1,0,False,False,False,0,0,0,,76,1
user_003811,70,<30k,desktop,new,East,54,False,0,0,0,False,False,False,0,0,0,,0,0
user_003812,48,<30k,mobile,returning,Midwest,40,True,82,2,0,True,False,True,93,2,0,5.1770171931318005,-11,0
user_003813,31,>150k,mobile,returning,West,99,True,73,2,1,False,True,True,55,1,0,8.963606501033407,18,1
user_003814,58,<30k,mobile,returning,East,29,True,139,5,0,False,False,True,155,9,0,3.8787259033671284,-16,-4
user_003815,45,75k-100k,desktop,returning,East,43,True,106,2,0,True,False,True,92,4,0,6.795315529051013,14,-2
user_003816,68,30k-50k,desktop,returning,West,50,False,0,0,0,True,True,True,104,1,0,8.462495465094003,-104,-1
user_003817,54,30k-50k,mobile,new,South,50,True,97,1,0,True,False,True,93,1,0,6.696208388482143,4,0
user_003818,52,30k-50k,mobile,new,West,60,False,0,0,0,False,True,True,67,1,0,5.281999643228114,-67,-1
user_003819,35,50k-75k,tablet,new,South,30,True,143,7,0,False,True,False,0,0,0,,143,7
user_003820,67,50k-75k,mobile,returning,South,40,True,109,3,0,True,True,True,139,1,0,10.0,-30,2
user_003821,68,<30k,desktop,returning,South,5,True,90,5,0,True,False,True,83,6,0,7.062243838898364,7,-1
user_003822,46,30k-50k,mobile,returning,East,39,True,99,3,0,True,False,True,94,5,0,7.335808216347675,5,-2
user_003823,45,50k-75k,desktop,returning,East,81,True,50,4,0,True,False,True,20,4,0,7.645279938154986,30,0
user_003824,22,30k-50k,desktop,returning,East,72,True,42,2,0,False,True,True,44,1,0,8.598801136935789,-2,1
user_003825,50,100k-150k,mobile,new,East,67,True,108,3,0,True,True,True,98,3,0,9.8413256788604,10,0
user_003826,51,75k-100k,tablet,new,West,61,True,134,2,0,True,False,True,126,1,0,6.735285487171,8,1
user_003827,39,50k-75k,mobile,new,West,58,True,161,2,0,False,True,True,104,1,0,8.793967279556517,57,1
user_003828,46,100k-150k,desktop,returning,West,65,True,119,1,1,True,True,True,105,1,0,9.05974294316142,14,0
user_003829,34,100k-150k,desktop,returning,South,100,True,68,2,0,True,True,True,75,2,0,10.0,-7,0
user_003830,40,30k-50k,mobile,returning,South,36,True,114,4,0,False,False,True,128,3,0,6.2372947640245116,-14,1
user_003831,49,50k-75k,desktop,returning,South,65,True,117,2,0,True,False,True,88,2,2,7.421668582064286,29,0
user_003832,46,30k-50k,desktop,returning,South,52,True,64,2,0,True,True,True,44,1,0,5.448710152031832,20,1
user_003833,43,50k-75k,mobile,new,West,51,True,125,2,0,True,False,True,155,3,0,9.480548619209307,-30,-1
user_003834,18,30k-50k,desktop,returning,Midwest,61,True,106,2,0,True,True,True,85,1,0,6.8924824483964215,21,1
user_003835,30,>150k,mobile,returning,East,85,True,58,1,0,True,True,True,34,1,0,8.95541389154064,24,0
user_003836,19,<30k,mobile,returning,East,67,True,68,2,0,True,False,True,63,2,1,9.83775740637653,5,0
user_003837,34,50k-75k,desktop,returning,East,60,True,119,1,0,True,False,True,94,1,0,6.961341027098837,25,0
user_003838,64,>150k,mobile,returning,East,29,True,129,4,0,False,True,False,0,0,0,,129,4
user_003839,68,>150k,tablet,returning,South,50,True,72,1,0,False,False,True,71,1,0,7.19538087508902,1,0
user_003840,59,100k-150k,desktop,returning,East,52,True,97,1,0,True,True,True,70,2,0,6.727014755555831,27,-1
user_003841,58,50k-75k,mobile,returning,West,44,True,99,1,0,True,False,True,127,2,0,9.155373487182702,-28,-1
user_003842,38,75k-100k,desktop,new,South,46,False,0,0,0,True,True,True,121,2,0,8.264729763791097,-121,-2
user_003843,38,75k-100k,tablet,new,Midwest,78,True,41,1,0,False,False,True,43,1,1,7.2453339308953275,-2,0
user_003844,18,30k-50k,desktop,new,South,66,True,93,5,0,True,False,True,81,3,0,9.144502590993044,12,2
user_003845,60,30k-50k,desktop,returning,South,30,True,123,2,1,False,False,True,102,1,0,7.005297552049042,21,1
user_003846,55,100k-150k,mobile,new,West,74,True,97,3,0,True,True,False,0,0,0,,97,3
user_003847,54,50k-75k,desktop,new,West,59,True,103,3,0,False,True,True,102,1,0,7.6992249991219035,1,2
user_003848,60,50k-75k,desktop,new,Midwest,34,False,0,0,0,True,False,True,121,2,0,7.465905607119059,-121,-2
user_003849,74,<30k,mobile,new,South,55,True,136,3,0,True,True,True,119,4,0,8.06116920915944,17,-1
user_003850,30,100k-150k,desktop,returning,South,93,True,30,3,1,False,True,True,22,1,0,10.0,8,2
user_003851,31,100k-150k,desktop,returning,Midwest,76,True,141,3,0,True,True,True,90,4,0,9.972307781106817,51,-1
user_003852,26,75k-100k,desktop,returning,West,67,True,109,1,0,True,False,True,147,1,1,6.6778047391394795,-38,0
user_003853,71,<30k,mobile,returning,South,16,False,0,0,0,False,True,False,0,0,0,,0,0
user_003854,53,100k-150k,desktop,returning,East,29,True,146,7,0,False,False,True,136,6,0,7.3621386715542005,10,1
user_003855,35,75k-100k,desktop,returning,Midwest,36,True,124,5,0,False,False,True,134,3,1,6.070993324375943,-10,2
user_003856,53,75k-100k,mobile,new,East,58,True,138,1,0,False,True,True,105,1,0,9.04120403646196,33,0
user_003857,40,50k-75k,desktop,returning,West,60,True,105,4,0,False,False,True,135,2,0,5.74626422099395,-30,2
user_003858,55,50k-75k,mobile,returning,Midwest,24,True,117,3,0,False,False,True,114,3,0,7.2607045148950675,3,0
user_003859,43,<30k,mobile,returning,South,4,True,103,5,0,True,False,True,103,6,0,6.9714404531250285,0,-1
user_003860,50,100k-150k,desktop,new,South,61,True,188,1,0,True,True,True,131,1,0,9.941103008414233,57,0
user_003861,35,50k-75k,desktop,returning,East,62,True,91,4,0,True,False,True,84,3,0,7.680876823897572,7,1
user_003862,65,<30k,mobile,returning,East,47,True,101,3,0,True,False,True,115,1,0,9.61337535766021,-14,2
user_003863,40,<30k,mobile,returning,South,17,True,108,3,0,True,False,True,104,1,0,9.425199422819613,4,2
user_003864,33,<30k,mobile,returning,East,49,True,68,1,1,False,True,True,37,1,0,7.015431910729964,31,0
user_003865,48,75k-100k,tablet,new,Midwest,43,True,185,4,0,False,True,True,130,2,0,6.464069669191335,55,2
user_003866,18,75k-100k,desktop,new,Midwest,68,True,95,4,0,True,True,True,64,4,0,7.195543033848316,31,0
user_003867,26,30k-50k,desktop,returning,West,83,True,88,3,0,True,True,True,86,2,0,9.545326866747212,2,1
user_003868,65,<30k,desktop,new,East,5,True,152,6,1,False,False,False,0,0,0,,152,6
user_003869,45,50k-75k,tablet,returning,Midwest,19,True,149,1,0,True,True,True,115,1,0,8.742696477766033,34,0
user_003870,60,50k-75k,mobile,returning,East,46,True,47,1,1,False,True,True,20,3,0,7.640857839950477,27,-2
user_003871,52,30k-50k,mobile,new,West,80,True,47,5,0,False,True,True,43,5,0,7.793872928815286,4,0
user_003872,63,30k-50k,mobile,returning,West,26,True,137,9,0,False,False,True,105,8,0,7.467710058866092,32,1
user_003873,34,50k-75k,desktop,returning,West,87,True,90,3,0,False,True,True,76,2,1,7.355777578080123,14,1
user_003874,41,75k-100k,desktop,returning,Midwest,48,True,76,4,0,True,False,True,91,4,0,9.222116754322053,-15,0
user_003875,39,75k-100k,desktop,returning,West,51,True,73,5,0,False,False,True,100,9,0,6.969152125568074,-27,-4
user_003876,27,<30k,desktop,new,West,30,True,122,2,1,False,True,True,70,1,0,6.638927661744085,52,1
user_003877,43,50k-75k,desktop,new,West,49,False,0,0,0,True,False,True,101,4,0,8.139331363561027,-101,-4
user_003878,18,<30k,desktop,new,South,44,False,0,0,0,False,True,False,0,0,0,,0,0
user_003879,64,75k-100k,desktop,returning,South,25,True,123,2,0,False,False,True,153,3,0,7.737329225608041,-30,-1
user_003880,29,50k-75k,desktop,new,East,79,True,88,1,0,False,True,True,62,1,1,9.145507269168261,26,0
user_003881,59,30k-50k,mobile,returning,South,37,True,69,4,0,True,False,True,83,7,0,6.786534001380321,-14,-3
user_003882,28,50k-75k,mobile,new,Midwest,54,True,124,1,0,False,True,True,99,1,0,6.782016428786952,25,0
user_003883,58,50k-75k,desktop,returning,South,43,True,66,3,0,True,False,True,53,6,0,7.660163046909246,13,-3
user_003884,65,>150k,mobile,returning,South,50,True,81,3,0,False,True,True,78,2,0,8.403160071363446,3,1
user_003885,50,50k-75k,desktop,new,South,49,True,124,1,0,True,True,True,110,2,0,10.0,14,-1
user_003886,22,75k-100k,mobile,new,South,55,True,112,4,0,False,True,True,82,5,0,6.88766979359043,30,-1
user_003887,57,50k-75k,mobile,returning,East,41,True,30,1,0,True,False,True,31,1,0,6.151178535559473,-1,0
user_003888,24,30k-50k,mobile,returning,South,42,True,134,3,0,False,True,True,89,2,0,6.951591663322132,45,1
user_003889,78,75k-100k,mobile,returning,South,33,True,131,5,0,False,True,False,0,0,0,,131,5
user_003890,73,<30k,desktop,returning,East,11,False,0,0,0,False,False,True,113,1,1,5.1014114064228835,-113,-1
user_003891,25,<30k,mobile,returning,East,66,True,66,3,1,True,True,True,48,1,0,8.105728906846073,18,2
user_003892,63,50k-75k,desktop,returning,South,7,True,116,1,0,False,False,True,104,1,0,6.771273438578388,12,0
user_003893,32,50k-75k,mobile,returning,East,84,True,76,1,1,False,True,True,73,1,0,5.84865157352713,3,0
user_003894,18,30k-50k,mobile,new,Midwest,59,False,0,0,0,False,False,True,133,1,0,5.366183726200801,-133,-1
user_003895,53,50k-75k,mobile,returning,West,73,False,0,0,0,True,True,True,88,1,0,9.608432557480919,-88,-1
user_003896,63,<30k,tablet,returning,Midwest,0,False,0,0,0,True,False,True,99,1,1,7.764804722221872,-99,-1
user_003897,51,30k-50k,mobile,returning,South,37,True,74,5,0,False,True,True,37,5,0,7.857699354235668,37,0
user_003898,54,75k-100k,mobile,returning,East,57,True,79,2,1,True,False,True,98,1,0,7.563773850004746,-19,1
user_003899,46,<30k,desktop,returning,South,17,True,136,3,0,False,False,True,142,1,0,7.644008868973362,-6,2
user_003900,41,100k-150k,mobile,returning,South,57,True,83,2,0,False,True,True,49,2,0,8.676382635505512,34,0
user_003901,18,<30k,desktop,new,South,72,True,41,5,0,False,False,False,0,0,0,,41,5
user_003902,42,50k-75k,desktop,returning,West,74,True,30,3,0,False,False,True,33,1,0,8.356479337110924,-3,2
user_003903,53,<30k,desktop,returning,East,55,True,96,3,0,False,True,False,0,0,0,,96,3
user_003904,18,75k-100k,mobile,returning,East,80,True,58,1,0,True,True,True,60,2,0,8.50882847291435,-2,-1
user_003905,18,75k-100k,mobile,new,South,53,True,143,3,0,False,False,True,159,4,0,6.999432000884628,-16,-1
user_003906,46,75k-100k,desktop,new,West,67,True,92,3,0,True,True,True,75,4,0,9.849776655703224,17,-1
user_003907,38,50k-75k,desktop,returning,West,40,True,64,3,0,False,True,True,20,4,0,5.700527309228508,44,-1
user_003908,49,100k-150k,mobile,new,South,46,False,0,0,0,False,True,True,118,1,0,7.3106044299291595,-118,-1
user_003909,71,30k-50k,desktop,returning,West,56,True,114,1,0,True,False,True,105,1,0,8.011773321211505,9,0
user_003910,66,75k-100k,desktop,returning,East,50,True,114,1,1,False,False,True,128,1,0,7.740966414197377,-14,0
user_003911,49,75k-100k,desktop,new,West,57,True,74,3,0,False,True,True,73,1,1,7.271559997233672,1,2
user_003912,47,75k-100k,desktop,new,West,56,True,147,3,0,False,True,True,102,1,0,8.787589809311317,45,2
user_003913,27,50k-75k,mobile,returning,Midwest,47,True,106,3,1,False,False,True,102,1,1,4.472625133686738,4,2
user_003914,65,30k-50k,desktop,new,East,23,True,127,4,0,False,False,True,130,3,0,5.662605264376398,-3,1
user_003915,42,75k-100k,desktop,new,East,48,False,0,0,0,True,True,True,94,1,0,6.610271712369323,-94,-1
user_003916,50,75k-100k,tablet,new,South,33,True,113,3,0,False,False,True,106,1,0,5.512331845095268,7,2
user_003917,42,75k-100k,desktop,new,East,37,True,62,4,0,False,True,True,50,1,0,6.924730645260851,12,3
user_003918,43,100k-150k,desktop,returning,East,80,True,36,1,0,True,True,True,20,1,0,8.159123287427724,16,0
user_003919,49,<30k,desktop,new,West,35,True,68,3,1,False,False,False,0,0,0,,68,3
user_003920,47,75k-100k,mobile,returning,South,56,True,87,5,0,False,True,True,62,1,0,8.552642216543704,25,4
user_003921,39,75k-100k,desktop,new,East,49,True,83,3,0,True,True,True,71,1,1,5.609017127083328,12,2
user_003922,70,30k-50k,desktop,new,West,40,True,121,3,0,False,True,True,104,1,0,7.4583496882404745,17,2
user_003923,39,100k-150k,desktop,returning,East,59,True,117,4,1,True,True,True,118,1,0,6.039250404960893,-1,3
user_003924,45,75k-100k,desktop,returning,Midwest,24,True,144,1,0,False,True,True,112,1,0,8.631311787701295,32,0
user_003925,41,50k-75k,mobile,returning,South,39,True,82,2,0,True,False,True,84,3,0,6.353285141048979,-2,-1
user_003926,44,50k-75k,desktop,returning,South,62,True,148,3,0,True,True,True,112,5,0,7.529611131295278,36,-2
user_003927,56,50k-75k,desktop,new,South,35,True,123,3,0,False,False,True,149,1,0,7.896041924972681,-26,2
user_003928,34,>150k,desktop,new,West,90,True,65,3,0,True,True,True,20,2,0,9.458135769220014,45,1
user_003929,43,100k-150k,mobile,returning,Midwest,40,True,105,1,0,False,True,True,81,1,0,8.720058921354584,24,0
user_003930,42,50k-75k,desktop,returning,West,89,True,49,4,0,False,True,True,56,5,0,8.816405752335495,-7,-1
user_003931,20,75k-100k,desktop,new,West,74,True,90,1,0,False,True,True,59,1,0,8.347096517394391,31,0
user_003932,25,30k-50k,mobile,new,East,83,False,0,0,0,True,True,False,0,0,0,,0,0
user_003933,45,<30k,mobile,returning,East,48,True,92,2,1,False,True,True,57,2,0,6.0466046688001835,35,0
user_003934,66,30k-50k,mobile,returning,East,43,True,71,3,1,False,False,True,43,1,0,5.973003926496663,28,2
user_003935,56,75k-100k,mobile,returning,East,0,True,154,4,0,False,False,True,156,4,0,8.246198362438513,-2,0
user_003936,34,75k-100k,mobile,returning,East,66,True,50,1,0,True,True,True,52,1,0,9.53668065068086,-2,0
user_003937,39,30k-50k,mobile,returning,South,24,True,126,4,0,False,False,False,0,0,0,,126,4
user_003938,28,30k-50k,desktop,new,West,83,True,84,1,0,False,True,True,48,2,0,9.320189598322948,36,-1
user_003939,79,30k-50k,mobile,new,South,28,False,0,0,0,False,False,True,131,1,0,8.089783747419204,-131,-1
user_003940,30,30k-50k,desktop,new,East,76,True,95,2,0,True,True,True,106,2,0,7.481444517160983,-11,0
user_003941,41,75k-100k,desktop,new,South,35,True,165,5,0,False,True,True,121,2,0,7.776039426900819,44,3
user_003942,47,75k-100k,desktop,new,South,59,True,133,1,0,False,True,True,119,1,0,8.09519114880878,14,0
user_003943,50,100k-150k,mobile,returning,West,86,True,65,3,1,True,False,True,20,5,0,6.910923623439798,45,-2
user_003944,32,50k-75k,mobile,returning,Midwest,34,True,106,5,0,False,False,True,90,11,0,6.2095941251459745,16,-6
user_003945,21,100k-150k,mobile,new,South,62,True,152,3,0,False,True,True,152,2,0,7.445425858403083,0,1
user_003946,40,30k-50k,desktop,new,Midwest,62,True,139,1,0,True,False,True,135,2,0,6.725246040759771,4,-1
user_003947,39,75k-100k,mobile,returning,East,32,True,105,9,0,False,False,True,112,9,0,7.6230663868678485,-7,0
user_003948,66,100k-150k,mobile,returning,East,32,True,106,5,0,True,True,True,106,3,0,7.026624286519869,0,2
user_003949,53,30k-50k,mobile,returning,East,41,True,101,3,0,False,False,True,90,4,0,9.324423841446812,11,-1
user_003950,18,100k-150k,desktop,returning,Midwest,84,True,36,3,0,True,True,True,20,2,0,7.224417851310894,16,1
user_003951,55,>150k,mobile,returning,South,65,True,79,3,0,True,True,True,79,2,0,9.116192967592207,0,1
user_003952,33,30k-50k,mobile,returning,East,76,True,68,2,1,True,True,True,63,1,1,10.0,5,1
user_003953,54,75k-100k,desktop,new,East,82,False,0,0,0,False,False,True,125,1,0,7.432398129816416,-125,-1
user_003954,75,30k-50k,desktop,new,East,30,True,134,2,0,True,False,True,102,4,0,7.843929478308948,32,-2
user_003955,40,100k-150k,mobile,returning,West,98,True,112,3,0,True,True,True,81,4,0,8.021842713768272,31,-1
user_003956,68,75k-100k,mobile,returning,East,36,True,37,6,0,False,False,True,33,6,0,8.832470581407001,4,0
user_003957,43,75k-100k,mobile,returning,East,25,True,125,5,0,False,False,False,0,0,0,,125,5
user_003958,18,50k-75k,desktop,returning,East,81,True,72,1,0,True,True,True,54,1,0,9.50167594025466,18,0
user_003959,35,100k-150k,desktop,returning,West,68,True,81,1,0,True,True,True,60,2,0,8.066060620126988,21,-1
user_003960,43,30k-50k,desktop,returning,South,21,False,0,0,0,True,True,True,83,1,0,8.695648812482531,-83,-1
user_003961,34,>150k,desktop,returning,West,100,True,35,4,1,True,True,True,29,5,0,9.845203983632727,6,-1
user_003962,36,50k-75k,desktop,returning,Midwest,48,True,95,5,0,True,False,True,61,2,0,9.190212897080123,34,3
user_003963,41,50k-75k,desktop,new,East,34,True,138,3,0,False,False,True,152,2,0,8.689107090467012,-14,1
user_003964,59,>150k,mobile,returning,Midwest,40,True,78,3,0,False,False,True,96,2,0,8.865887434795807,-18,1
user_003965,31,<30k,mobile,new,East,65,False,0,0,0,False,False,True,95,1,1,7.358330089416949,-95,-1
user_003966,29,100k-150k,desktop,returning,West,100,True,46,3,0,True,True,True,48,3,0,7.960755750439038,-2,0
user_003967,59,30k-50k,desktop,returning,South,65,True,61,5,0,True,False,True,86,7,0,7.322006952267303,-25,-2
user_003968,40,>150k,desktop,returning,South,56,True,105,4,0,True,False,True,79,10,0,7.810206929833072,26,-6
user_003969,48,75k-100k,mobile,returning,East,50,True,118,3,0,True,True,True,75,1,0,8.930868648769469,43,2
user_003970,42,30k-50k,mobile,new,Midwest,71,True,102,3,0,False,True,True,89,2,0,7.893117408477603,13,1
user_003971,24,30k-50k,desktop,returning,West,49,True,134,3,0,False,True,True,139,2,0,5.509320060101664,-5,1
user_003972,51,>150k,desktop,returning,South,63,True,113,1,0,True,True,True,62,1,0,8.285575134444924,51,0
user_003973,37,<30k,desktop,returning,Midwest,19,True,76,2,0,True,False,True,75,2,0,6.149475999289663,1,0
user_003974,51,30k-50k,mobile,new,East,59,True,125,1,0,True,False,True,151,1,0,8.774427937697082,-26,0
user_003975,46,100k-150k,desktop,returning,East,62,True,46,4,0,True,True,True,40,9,0,8.432797264292356,6,-5
user_003976,30,50k-75k,desktop,returning,South,49,True,56,1,0,True,True,True,36,2,0,8.827652271254404,20,-1
user_003977,54,50k-75k,tablet,returning,South,54,True,120,1,0,False,False,True,147,1,0,8.068729015565337,-27,0
user_003978,29,50k-75k,mobile,new,South,52,True,144,2,0,True,True,True,147,1,0,5.4447256444505605,-3,1
user_003979,62,>150k,mobile,returning,East,45,True,102,1,0,True,True,True,76,1,0,7.638850931632698,26,0
user_003980,57,<30k,mobile,returning,Midwest,31,True,36,6,0,False,True,True,29,4,0,8.255079167472234,7,2
user_003981,65,<30k,mobile,returning,East,18,True,118,4,0,False,True,False,0,0,0,,118,4
user_003982,62,<30k,desktop,new,West,30,True,83,3,0,True,False,True,85,3,0,7.950865570621,-2,0
user_003983,58,<30k,desktop,returning,West,35,True,92,4,0,True,True,True,79,4,0,8.69393692133136,13,0
user_003984,40,50k-75k,mobile,returning,Midwest,20,True,112,4,0,True,False,True,138,2,0,6.452724324400543,-26,2
user_003985,31,50k-75k,desktop,returning,South,65,True,59,1,0,True,True,True,57,1,0,7.009686297964588,2,0
user_003986,29,50k-75k,desktop,new,West,56,False,0,0,0,False,True,True,97,3,0,7.600136105814795,-97,-3
user_003987,68,30k-50k,mobile,new,Midwest,9,False,0,0,0,True,False,False,0,0,0,,0,0
user_003988,44,50k-75k,desktop,new,East,44,True,130,3,0,False,False,True,164,2,0,8.245873623278491,-34,1
user_003989,41,50k-75k,mobile,new,West,51,True,132,1,0,False,True,True,123,1,0,5.374424351674594,9,0
user_003990,51,>150k,mobile,returning,Midwest,62,False,0,0,0,True,True,True,81,1,1,7.876161388351377,-81,-1
user_003991,58,100k-150k,desktop,returning,West,63,True,58,2,1,False,False,True,54,2,1,8.487363885384733,4,0
user_003992,44,75k-100k,tablet,new,East,53,True,89,4,0,False,False,True,47,4,0,8.777092099911801,42,0
user_003993,41,75k-100k,mobile,returning,South,44,True,73,3,0,True,True,True,47,2,0,8.979654805860585,26,1
user_003994,41,<30k,desktop,returning,West,52,True,47,3,0,False,False,True,28,4,1,8.814057168842421,19,-1
user_003995,75,30k-50k,desktop,returning,South,26,True,151,4,1,False,False,True,127,4,1,7.493466519998291,24,0
user_003996,58,50k-75k,desktop,returning,West,38,True,76,2,0,True,True,True,61,2,1,8.707968355586477,15,0
user_003997,68,50k-75k,mobile,returning,West,56,True,70,2,0,False,False,True,54,1,0,9.514328278161331,16,1
user_003998,42,100k-150k,desktop,returning,Midwest,44,True,141,6,0,True,True,True,92,4,0,6.883145983812913,49,2
user_003999,18,30k-50k,mobile,returning,East,90,True,38,2,0,True,True,True,30,2,0,8.00924710411734,8,0
user_004000,63,30k-50k,mobile,new,West,52,True,121,5,0,False,True,True,127,1,0,7.4322337614249,-6,4
user_004001,45,30k-50k,mobile,returning,West,44,True,57,3,0,False,True,True,60,1,0,8.684641593774357,-3,2
user_004002,22,75k-100k,desktop,returning,West,73,True,35,5,0,True,True,True,53,2,0,9.873040456783423,-18,3
user_004003,38,75k-100k,desktop,new,West,55,True,111,1,0,False,True,True,92,1,0,8.443791568541315,19,0
user_004004,36,30k-50k,desktop,returning,East,42,True,91,1,0,False,False,True,81,1,0,6.467610400597091,10,0
user_004005,45,30k-50k,mobile,returning,West,61,True,89,2,0,True,True,True,105,1,0,8.538392868779141,-16,1
user_004006,27,50k-75k,mobile,returning,East,56,True,71,5,0,True,True,True,40,3,0,10.0,31,2
user_004007,53,100k-150k,mobile,returning,East,50,True,83,2,0,False,True,True,98,1,0,7.055366758960315,-15,1
user_004008,69,50k-75k,desktop,returning,West,51,True,30,1,0,False,True,True,20,1,0,7.508413403112709,10,0
user_004009,31,75k-100k,desktop,returning,West,94,True,71,2,0,True,True,True,38,1,0,8.543194353601157,33,1
user_004010,62,50k-75k,mobile,returning,East,43,True,85,3,0,False,True,True,63,4,0,6.724754304101483,22,-1
user_004011,66,100k-150k,desktop,new,South,68,True,109,2,1,False,False,True,90,3,0,5.895731694152495,19,-1
user_004012,39,100k-150k,mobile,new,East,88,True,100,3,0,True,False,True,74,2,1,6.646672513119732,26,1
user_004013,53,75k-100k,desktop,returning,South,31,True,44,3,0,False,False,True,44,3,0,8.146832264734506,0,0
user_004014,35,75k-100k,mobile,new,West,75,True,120,3,0,False,True,True,77,2,0,6.672059837559848,43,1
user_004015,36,50k-75k,mobile,returning,Midwest,65,True,84,1,0,True,True,True,61,1,0,7.960565093740364,23,0
user_004016,49,75k-100k,desktop,new,West,70,True,98,1,1,False,True,True,105,1,1,6.391339479288935,-7,0
user_004017,56,75k-100k,mobile,returning,Midwest,7,True,143,4,0,True,True,True,132,2,0,8.005754164776185,11,2
user_004018,53,<30k,desktop,new,East,53,True,53,3,2,True,True,True,57,1,0,9.094389243083958,-4,2
user_004019,46,<30k,mobile,new,Midwest,38,False,0,0,0,True,True,True,131,2,0,7.9620475169890605,-131,-2
user_004020,18,30k-50k,mobile,returning,West,99,True,106,1,0,True,True,True,122,1,0,8.931121426220152,-16,0
user_004021,18,75k-100k,desktop,new,Midwest,70,True,121,5,0,False,True,True,64,3,0,7.8695845352353,57,2
user_004022,32,30k-50k,desktop,new,South,59,True,135,1,0,False,False,True,101,1,0,5.752333231215628,34,0
user_004023,34,50k-75k,mobile,returning,South,73,True,109,1,0,True,True,True,72,1,0,8.55958008582258,37,0
user_004024,53,100k-150k,mobile,returning,East,60,True,122,2,1,True,True,False,0,0,0,,122,2
user_004025,33,30k-50k,desktop,new,South,79,True,94,2,0,True,True,True,57,1,0,7.779570795180514,37,1
user_004026,33,75k-100k,desktop,returning,Midwest,67,True,94,1,0,True,True,True,59,1,0,8.477334107901152,35,0
user_004027,58,75k-100k,desktop,returning,South,11,True,202,1,0,False,False,True,182,1,0,5.896086495239746,20,0
user_004028,19,<30k,desktop,returning,East,71,True,149,4,0,False,True,False,0,0,0,,149,4
user_004029,27,75k-100k,desktop,new,East,55,True,76,1,0,False,True,True,84,3,0,9.67116217607279,-8,-2
user_004030,34,100k-150k,mobile,new,Midwest,69,True,151,7,0,True,True,True,138,3,1,5.900229413228679,13,4
user_004031,65,50k-75k,mobile,new,West,46,True,80,5,1,False,False,True,88,5,0,6.917900871658691,-8,0
user_004032,55,100k-150k,mobile,returning,South,57,True,86,3,0,False,False,True,103,2,0,8.198601000346516,-17,1
user_004033,65,100k-150k,mobile,new,West,90,True,82,1,0,False,True,True,45,1,0,8.782313246135946,37,0
user_004034,23,50k-75k,desktop,returning,West,62,True,108,1,0,True,False,True,67,2,0,7.191804563823916,41,-1
user_004035,59,50k-75k,desktop,returning,East,27,True,102,3,1,False,False,True,110,4,1,6.571261065925835,-8,-1
user_004036,41,100k-150k,mobile,new,South,51,True,57,3,1,True,True,True,54,2,0,8.342957933720122,3,1
user_004037,54,50k-75k,mobile,new,East,57,True,152,1,0,False,False,True,159,2,0,8.635741355310365,-7,-1
user_004038,18,>150k,mobile,new,South,87,True,77,2,0,True,True,True,131,1,1,8.132240616712131,-54,1
user_004039,68,30k-50k,mobile,returning,West,37,False,0,0,0,True,True,False,0,0,0,,0,0
user_004040,54,75k-100k,mobile,new,East,81,True,87,4,1,True,True,True,92,4,0,8.513450067339047,-5,0
user_004041,59,50k-75k,mobile,returning,East,36,True,74,2,0,True,False,True,67,1,0,8.240657203074644,7,1
user_004042,38,75k-100k,desktop,returning,Midwest,46,True,65,3,0,False,False,True,71,2,0,5.703232232524667,-6,1
user_004043,45,>150k,mobile,returning,West,73,True,87,3,0,True,True,True,54,1,0,9.070482166222732,33,2
user_004044,54,50k-75k,desktop,new,East,28,False,0,0,0,False,False,True,97,1,0,6.818769763133714,-97,-1
user_004045,44,100k-150k,desktop,returning,South,44,True,71,1,2,True,True,True,68,2,0,8.20719115749884,3,-1
user_004046,49,50k-75k,mobile,new,West,74,True,79,6,0,False,False,False,0,0,0,,79,6
user_004047,63,100k-150k,desktop,returning,Midwest,30,True,93,2,0,False,False,True,67,1,0,9.956125185553454,26,1
user_004048,24,>150k,tablet,returning,West,90,True,107,1,1,True,True,True,50,1,0,8.489369567877075,57,0
user_004049,41,100k-150k,mobile,returning,Midwest,50,True,112,1,0,True,True,True,41,1,0,8.481845937101188,71,0
user_004050,44,<30k,desktop,returning,West,51,True,54,2,0,True,True,True,59,2,0,8.801161842694048,-5,0
user_004051,33,30k-50k,mobile,new,South,40,True,121,5,0,False,False,False,0,0,0,,121,5
user_004052,32,100k-150k,desktop,returning,South,91,True,39,2,0,True,True,False,0,0,0,,39,2
user_004053,41,75k-100k,desktop,returning,Midwest,39,True,107,3,0,True,False,True,140,2,0,7.424193931997502,-33,1
user_004054,72,50k-75k,mobile,returning,East,29,True,126,2,0,False,False,True,137,3,0,6.823501626934589,-11,-1
user_004055,50,50k-75k,mobile,new,Midwest,56,True,99,1,0,False,False,True,66,1,0,5.3628703912423115,33,0
user_004056,67,50k-75k,mobile,returning,South,19,False,0,0,0,False,False,True,137,1,0,7.292523399687687,-137,-1
user_004057,22,50k-75k,desktop,returning,West,82,False,0,0,0,True,True,True,105,1,0,9.279430095467474,-105,-1
user_004058,59,30k-50k,desktop,new,Midwest,11,True,153,2,0,True,False,True,148,1,0,6.5784457974281505,5,1
user_004059,41,<30k,desktop,returning,South,42,True,79,1,1,False,False,True,114,1,0,6.148510213891695,-35,0
user_004060,48,<30k,desktop,returning,West,35,False,0,0,0,False,False,True,141,1,0,6.612338395041099,-141,-1
user_004061,44,100k-150k,desktop,new,East,56,True,125,1,0,True,True,True,116,1,0,5.007649269961259,9,0
user_004062,54,75k-100k,desktop,returning,West,57,True,159,3,1,True,False,True,185,3,0,8.844959608310266,-26,0
user_004063,41,30k-50k,mobile,returning,Midwest,56,True,57,3,0,True,False,True,59,2,0,7.983145821065446,-2,1
user_004064,42,50k-75k,desktop,returning,South,47,True,111,1,1,True,False,True,149,1,0,6.903463165796607,-38,0
user_004065,29,75k-100k,mobile,new,West,100,True,92,4,0,False,True,True,60,3,0,7.274846776880112,32,1
user_004066,40,100k-150k,desktop,new,Midwest,40,True,100,7,0,False,True,True,82,8,0,9.633633467217026,18,-1
user_004067,38,75k-100k,desktop,returning,South,65,True,115,5,0,True,True,True,97,4,0,7.9335261906453125,18,1
user_004068,33,50k-75k,desktop,new,South,77,False,0,0,0,False,False,True,111,5,0,7.308794936146259,-111,-5
user_004069,41,>150k,mobile,returning,East,88,True,88,1,1,True,True,True,50,1,0,9.009269142890625,38,0
user_004070,38,75k-100k,mobile,new,West,71,True,90,6,1,False,False,True,123,6,0,7.7386843329726736,-33,0
user_004071,43,75k-100k,desktop,returning,West,62,True,69,2,0,True,True,True,29,1,0,7.09153837529447,40,1
user_004072,18,75k-100k,desktop,new,West,75,False,0,0,0,False,False,True,140,2,1,7.629027011320765,-140,-2
user_004073,28,100k-150k,mobile,returning,East,88,True,91,5,0,False,True,True,20,2,0,8.388382445991802,71,3
user_004074,80,30k-50k,desktop,returning,West,62,True,107,1,0,False,False,True,130,1,0,9.71123743816048,-23,0
user_004075,51,<30k,desktop,returning,West,72,True,134,1,0,False,True,False,0,0,0,,134,1
user_004076,25,100k-150k,mobile,returning,West,88,True,71,2,0,True,True,True,36,1,0,10.0,35,1
user_004077,33,100k-150k,desktop,new,West,88,True,92,2,0,True,True,True,81,1,0,6.587122131550898,11,1
user_004078,48,75k-100k,desktop,returning,South,11,True,183,5,0,False,False,True,176,7,0,7.480250390704982,7,-2
user_004079,40,50k-75k,desktop,returning,South,37,True,31,3,0,True,True,True,20,2,0,7.3903730513185195,11,1
user_004080,40,100k-150k,desktop,new,Midwest,90,True,115,1,0,False,True,True,51,1,0,8.899538957193611,64,0
user_004081,60,30k-50k,desktop,returning,West,58,True,56,1,0,False,False,True,69,1,0,6.608864723407565,-13,0
user_004082,70,100k-150k,mobile,returning,West,76,True,66,3,0,True,True,True,35,4,0,8.503656656227795,31,-1
user_004083,28,50k-75k,desktop,returning,Midwest,64,True,107,4,0,False,True,True,90,1,0,8.511089874607551,17,3
user_004084,41,<30k,mobile,returning,South,36,True,30,1,0,False,True,True,20,1,0,8.132752700349412,10,0
user_004085,58,75k-100k,mobile,new,Midwest,11,True,166,2,1,False,False,True,181,1,0,8.08150894614672,-15,1
user_004086,65,75k-100k,desktop,returning,East,32,True,132,1,0,False,True,True,79,1,0,7.333967632696051,53,0
user_004087,43,50k-75k,mobile,returning,West,50,True,41,1,0,False,False,True,49,1,0,4.901426204023987,-8,0
user_004088,44,30k-50k,mobile,returning,West,55,False,0,0,0,True,False,True,117,3,1,6.951377827560309,-117,-3
user_004089,54,30k-50k,mobile,returning,Midwest,47,True,71,4,0,True,True,True,25,6,0,8.617164015581741,46,-2
user_004090,44,50k-75k,desktop,new,South,27,True,174,6,0,True,False,True,165,11,0,6.873752618578119,9,-5
user_004091,37,50k-75k,desktop,returning,South,34,True,142,1,0,False,False,True,145,1,0,7.407225728984044,-3,0
user_004092,50,100k-150k,desktop,returning,Midwest,61,True,79,4,1,False,False,True,90,3,1,7.092501058398572,-11,1
user_004093,68,50k-75k,desktop,returning,South,48,True,76,1,0,False,False,False,0,0,0,,76,1
user_004094,70,>150k,desktop,returning,Midwest,41,True,94,2,1,True,False,True,95,3,0,6.839793303781753,-1,-1
user_004095,37,50k-75k,desktop,returning,South,40,True,82,2,0,False,True,True,45,1,0,5.80584687989983,37,1
user_004096,28,50k-75k,desktop,new,West,100,True,130,3,0,False,False,True,124,2,0,5.663819505700969,6,1
user_004097,21,75k-100k,desktop,returning,East,100,True,70,1,0,False,True,True,66,2,0,9.334854179408538,4,-1
user_004098,38,100k-150k,desktop,new,West,58,False,0,0,0,True,True,False,0,0,0,,0,0
user_004099,47,50k-75k,desktop,new,Midwest,52,True,124,1,2,False,True,True,92,1,0,5.312338014256187,32,0
user_004100,30,30k-50k,desktop,returning,South,37,False,0,0,0,True,False,True,131,1,0,7.282823533077451,-131,-1
user_004101,29,50k-75k,desktop,returning,West,82,True,83,1,0,False,True,True,70,1,0,6.472143988134002,13,0
user_004102,59,30k-50k,desktop,new,East,54,False,0,0,0,False,False,True,128,1,0,7.3393440340922265,-128,-1
user_004103,30,<30k,desktop,new,East,58,True,97,1,0,False,True,True,109,1,0,6.874475817254446,-12,0
user_004104,44,>150k,mobile,returning,South,60,True,134,2,1,True,False,True,129,2,0,5.023882641062829,5,0
user_004105,47,100k-150k,tablet,new,East,56,True,85,1,0,False,True,True,76,1,0,7.253132131892817,9,0
user_004106,35,50k-75k,mobile,returning,West,63,False,0,0,0,False,True,True,104,1,0,8.520369194448445,-104,-1
user_004107,67,30k-50k,desktop,new,East,14,True,124,5,1,False,True,True,80,1,1,7.591261513785453,44,4
user_004108,55,75k-100k,mobile,new,East,60,True,103,3,0,True,True,True,74,3,0,8.826576079955796,29,0
user_004109,38,30k-50k,mobile,returning,West,56,True,50,5,0,True,False,True,31,2,1,6.595616142531421,19,3
user_004110,36,50k-75k,mobile,returning,Midwest,27,True,98,4,0,False,False,True,89,6,0,6.450847655985481,9,-2
user_004111,52,75k-100k,desktop,new,Midwest,66,True,125,1,0,True,False,True,129,1,0,6.982579610453298,-4,0
user_004112,37,30k-50k,mobile,returning,South,48,True,143,3,0,True,True,True,96,1,0,6.35918437098761,47,2
user_004113,63,50k-75k,desktop,returning,West,49,True,122,4,0,True,True,True,88,6,0,9.891278845676293,34,-2
user_004114,63,<30k,desktop,returning,Midwest,41,False,0,0,0,False,False,True,154,2,0,6.792357673906857,-154,-2
user_004115,66,<30k,mobile,returning,West,52,False,0,0,0,True,True,True,99,1,0,8.292103180016163,-99,-1
user_004116,58,30k-50k,desktop,returning,East,33,True,85,2,0,False,True,True,89,1,0,7.977103822964757,-4,1
user_004117,26,50k-75k,desktop,new,West,70,True,105,3,0,False,True,True,77,1,0,7.347470311311476,28,2
user_004118,58,75k-100k,mobile,new,East,8,True,202,3,1,False,True,True,158,3,0,7.885185766104871,44,0
user_004119,48,30k-50k,mobile,returning,South,47,True,136,1,0,True,False,True,169,1,0,5.604590091269995,-33,0
user_004120,30,50k-75k,desktop,returning,South,66,True,122,1,0,False,False,True,99,1,0,7.879261698114248,23,0
user_004121,31,100k-150k,desktop,returning,West,79,True,85,3,0,False,True,True,72,1,0,6.76746882927165,13,2
user_004122,58,50k-75k,mobile,returning,West,29,True,128,6,0,False,False,True,124,5,0,7.764724926476315,4,1
user_004123,48,100k-150k,mobile,returning,West,67,True,93,3,0,True,True,True,79,1,0,5.870193599140239,14,2
user_004124,37,75k-100k,desktop,returning,South,34,True,65,3,1,True,False,True,79,2,0,2.851765200863875,-14,1
user_004125,34,<30k,desktop,new,West,72,True,93,3,0,False,True,True,84,3,0,10.0,9,0
user_004126,23,<30k,mobile,new,Midwest,59,True,134,1,0,False,True,True,77,2,0,7.786496476208048,57,-1
user_004127,21,30k-50k,desktop,returning,Midwest,60,True,83,1,0,False,False,True,93,1,1,4.713117300852108,-10,0
user_004128,28,>150k,desktop,new,East,75,True,140,2,0,False,False,True,138,1,0,7.615499433844914,2,1
user_004129,34,100k-150k,desktop,new,East,94,True,86,3,0,False,True,True,75,2,0,8.98700440784713,11,1
user_004130,57,50k-75k,desktop,returning,Midwest,24,True,137,6,0,True,False,True,106,7,0,6.993759513202341,31,-1
user_004131,41,<30k,mobile,new,Midwest,36,True,146,1,0,False,False,True,144,3,0,8.073079366191847,2,-2
user_004132,51,75k-100k,desktop,returning,West,70,True,86,3,0,True,True,True,76,5,0,9.99169284231999,10,-2
user_004133,38,50k-75k,mobile,returning,South,41,True,72,2,0,False,False,True,78,1,0,6.019135667845288,-6,1
user_004134,28,100k-150k,mobile,returning,East,85,True,74,2,0,True,True,True,60,3,0,7.682308554084317,14,-1
user_004135,36,100k-150k,desktop,returning,Midwest,45,True,109,4,0,False,False,True,67,4,0,7.630919788100857,42,0
user_004136,68,50k-75k,desktop,returning,East,26,True,145,1,0,False,False,True,170,2,0,9.109763049446391,-25,-1
user_004137,68,30k-50k,mobile,new,South,14,True,108,4,0,False,False,True,119,2,0,7.035823908462502,-11,2
user_004138,30,<30k,desktop,returning,West,59,True,67,2,0,False,True,True,42,1,0,8.125678213496574,25,1
user_004139,43,50k-75k,desktop,returning,South,38,True,54,3,0,False,False,True,25,4,0,5.8786120177785826,29,-1
user_004140,34,75k-100k,desktop,returning,West,77,True,93,3,0,False,True,True,84,6,0,7.910235811179467,9,-3
user_004141,18,75k-100k,mobile,new,East,55,True,117,6,0,False,True,True,103,9,0,5.931172542250505,14,-3
user_004142,29,50k-75k,desktop,returning,East,49,True,85,1,0,False,False,True,121,1,0,6.774825681883139,-36,0
user_004143,41,75k-100k,desktop,returning,Midwest,65,True,87,1,0,True,False,False,0,0,0,,87,1
user_004144,40,50k-75k,desktop,new,East,51,True,143,1,0,False,True,True,103,1,0,9.885911892981452,40,0
user_004145,45,50k-75k,desktop,returning,South,17,True,129,2,0,True,False,True,148,4,0,5.96020828691353,-19,-2
user_004146,52,<30k,mobile,returning,West,58,True,32,5,0,True,True,True,34,4,0,7.9771189509326845,-2,1
user_004147,18,100k-150k,desktop,new,East,76,True,83,5,0,True,True,True,114,4,0,7.201106508407694,-31,1
user_004148,50,100k-150k,desktop,new,East,60,False,0,0,0,True,False,True,134,1,0,8.612967530249046,-134,-1
user_004149,50,75k-100k,desktop,returning,Midwest,68,True,145,4,0,True,True,True,156,1,0,7.08202132195802,-11,3
user_004150,42,100k-150k,tablet,returning,Midwest,70,True,117,2,0,True,True,True,138,1,0,5.936549239008354,-21,1
user_004151,27,100k-150k,desktop,returning,South,75,True,76,2,0,True,True,True,72,4,1,8.305334198018892,4,-2
user_004152,75,30k-50k,desktop,new,East,53,True,103,5,0,True,False,True,88,6,1,6.676145967785959,15,-1
user_004153,37,100k-150k,desktop,returning,Midwest,70,True,30,3,0,False,False,True,43,2,0,7.174327721367744,-13,1
user_004154,18,30k-50k,desktop,returning,Midwest,56,True,80,1,0,False,True,True,75,1,0,8.573006237117951,5,0
user_004155,77,50k-75k,mobile,returning,East,44,False,0,0,0,False,False,True,168,1,0,6.535245844143956,-168,-1
user_004156,35,>150k,desktop,returning,Midwest,62,True,30,4,0,True,True,True,20,3,0,8.196690369029225,10,1
user_004157,60,<30k,desktop,returning,South,21,True,123,4,2,False,False,True,135,5,0,4.908486398898742,-12,-1
user_004158,28,>150k,mobile,returning,Midwest,66,True,77,4,0,False,True,True,63,3,0,7.196636229901013,14,1
user_004159,68,100k-150k,tablet,returning,East,15,True,203,6,0,True,True,True,202,3,0,7.486809098175919,1,3
user_004160,56,50k-75k,desktop,new,South,46,True,155,2,0,False,False,True,136,1,0,7.455473860231132,19,1
user_004161,46,100k-150k,mobile,new,South,48,True,127,3,0,False,True,True,81,1,0,8.142652469246054,46,2
user_004162,32,30k-50k,desktop,returning,South,41,True,103,1,0,False,True,False,0,0,0,,103,1
user_004163,38,100k-150k,mobile,returning,East,70,True,99,2,0,True,True,True,52,2,0,5.635267669101371,47,0
user_004164,45,50k-75k,desktop,returning,West,88,True,150,2,0,True,True,True,130,4,0,9.164250282513747,20,-2
user_004165,68,<30k,desktop,returning,West,44,False,0,0,0,True,False,False,0,0,0,,0,0
user_004166,49,<30k,mobile,returning,South,30,True,121,6,0,False,False,True,132,9,1,4.526535046160826,-11,-3
user_004167,44,75k-100k,mobile,returning,South,22,True,139,5,0,False,False,True,120,6,0,8.646689113699615,19,-1
user_004168,37,75k-100k,mobile,new,West,56,True,75,1,0,False,False,True,49,1,0,6.7130603215530416,26,0
user_004169,30,100k-150k,tablet,new,East,60,True,167,4,0,False,False,True,183,1,1,6.459887948364477,-16,3
user_004170,49,100k-150k,mobile,returning,West,60,True,95,1,1,False,True,True,69,1,0,9.177015723616242,26,0
user_004171,43,>150k,mobile,returning,South,57,True,73,4,0,False,True,True,80,2,0,8.1300547139039,-7,2
user_004172,18,30k-50k,desktop,new,West,95,True,95,1,0,True,True,True,80,1,0,6.447238306773826,15,0
user_004173,28,50k-75k,mobile,returning,Midwest,58,True,144,4,0,True,True,True,142,1,0,8.752166717329544,2,3
user_004174,55,50k-75k,desktop,new,West,44,True,72,5,0,False,False,False,0,0,0,,72,5
user_004175,32,>150k,mobile,new,West,69,True,149,3,0,False,True,True,134,1,0,8.125466414761302,15,2
user_004176,45,100k-150k,mobile,returning,East,85,True,88,3,0,True,True,True,107,3,0,10.0,-19,0
user_004177,64,<30k,desktop,new,Midwest,23,True,116,6,0,True,False,True,91,9,0,8.49445428047808,25,-3
user_004178,60,>150k,desktop,new,Midwest,61,False,0,0,0,True,True,True,119,3,0,9.44613805262294,-119,-3
user_004179,44,100k-150k,mobile,new,Midwest,69,True,109,4,0,False,True,False,0,0,0,,109,4
user_004180,48,>150k,desktop,returning,South,69,False,0,0,0,False,True,True,88,1,0,8.261015050440529,-88,-1
user_004181,40,30k-50k,desktop,returning,West,71,True,65,3,0,False,True,True,20,2,0,8.854279171719426,45,1
user_004182,45,75k-100k,mobile,returning,South,33,True,121,4,1,False,True,False,0,0,0,,121,4
user_004183,66,100k-150k,desktop,new,West,58,True,126,2,0,False,False,True,135,2,1,5.196734683193974,-9,0
user_004184,67,50k-75k,mobile,returning,South,41,True,85,3,0,False,False,True,123,1,1,5.979800714592081,-38,2
user_004185,50,30k-50k,mobile,new,East,23,False,0,0,0,False,False,False,0,0,0,,0,0
user_004186,47,75k-100k,desktop,new,South,37,True,166,5,0,False,False,True,190,6,0,6.615905456150335,-24,-1
user_004187,55,50k-75k,mobile,new,West,60,True,145,1,0,True,True,True,157,2,0,7.656031299235123,-12,-1
user_004188,40,75k-100k,desktop,new,Midwest,29,True,227,4,2,True,True,True,151,3,0,9.404508168259705,76,1
user_004189,39,<30k,mobile,new,East,55,False,0,0,0,False,False,False,0,0,0,,0,0
user_004190,59,100k-150k,desktop,returning,West,82,True,109,2,1,False,True,True,114,3,0,7.2735121071197995,-5,-1
user_004191,31,50k-75k,mobile,returning,South,41,True,88,7,0,True,True,True,78,8,0,9.644111096719579,10,-1
user_004192,45,<30k,desktop,new,East,53,True,152,2,0,False,False,True,166,1,0,8.006195824355709,-14,1
user_004193,20,50k-75k,mobile,returning,South,70,False,0,0,0,True,True,True,67,1,0,8.801554971957541,-67,-1
user_004194,52,<30k,mobile,returning,West,85,False,0,0,0,False,True,True,101,1,0,10.0,-101,-1
user_004195,50,75k-100k,mobile,returning,East,48,True,122,2,0,False,True,True,139,2,1,8.328422454370898,-17,0
user_004196,32,30k-50k,desktop,new,East,71,False,0,0,0,False,True,True,105,2,0,10.0,-105,-2
user_004197,59,75k-100k,desktop,returning,West,25,True,122,3,0,False,True,True,113,2,0,7.6822087867906514,9,1
user_004198,51,<30k,desktop,new,East,48,True,123,2,0,False,False,True,124,1,0,7.2897681050736525,-1,1
user_004199,22,75k-100k,desktop,returning,East,95,True,63,2,0,True,True,True,57,2,0,7.787522287847451,6,0
user_004200,40,100k-150k,mobile,new,West,64,True,139,3,0,False,True,True,101,3,0,7.307784943754343,38,0
user_004201,80,100k-150k,desktop,new,South,62,True,95,6,0,True,True,True,87,5,0,8.338951880632141,8,1
user_004202,61,50k-75k,desktop,new,West,30,False,0,0,0,False,True,True,90,1,0,8.528131770809805,-90,-1
user_004203,28,75k-100k,mobile,new,Midwest,86,False,0,0,0,False,False,False,0,0,0,,0,0
user_004204,25,100k-150k,tablet,new,Midwest,74,True,73,1,0,True,True,True,52,1,0,8.67800906912158,21,0
user_004205,61,75k-100k,desktop,new,West,22,False,0,0,0,True,False,True,138,1,0,6.7626204001122305,-138,-1
user_004206,80,75k-100k,desktop,returning,South,39,True,166,5,0,False,False,True,179,4,1,7.620193693568653,-13,1
user_004207,47,50k-75k,desktop,new,East,46,True,105,3,0,True,True,True,69,2,0,8.72096962472068,36,1
user_004208,40,50k-75k,mobile,returning,South,55,True,110,3,0,True,False,True,125,6,1,8.722866943807679,-15,-3
user_004209,64,<30k,mobile,returning,West,37,True,76,3,0,False,True,True,66,1,0,9.604121754422623,10,2
user_004210,43,50k-75k,mobile,new,South,35,False,0,0,0,False,True,True,102,1,0,7.484260630445756,-102,-1
user_004211,58,30k-50k,desktop,new,East,31,True,138,2,0,False,False,False,0,0,0,,138,2
user_004212,71,30k-50k,desktop,new,South,49,True,148,1,3,True,True,True,143,1,0,8.497656562165973,5,0
user_004213,43,50k-75k,mobile,new,Midwest,51,True,145,2,1,True,True,True,91,1,0,9.875633524134118,54,1
user_004214,34,100k-150k,mobile,returning,East,51,True,49,8,0,True,True,True,21,5,0,10.0,28,3
user_004215,56,75k-100k,desktop,returning,East,5,True,136,4,0,True,False,True,151,5,0,7.631117587857337,-15,-1
user_004216,36,50k-75k,desktop,returning,West,64,True,107,3,0,False,False,True,148,1,1,8.546441494915111,-41,2
user_004217,60,75k-100k,desktop,returning,Midwest,35,True,85,7,0,False,False,True,109,5,0,7.440574820287128,-24,2
user_004218,59,50k-75k,mobile,returning,Midwest,26,True,150,5,0,False,False,True,173,1,0,6.001866646854547,-23,4
user_004219,29,50k-75k,mobile,new,East,80,True,125,2,0,False,True,True,77,1,0,5.0839215708739145,48,1
user_004220,48,>150k,mobile,returning,West,79,True,103,1,1,True,True,True,98,1,0,6.689062673752075,5,0
user_004221,53,30k-50k,desktop,new,Midwest,56,True,103,2,0,True,True,True,82,2,0,6.464882225884,21,0
user_004222,59,100k-150k,desktop,returning,West,38,True,84,7,0,False,True,True,47,2,0,7.837508884021543,37,5
user_004223,43,75k-100k,desktop,new,South,52,True,150,1,0,False,True,True,85,2,0,6.410276032688763,65,-1
user_004224,72,30k-50k,mobile,new,Midwest,37,True,153,5,0,True,False,True,169,2,0,6.110206970491146,-16,3
user_004225,69,30k-50k,desktop,returning,South,25,True,131,4,0,False,False,False,0,0,0,,131,4
user_004226,64,30k-50k,mobile,new,East,54,True,82,1,0,True,True,True,64,1,0,6.899732386099724,18,0
user_004227,69,<30k,mobile,returning,East,15,True,81,3,0,False,True,True,33,1,0,6.804902720350305,48,2
user_004228,43,<30k,mobile,new,West,56,True,110,5,1,True,True,False,0,0,0,,110,5
user_004229,47,50k-75k,desktop,new,West,62,True,116,6,0,True,False,True,120,6,1,9.65893668101131,-4,0
user_004230,39,50k-75k,mobile,returning,East,42,True,78,2,0,False,False,True,101,2,0,5.748221271711407,-23,0
user_004231,33,50k-75k,mobile,returning,Midwest,65,True,162,6,0,False,False,True,144,7,0,9.134508160955459,18,-1
user_004232,27,50k-75k,desktop,new,West,72,True,134,1,0,True,True,True,91,1,0,8.675798807667938,43,0
user_004233,30,100k-150k,desktop,new,Midwest,75,False,0,0,0,False,True,True,107,1,0,10.0,-107,-1
user_004234,35,30k-50k,desktop,new,East,41,False,0,0,0,False,False,True,109,1,1,5.969102643004271,-109,-1
user_004235,40,75k-100k,desktop,returning,Midwest,27,False,0,0,0,False,False,False,0,0,0,,0,0
user_004236,56,50k-75k,mobile,new,West,45,True,113,2,0,True,True,False,0,0,0,,113,2
user_004237,33,50k-75k,mobile,returning,East,52,True,59,2,0,False,True,True,36,4,0,9.15535438072143,23,-2
user_004238,33,75k-100k,desktop,returning,East,64,True,35,2,1,False,False,True,25,2,0,6.064059587107003,10,0
user_004239,51,100k-150k,desktop,new,Midwest,59,False,0,0,0,False,False,True,125,3,0,6.531330279847929,-125,-3
user_004240,53,100k-150k,mobile,returning,East,51,True,120,3,0,False,True,True,96,6,0,8.685581425917492,24,-3
user_004241,39,50k-75k,mobile,returning,Midwest,30,True,94,11,0,False,True,True,60,14,0,7.963787040973001,34,-3
user_004242,79,50k-75k,mobile,returning,West,53,False,0,0,0,True,True,True,92,1,0,6.887532019917261,-92,-1
user_004243,35,50k-75k,mobile,returning,West,47,True,122,3,0,False,True,True,90,4,0,7.149099046977326,32,-1
user_004244,52,100k-150k,mobile,returning,Midwest,30,True,76,3,2,True,True,True,67,4,0,8.071155675862508,9,-1
user_004245,45,50k-75k,mobile,returning,Midwest,45,True,109,1,0,True,False,True,110,1,0,9.041845103817069,-1,0
user_004246,46,<30k,mobile,new,South,51,True,85,4,0,False,True,True,56,8,0,8.045700455921256,29,-4
user_004247,43,<30k,mobile,returning,South,34,False,0,0,0,False,False,True,102,1,0,6.203151984742614,-102,-1
user_004248,27,100k-150k,desktop,returning,East,75,True,33,3,0,True,True,True,22,2,0,7.961406488461414,11,1
user_004249,49,75k-100k,desktop,returning,East,85,True,124,1,0,True,True,True,111,2,0,7.38727094313942,13,-1
user_004250,50,50k-75k,desktop,returning,East,44,False,0,0,0,False,False,False,0,0,0,,0,0
user_004251,67,50k-75k,mobile,returning,East,44,True,84,5,0,False,False,True,64,7,0,8.532639769136741,20,-2
user_004252,58,<30k,desktop,returning,East,28,False,0,0,0,False,False,True,88,1,0,7.076090535498719,-88,-1
user_004253,50,30k-50k,mobile,returning,South,59,True,114,3,0,False,True,True,78,2,0,8.54859112781896,36,1
user_004254,36,100k-150k,desktop,new,South,49,False,0,0,0,True,True,True,92,1,0,8.864214078755518,-92,-1
user_004255,68,50k-75k,mobile,new,West,42,True,84,2,0,False,True,False,0,0,0,,84,2
user_004256,41,100k-150k,desktop,returning,Midwest,58,True,120,4,0,False,True,True,56,3,0,7.883750023944894,64,1
user_004257,47,75k-100k,desktop,returning,Midwest,42,True,131,1,0,False,True,True,110,1,0,7.3849309391766536,21,0
user_004258,41,75k-100k,desktop,returning,East,45,True,114,2,0,False,False,True,112,2,1,6.629844229005501,2,0
user_004259,33,50k-75k,desktop,returning,Midwest,70,False,0,0,0,True,True,True,98,1,0,8.657556336774963,-98,-1
user_004260,51,100k-150k,desktop,returning,Midwest,47,True,101,3,0,True,True,True,116,5,1,7.742081271100276,-15,-2
user_004261,39,<30k,mobile,returning,Midwest,68,True,69,4,0,True,True,True,20,4,0,7.6455988933307095,49,0
user_004262,54,75k-100k,desktop,returning,South,59,True,92,2,0,False,True,True,85,4,0,7.038874816373996,7,-2
user_004263,51,50k-75k,mobile,new,South,63,False,0,0,0,False,False,False,0,0,0,,0,0
user_004264,56,50k-75k,mobile,new,East,34,True,155,3,0,False,False,True,122,4,0,8.879299455528885,33,-1
user_004265,42,<30k,desktop,returning,South,51,True,57,5,0,False,True,True,77,5,0,7.447376523177901,-20,0
user_004266,54,>150k,desktop,new,Midwest,41,True,148,4,0,False,True,True,117,3,0,8.30722701285158,31,1
user_004267,42,100k-150k,desktop,new,East,59,True,167,2,0,True,True,True,169,1,0,8.756099351934504,-2,1
user_004268,42,<30k,desktop,returning,South,27,True,121,6,0,False,False,True,106,4,0,4.573677731352425,15,2
user_004269,57,30k-50k,mobile,returning,East,39,True,114,9,1,False,True,True,95,4,0,5.408668563029794,19,5
user_004270,39,50k-75k,desktop,new,South,38,True,126,4,0,False,True,True,57,2,0,8.708157766810887,69,2
user_004271,37,<30k,mobile,returning,South,53,True,97,6,0,True,False,True,89,8,0,6.935066905983136,8,-2
user_004272,72,50k-75k,desktop,returning,Midwest,41,True,62,2,0,True,True,True,62,1,0,6.771428070743743,0,1
user_004273,40,75k-100k,mobile,new,Midwest,61,True,123,5,0,True,True,True,85,4,0,7.789764598606453,38,1
user_004274,42,>150k,mobile,returning,East,70,True,33,6,0,True,True,True,30,5,0,9.84675291743598,3,1
user_004275,59,50k-75k,mobile,returning,South,21,True,136,4,0,True,False,False,0,0,0,,136,4
user_004276,50,100k-150k,mobile,returning,East,47,True,159,2,0,True,True,True,136,2,0,8.23228237378296,23,0
user_004277,31,75k-100k,mobile,new,South,79,True,94,1,0,False,True,True,95,3,0,8.925101951951643,-1,-2
user_004278,23,50k-75k,mobile,new,East,71,False,0,0,0,False,True,False,0,0,0,,0,0
user_004279,24,75k-100k,mobile,returning,East,64,True,99,2,1,True,True,True,92,2,0,7.1708120622317235,7,0
user_004280,24,75k-100k,mobile,new,West,78,False,0,0,0,False,True,True,99,1,0,8.92534627593547,-99,-1
user_004281,67,50k-75k,mobile,returning,South,32,True,54,4,0,False,True,True,35,3,0,5.802764019210017,19,1
user_004282,41,75k-100k,desktop,new,South,57,False,0,0,0,False,False,True,140,1,0,7.756365111965058,-140,-1
user_004283,35,30k-50k,tablet,returning,East,64,True,52,2,0,True,True,True,20,1,0,6.739575924205723,32,1
user_004284,65,30k-50k,desktop,returning,South,27,False,0,0,0,True,True,True,122,1,0,5.769853247929338,-122,-1
user_004285,39,30k-50k,desktop,new,East,57,True,111,4,0,False,True,True,78,3,0,8.885458074652336,33,1
user_004286,32,100k-150k,mobile,new,West,100,True,102,4,0,False,True,True,88,3,0,9.325852778602425,14,1
user_004287,53,75k-100k,desktop,new,East,48,True,94,2,0,False,True,True,98,1,0,7.135632726358337,-4,1
user_004288,52,30k-50k,mobile,returning,Midwest,48,True,50,2,0,True,True,True,29,1,1,6.258918517114389,21,1
user_004289,41,100k-150k,mobile,returning,Midwest,69,True,35,1,0,True,True,True,20,1,0,8.07891159998245,15,0
user_004290,33,50k-75k,desktop,returning,East,52,True,64,3,0,True,True,True,37,1,0,6.7755839351299985,27,2
user_004291,40,50k-75k,desktop,returning,South,44,True,165,1,0,True,False,True,125,2,0,7.508053655366131,40,-1
user_004292,55,75k-100k,mobile,returning,Midwest,44,True,71,3,0,False,True,True,101,1,0,9.529964151147846,-30,2
user_004293,31,<30k,desktop,returning,Midwest,45,True,110,2,0,False,False,True,83,2,0,5.9646704023617785,27,0
user_004294,52,30k-50k,desktop,new,East,27,True,154,1,0,False,True,True,102,2,0,8.241490160821199,52,-1
user_004295,49,75k-100k,mobile,returning,South,37,True,85,2,0,False,False,True,111,1,0,6.603037640454741,-26,1
user_004296,45,30k-50k,mobile,returning,West,45,True,97,1,0,False,False,True,96,1,0,9.432121550382787,1,0
user_004297,44,50k-75k,desktop,new,South,54,True,152,1,0,False,False,True,180,1,0,5.6745086059352685,-28,0
user_004298,54,75k-100k,desktop,new,East,31,True,78,4,0,False,False,True,109,6,0,5.623183192423125,-31,-2
user_004299,52,30k-50k,desktop,new,South,58,True,171,2,0,False,False,True,154,3,0,7.906805171672011,17,-1
user_004300,47,<30k,mobile,returning,West,32,True,39,5,1,False,False,True,51,1,0,4.3019375366368475,-12,4
user_004301,46,30k-50k,mobile,returning,East,32,True,81,3,0,False,True,True,78,1,0,9.206105304334672,3,2
user_004302,18,50k-75k,desktop,new,Midwest,44,True,122,2,0,True,True,True,107,1,0,9.76015915168493,15,1
user_004303,50,30k-50k,mobile,returning,East,52,True,120,4,0,True,True,False,0,0,0,,120,4
user_004304,61,50k-75k,mobile,new,South,48,True,158,1,0,False,False,True,150,1,0,6.826997928081568,8,0
user_004305,24,50k-75k,desktop,returning,East,99,True,90,1,0,True,True,True,82,1,0,9.197159717574126,8,0
user_004306,26,<30k,desktop,new,East,40,True,42,4,1,False,True,True,37,4,1,7.257096052284087,5,0
user_004307,24,50k-75k,tablet,returning,West,88,False,0,0,0,False,True,True,121,1,0,8.320955678451162,-121,-1
user_004308,25,<30k,mobile,new,East,55,True,70,6,0,True,True,True,39,4,0,7.613185618260842,31,2
user_004309,37,75k-100k,mobile,returning,Midwest,17,True,163,4,1,False,False,False,0,0,0,,163,4
user_004310,49,30k-50k,desktop,returning,West,52,True,114,1,0,False,False,True,105,2,0,6.261551001593648,9,-1
user_004311,30,30k-50k,mobile,returning,South,50,True,99,2,0,True,True,True,108,2,0,8.819826525700812,-9,0
user_004312,32,100k-150k,mobile,returning,South,73,True,34,2,1,True,True,True,32,2,0,7.7785257033783255,2,0
user_004313,38,100k-150k,tablet,new,Midwest,68,True,88,5,0,True,False,True,69,5,0,7.481921680268636,19,0
user_004314,38,30k-50k,mobile,returning,South,25,True,138,7,0,False,True,True,149,5,0,10.0,-11,2
user_004315,44,75k-100k,desktop,returning,Midwest,31,True,91,4,0,False,False,True,101,4,1,7.530866711107635,-10,0
user_004316,80,>150k,mobile,returning,East,69,False,0,0,0,True,True,True,120,1,0,6.17694666478472,-120,-1
user_004317,56,50k-75k,desktop,returning,East,26,True,159,4,1,True,True,True,166,3,0,7.371839607512627,-7,1
user_004318,34,30k-50k,mobile,new,South,60,True,87,2,0,False,True,True,94,4,0,8.056177844847102,-7,-2
user_004319,46,<30k,mobile,new,East,17,True,142,5,1,False,True,False,0,0,0,,142,5
user_004320,20,<30k,mobile,returning,West,57,True,97,3,0,True,True,True,59,5,0,8.662003982278176,38,-2
user_004321,37,30k-50k,desktop,returning,Midwest,33,False,0,0,0,False,False,False,0,0,0,,0,0
user_004322,42,30k-50k,desktop,returning,East,51,True,128,4,0,True,True,True,107,2,0,9.330452138294602,21,2
user_004323,22,>150k,mobile,returning,East,67,True,85,7,0,False,True,True,54,2,0,7.130605109119365,31,5
user_004324,26,>150k,tablet,new,Midwest,81,True,75,1,0,True,True,True,61,1,1,9.207918184042484,14,0
user_004325,34,30k-50k,tablet,returning,West,67,True,108,2,1,False,True,True,101,1,0,8.41014968255968,7,1
user_004326,37,50k-75k,mobile,returning,West,56,False,0,0,0,False,True,True,121,2,0,10.0,-121,-2
user_004327,18,100k-150k,mobile,returning,East,81,False,0,0,0,True,True,True,126,1,0,7.504555841706222,-126,-1
user_004328,29,75k-100k,desktop,new,West,88,True,129,5,0,False,True,True,109,5,0,7.715948049652332,20,0
user_004329,49,75k-100k,mobile,returning,East,37,True,145,6,0,False,False,True,158,3,0,7.292397792403334,-13,3
user_004330,34,50k-75k,mobile,returning,East,74,True,53,4,1,True,True,True,97,2,0,6.473031872624575,-44,2
user_004331,58,100k-150k,mobile,returning,East,64,True,54,2,0,False,True,True,28,1,0,8.028082494839232,26,1
user_004332,38,50k-75k,mobile,new,East,36,True,137,5,0,False,False,True,151,2,0,7.014268295719797,-14,3
user_004333,39,75k-100k,desktop,new,West,58,False,0,0,0,True,False,True,110,3,0,7.950582566199305,-110,-3
user_004334,18,75k-100k,desktop,new,Midwest,84,True,54,2,0,True,True,True,47,1,0,10.0,7,1
user_004335,54,75k-100k,mobile,returning,East,28,True,98,3,0,True,True,True,78,3,0,6.845025303825083,20,0
user_004336,31,75k-100k,tablet,returning,West,74,False,0,0,0,False,True,True,77,1,0,7.898642363488319,-77,-1
user_004337,48,100k-150k,desktop,returning,West,59,True,66,3,1,True,True,True,69,2,2,6.595920940864674,-3,1
user_004338,45,50k-75k,desktop,new,East,46,True,97,2,0,False,False,True,57,1,0,7.048965566308893,40,1
user_004339,51,50k-75k,desktop,returning,East,46,True,64,1,0,False,False,True,82,1,1,8.523769095083154,-18,0
user_004340,23,<30k,mobile,returning,Midwest,57,True,65,6,0,False,True,True,29,13,0,6.867622879772875,36,-7
user_004341,69,100k-150k,mobile,new,West,78,True,66,1,0,False,True,True,80,3,0,9.17124658411631,-14,-2
user_004342,18,>150k,mobile,new,Midwest,97,True,119,2,0,True,True,True,53,2,1,7.793779233430238,66,0
user_004343,34,<30k,desktop,new,East,43,False,0,0,0,False,False,False,0,0,0,,0,0
user_004344,49,50k-75k,mobile,returning,South,45,True,30,4,0,False,True,True,43,4,0,7.094830462084557,-13,0
user_004345,25,>150k,mobile,returning,South,87,True,76,5,0,True,True,True,53,2,0,7.119500670942719,23,3
user_004346,39,75k-100k,mobile,new,West,70,True,106,1,0,True,True,True,94,1,0,8.104456905734807,12,0
user_004347,73,<30k,mobile,returning,South,0,False,0,0,0,True,False,True,138,1,0,8.080206621389312,-138,-1
user_004348,55,30k-50k,mobile,returning,East,41,True,157,3,0,True,True,True,107,2,0,9.763315266729084,50,1
user_004349,40,100k-150k,mobile,returning,Midwest,34,True,107,3,0,False,True,True,78,4,0,6.776176015545025,29,-1
user_004350,38,30k-50k,mobile,new,Midwest,61,True,135,1,0,True,True,True,110,1,0,9.35436029195691,25,0
user_004351,58,30k-50k,desktop,returning,South,3,True,136,1,0,True,False,True,104,1,0,5.389958536177714,32,0
user_004352,59,50k-75k,desktop,new,East,32,False,0,0,0,False,False,True,144,3,0,8.636522423399766,-144,-3
user_004353,72,50k-75k,tablet,new,East,13,True,133,2,0,True,False,True,128,1,1,7.103319311967866,5,1
user_004354,42,100k-150k,desktop,returning,Midwest,67,True,86,2,0,True,True,True,52,2,0,8.100693478266502,34,0
user_004355,29,100k-150k,desktop,returning,Midwest,74,True,96,1,0,True,True,False,0,0,0,,96,1
user_004356,20,50k-75k,mobile,returning,South,80,True,48,4,1,False,True,True,36,3,0,8.464596965485798,12,1
user_004357,42,50k-75k,mobile,new,West,63,True,125,4,0,False,True,True,131,1,0,7.967480268679233,-6,3
user_004358,71,50k-75k,tablet,returning,West,45,False,0,0,0,True,False,True,141,1,0,8.732275636046339,-141,-1
user_004359,76,75k-100k,desktop,returning,West,37,False,0,0,0,False,False,True,111,1,1,6.511122239520331,-111,-1
user_004360,37,75k-100k,mobile,new,South,33,True,129,7,0,False,False,True,151,7,0,8.172683062946005,-22,0
user_004361,22,75k-100k,mobile,new,East,100,False,0,0,0,True,True,False,0,0,0,,0,0
user_004362,66,100k-150k,mobile,returning,West,50,True,62,3,0,False,False,True,48,5,0,8.028476837841561,14,-2
user_004363,75,30k-50k,desktop,new,West,49,True,199,3,1,True,False,True,214,3,0,5.0474813567292856,-15,0
user_004364,37,<30k,desktop,new,West,43,False,0,0,0,True,True,True,34,1,0,6.505652213941863,-34,-1
user_004365,42,<30k,desktop,returning,East,47,True,144,3,0,False,True,True,140,1,1,7.969505187053083,4,2
user_004366,47,30k-50k,mobile,new,East,22,False,0,0,0,False,False,True,152,1,0,7.1555628400199875,-152,-1
user_004367,46,75k-100k,desktop,returning,West,44,True,105,4,0,False,False,True,98,5,0,7.374221995969917,7,-1
user_004368,33,30k-50k,mobile,returning,East,86,True,99,2,0,True,True,True,35,2,0,7.096321655154544,64,0
user_004369,71,>150k,desktop,new,East,58,True,123,2,1,False,True,True,117,1,0,5.36348572025979,6,1
user_004370,42,50k-75k,desktop,returning,East,55,True,121,1,0,True,True,True,93,1,0,8.460639722459698,28,0
user_004371,54,<30k,mobile,returning,Midwest,43,True,108,2,0,False,True,True,94,3,0,5.906209238064231,14,-1
user_004372,18,100k-150k,desktop,new,West,100,True,68,3,0,True,True,True,35,2,0,9.295235992925573,33,1
user_004373,53,50k-75k,desktop,returning,West,43,True,112,1,0,False,True,True,101,1,0,7.221833354666523,11,0
user_004374,31,50k-75k,tablet,returning,East,74,True,105,4,0,True,True,True,74,3,0,9.481879830225383,31,1
user_004375,52,50k-75k,desktop,returning,East,42,False,0,0,0,True,True,True,130,1,0,7.12431656205692,-130,-1
user_004376,28,30k-50k,desktop,returning,East,100,True,30,4,0,True,True,True,37,4,0,8.05708333823398,-7,0
user_004377,52,75k-100k,desktop,returning,East,62,True,113,4,0,True,True,True,90,1,0,8.75033137398503,23,3
user_004378,48,30k-50k,desktop,returning,West,52,True,68,3,1,True,False,True,46,1,0,7.37221596134688,22,2
user_004379,40,100k-150k,desktop,returning,West,64,True,58,1,0,True,False,True,64,1,0,6.468250051575949,-6,0
user_004380,38,100k-150k,tablet,new,South,61,True,137,1,1,False,True,True,64,1,0,6.456777628873012,73,0
user_004381,43,50k-75k,desktop,new,South,44,True,146,3,0,False,True,True,133,6,0,7.809007400136783,13,-3
user_004382,19,30k-50k,desktop,returning,South,100,True,30,4,0,True,True,True,27,2,0,8.969752671096675,3,2
user_004383,66,100k-150k,mobile,returning,West,74,False,0,0,0,True,True,True,90,1,0,9.902048027944401,-90,-1
user_004384,32,100k-150k,mobile,returning,East,81,True,117,3,0,False,True,True,91,2,0,9.455664144097097,26,1
user_004385,59,<30k,desktop,returning,East,29,True,104,4,0,True,True,True,75,4,1,7.899385990311902,29,0
user_004386,46,100k-150k,mobile,returning,East,83,True,30,1,0,True,True,True,25,1,0,8.667812791754445,5,0
user_004387,68,75k-100k,mobile,returning,Midwest,43,True,50,3,0,True,True,True,35,1,0,7.610644914466471,15,2
user_004388,49,100k-150k,desktop,new,South,46,True,98,2,1,False,True,True,56,1,0,7.747861398328899,42,1
user_004389,18,100k-150k,mobile,returning,South,80,True,78,4,1,True,True,True,62,6,0,7.938627396171899,16,-2
user_004390,33,50k-75k,tablet,new,Midwest,80,True,55,5,0,True,True,True,54,3,0,10.0,1,2
user_004391,18,>150k,desktop,returning,West,100,True,63,4,0,False,True,True,64,2,0,7.7278919925650476,-1,2
user_004392,67,50k-75k,desktop,returning,West,44,True,118,1,0,False,False,True,139,1,0,8.192632996890937,-21,0
user_004393,40,50k-75k,mobile,new,West,46,False,0,0,0,False,False,True,135,1,1,5.9938305155054925,-135,-1
user_004394,48,50k-75k,mobile,returning,South,23,False,0,0,0,False,False,True,153,1,0,6.702618970637003,-153,-1
user_004395,36,30k-50k,desktop,returning,South,54,True,72,4,0,True,True,True,84,3,0,8.08278499821282,-12,1
user_004396,42,75k-100k,mobile,returning,West,44,True,68,1,1,False,False,True,75,1,0,5.869240139104879,-7,0
user_004397,31,30k-50k,desktop,returning,East,90,True,85,1,0,False,True,True,86,1,0,7.431676856579753,-1,0
user_004398,39,50k-75k,desktop,returning,West,53,True,102,7,0,False,False,True,124,14,0,6.56165322474396,-22,-7
user_004399,49,50k-75k,mobile,returning,South,24,True,136,3,0,True,True,True,64,4,0,6.599349586295976,72,-1
user_004400,24,50k-75k,desktop,returning,South,89,True,78,1,0,True,True,True,32,1,0,7.66411251247047,46,0
user_004401,53,30k-50k,mobile,returning,East,31,True,111,2,0,True,True,True,88,1,0,7.68918654339479,23,1
user_004402,35,30k-50k,desktop,returning,East,59,True,88,2,0,True,True,True,99,5,0,6.625578822714517,-11,-3
user_004403,31,100k-150k,desktop,new,West,76,True,115,1,0,True,True,True,84,2,0,5.633771163602269,31,-1
user_004404,36,50k-75k,mobile,returning,West,55,True,85,4,0,False,True,True,44,6,0,9.411664968328328,41,-2
user_004405,48,30k-50k,desktop,returning,West,64,True,146,3,0,True,False,True,160,1,0,6.2496297594755195,-14,2
user_004406,25,75k-100k,desktop,returning,East,61,True,97,2,0,True,True,True,115,2,0,9.853606033781151,-18,0
user_004407,65,50k-75k,desktop,returning,South,14,True,133,3,1,False,False,True,144,3,0,6.969005798271531,-11,0
user_004408,44,75k-100k,desktop,returning,West,50,True,152,2,0,True,True,True,159,1,0,9.242667319472869,-7,1
user_004409,41,50k-75k,mobile,returning,Midwest,57,True,61,1,0,True,True,True,57,2,0,7.537146387511141,4,-1
user_004410,34,50k-75k,desktop,returning,South,71,True,103,2,0,True,True,True,104,2,0,8.44083188981638,-1,0
user_004411,57,<30k,desktop,returning,Midwest,0,True,90,8,0,True,True,True,64,5,0,7.945830339563671,26,3
user_004412,51,30k-50k,desktop,returning,South,22,True,157,4,1,False,False,True,166,3,0,5.579470394225277,-9,1
user_004413,42,50k-75k,desktop,returning,South,40,True,63,6,0,False,False,True,61,5,0,5.941875589544274,2,1
user_004414,39,75k-100k,mobile,new,East,51,True,58,4,0,True,True,True,50,4,0,8.012346428332151,8,0
user_004415,58,30k-50k,desktop,returning,West,24,True,131,4,0,True,False,True,141,4,0,5.845981879315517,-10,0
user_004416,42,30k-50k,desktop,returning,East,61,False,0,0,0,True,False,True,98,2,0,7.623949926504712,-98,-2
user_004417,28,30k-50k,desktop,returning,East,45,True,98,3,0,True,True,True,68,2,0,5.133471313071939,30,1
user_004418,20,30k-50k,desktop,returning,East,51,True,61,2,0,False,True,False,0,0,0,,61,2
user_004419,67,30k-50k,mobile,new,East,38,True,93,8,0,True,True,True,99,6,0,9.600722330405578,-6,2
user_004420,49,50k-75k,desktop,returning,South,58,True,116,4,0,False,True,True,112,1,0,8.625123129250717,4,3
user_004421,74,50k-75k,mobile,returning,Midwest,31,True,79,4,0,True,False,True,81,3,0,8.456448944220478,-2,1
user_004422,41,50k-75k,desktop,returning,Midwest,51,False,0,0,0,False,True,True,110,3,0,7.612639947360239,-110,-3
user_004423,28,100k-150k,mobile,returning,Midwest,100,True,30,1,0,False,True,True,36,1,0,8.449685893579899,-6,0
user_004424,54,75k-100k,desktop,new,Midwest,30,True,160,6,0,False,True,True,107,3,0,10.0,53,3
user_004425,78,<30k,desktop,returning,East,28,True,115,7,0,True,True,True,87,4,0,7.756866680144742,28,3
user_004426,39,>150k,desktop,returning,East,63,True,112,2,0,False,True,True,97,2,0,8.321132816421342,15,0
user_004427,30,50k-75k,desktop,returning,East,55,True,69,2,0,True,True,True,24,1,0,10.0,45,1
user_004428,66,<30k,desktop,returning,Midwest,23,False,0,0,0,True,True,True,72,1,0,9.438902554037627,-72,-1
user_004429,41,75k-100k,desktop,returning,East,33,True,88,3,0,False,False,True,57,3,0,5.277637992182625,31,0
user_004430,18,75k-100k,mobile,returning,Midwest,56,True,112,3,1,False,True,True,86,2,0,10.0,26,1
user_004431,55,50k-75k,mobile,new,East,74,True,92,3,0,True,True,True,64,4,0,9.696611826386235,28,-1
user_004432,69,50k-75k,desktop,returning,East,47,True,72,1,0,False,True,True,35,1,0,7.651575720049416,37,0
user_004433,40,50k-75k,desktop,returning,West,69,True,46,2,0,True,True,True,27,2,0,8.433996358614278,19,0
user_004434,52,<30k,mobile,returning,Midwest,38,True,70,2,0,True,False,True,59,1,0,6.6132820709360844,11,1
user_004435,48,30k-50k,desktop,returning,South,43,True,46,3,0,False,True,True,27,2,0,10.0,19,1
user_004436,47,<30k,desktop,returning,South,24,True,125,2,0,True,True,True,53,3,0,10.0,72,-1
user_004437,54,75k-100k,desktop,returning,West,68,True,91,1,0,False,True,True,85,1,0,7.610711429111026,6,0
user_004438,52,>150k,mobile,new,West,76,True,102,2,0,True,True,True,81,1,0,6.388249336049009,21,1
user_004439,56,<30k,mobile,returning,Midwest,11,True,84,1,0,True,True,True,41,2,0,8.786178382906693,43,-1
user_004440,29,<30k,desktop,new,West,61,True,56,2,0,True,False,True,36,2,0,8.783995088156779,20,0
user_004441,41,50k-75k,desktop,returning,Midwest,43,True,89,3,0,True,False,True,67,2,0,8.857195019030431,22,1
user_004442,27,>150k,desktop,new,East,92,True,117,4,1,False,True,True,102,4,0,7.08663710690543,15,0
user_004443,33,50k-75k,desktop,new,West,96,True,96,2,0,False,True,True,94,2,0,9.382552540024463,2,0
user_004444,50,30k-50k,desktop,returning,East,61,False,0,0,0,False,False,True,133,1,0,5.37491952299834,-133,-1
user_004445,76,30k-50k,mobile,returning,West,38,True,96,4,0,False,False,True,124,6,0,7.785347316852107,-28,-2
user_004446,57,50k-75k,desktop,returning,West,8,True,194,2,0,True,False,False,0,0,0,,194,2
user_004447,42,75k-100k,desktop,returning,South,41,True,127,2,0,False,True,True,106,5,0,6.296115106071936,21,-3
user_004448,36,30k-50k,mobile,returning,West,46,True,78,2,0,True,True,True,69,2,0,6.123663782699173,9,0
user_004449,38,75k-100k,desktop,returning,West,60,False,0,0,0,True,True,True,82,1,1,9.65832815395424,-82,-1
user_004450,24,30k-50k,desktop,returning,West,75,True,73,1,0,True,True,True,61,1,0,9.676984497387634,12,0
user_004451,62,50k-75k,desktop,new,South,33,True,144,3,0,False,False,True,122,4,0,7.997995476966118,22,-1
user_004452,21,75k-100k,desktop,returning,West,98,True,59,5,1,True,True,True,91,7,0,7.988652864426056,-32,-2
user_004453,56,<30k,mobile,returning,South,0,True,120,5,1,True,False,True,124,7,0,6.046877142558058,-4,-2
user_004454,38,100k-150k,mobile,new,East,34,True,121,1,0,False,True,True,105,1,1,7.036569462553594,16,0
user_004455,40,100k-150k,desktop,returning,South,55,True,94,2,1,False,False,True,105,1,1,7.936495103898966,-11,1
user_004456,53,100k-150k,desktop,new,East,72,True,103,2,0,False,True,True,88,1,0,8.473760977417934,15,1
user_004457,66,100k-150k,desktop,returning,East,58,True,142,2,0,True,True,True,109,1,0,8.541775550323457,33,1
user_004458,39,50k-75k,mobile,returning,Midwest,39,True,49,6,0,False,True,True,27,4,0,9.530414288215901,22,2
user_004459,50,30k-50k,mobile,returning,East,39,False,0,0,0,True,False,True,100,1,0,7.199166723846303,-100,-1
user_004460,54,100k-150k,mobile,new,South,57,False,0,0,0,False,True,True,83,3,0,7.440313443262757,-83,-3
user_004461,51,30k-50k,mobile,new,West,74,True,58,2,0,False,False,True,39,4,0,6.648675367189329,19,-2
user_004462,50,100k-150k,mobile,returning,Midwest,72,True,57,6,0,False,False,True,83,19,0,6.789200063847846,-26,-13
user_004463,77,100k-150k,desktop,returning,South,50,True,60,4,1,False,False,True,70,5,0,6.15495473159701,-10,-1
user_004464,44,100k-150k,mobile,returning,East,59,True,51,3,0,True,True,True,50,3,0,7.722709374065319,1,0
user_004465,56,30k-50k,desktop,new,East,59,True,104,2,0,True,True,True,49,2,0,8.272540789655658,55,0
user_004466,62,30k-50k,mobile,new,South,11,True,134,1,0,False,True,True,126,1,1,7.882851619361715,8,0
user_004467,38,50k-75k,desktop,returning,South,25,True,150,2,0,False,True,True,100,2,0,6.426200920676678,50,0
user_004468,28,<30k,mobile,returning,West,71,False,0,0,0,True,True,True,77,1,0,7.41649952127953,-77,-1
user_004469,30,<30k,mobile,returning,Midwest,60,True,110,2,0,True,True,True,88,2,0,8.93992030004838,22,0
user_004470,31,75k-100k,mobile,returning,South,58,True,59,4,0,False,False,True,66,8,0,6.98618890143598,-7,-4
user_004471,60,100k-150k,mobile,new,Midwest,54,True,126,3,0,False,False,True,139,6,0,7.379449240593064,-13,-3
user_004472,60,30k-50k,mobile,new,East,18,False,0,0,0,False,False,False,0,0,0,,0,0
user_004473,36,<30k,mobile,returning,South,33,True,82,1,0,True,False,True,126,1,0,5.381705208912032,-44,0
user_004474,44,30k-50k,desktop,new,East,39,True,118,1,0,True,True,True,78,1,0,6.013556462783746,40,0
user_004475,69,30k-50k,mobile,returning,East,38,True,92,2,0,True,True,True,73,3,0,6.973385968732643,19,-1
user_004476,52,<30k,desktop,new,East,41,True,140,8,0,False,False,True,156,12,0,8.355064108579864,-16,-4
user_004477,23,50k-75k,mobile,returning,East,68,False,0,0,0,False,True,True,127,1,0,8.043243239712993,-127,-1
user_004478,21,50k-75k,mobile,returning,Midwest,79,True,81,4,1,True,True,True,32,5,0,9.648828960821842,49,-1
user_004479,55,<30k,desktop,returning,South,20,True,123,5,0,True,False,True,112,6,0,9.05295321320639,11,-1
user_004480,35,100k-150k,mobile,new,West,89,True,96,1,0,False,True,True,109,1,0,6.55959808839401,-13,0
user_004481,45,50k-75k,desktop,returning,East,46,True,110,1,0,False,True,True,104,2,0,6.8460181776281175,6,-1
user_004482,63,<30k,desktop,new,Midwest,43,True,144,1,1,False,True,True,134,1,0,9.095686042169406,10,0
user_004483,51,30k-50k,mobile,returning,West,42,True,113,2,0,False,False,True,81,1,0,6.896864138042255,32,1
user_004484,47,100k-150k,mobile,returning,Midwest,50,True,127,3,0,False,True,True,78,5,0,4.041835697925093,49,-2
user_004485,42,100k-150k,tablet,new,Midwest,59,True,155,2,0,False,False,True,197,2,0,8.755609722665945,-42,0
user_004486,43,75k-100k,mobile,returning,East,16,True,98,4,1,True,True,True,87,5,0,7.282881333673355,11,-1
user_004487,38,50k-75k,desktop,new,Midwest,52,False,0,0,0,False,False,True,151,2,0,6.404784345484247,-151,-2
user_004488,41,50k-75k,desktop,returning,East,51,True,107,2,0,False,False,True,119,1,0,8.006054067398752,-12,1
user_004489,63,50k-75k,desktop,new,East,45,True,128,2,0,True,False,True,118,1,0,3.6821585386082,10,1
user_004490,51,<30k,tablet,returning,East,16,True,162,3,0,False,False,True,158,1,0,6.375168959589367,4,2
user_004491,22,100k-150k,desktop,returning,East,73,True,65,6,0,True,True,True,78,7,0,9.331007147607588,-13,-1
user_004492,51,75k-100k,mobile,new,East,59,True,135,5,0,False,False,True,140,9,0,7.9835330539475,-5,-4
user_004493,48,30k-50k,desktop,new,West,50,True,147,2,0,True,False,True,154,1,0,7.699922119251543,-7,1
user_004494,52,75k-100k,desktop,returning,South,26,True,180,4,0,False,False,True,196,3,0,8.54568945843739,-16,1
user_004495,63,50k-75k,desktop,new,West,57,True,126,4,0,False,False,True,112,3,0,6.9665790775729635,14,1
user_004496,43,30k-50k,desktop,new,South,36,True,117,2,0,True,True,True,101,1,0,8.015787892875764,16,1
user_004497,38,<30k,desktop,returning,East,41,True,143,3,1,False,True,True,134,2,0,8.285261470949415,9,1
user_004498,63,50k-75k,mobile,new,Midwest,44,False,0,0,0,False,True,True,114,3,0,8.193200714378474,-114,-3
user_004499,63,100k-150k,desktop,returning,East,35,True,57,4,0,False,True,True,45,5,0,7.243196297414023,12,-1
user_004500,59,50k-75k,desktop,new,East,26,True,161,3,1,True,False,True,198,5,0,7.398739270379058,-37,-2
user_004501,50,<30k,desktop,returning,West,11,False,0,0,0,True,False,False,0,0,0,,0,0
user_004502,66,<30k,desktop,returning,South,64,True,93,6,0,True,True,True,84,6,0,8.109962572521642,9,0
user_004503,46,30k-50k,tablet,new,East,46,True,96,1,0,False,False,True,114,1,0,5.390821577827592,-18,0
user_004504,55,50k-75k,desktop,new,South,48,True,105,1,0,True,True,True,91,1,0,7.807654335437993,14,0
user_004505,43,30k-50k,desktop,returning,South,35,True,143,6,0,False,True,True,98,2,0,9.253154063052259,45,4
user_004506,33,30k-50k,mobile,new,South,69,True,132,4,0,False,False,False,0,0,0,,132,4
user_004507,72,50k-75k,mobile,returning,East,22,True,133,4,0,False,False,True,122,6,0,7.943586919318195,11,-2
user_004508,72,75k-100k,mobile,returning,South,7,True,132,7,1,False,False,True,118,5,1,6.5362645618644,14,2
user_004509,28,30k-50k,mobile,returning,Midwest,86,True,100,3,0,True,True,True,91,5,1,6.6487462573074305,9,-2
user_004510,43,75k-100k,mobile,returning,West,55,True,148,2,0,True,True,True,120,3,0,7.656163098172851,28,-1
user_004511,65,30k-50k,desktop,returning,West,44,True,96,2,0,True,True,True,85,3,0,7.431996483216347,11,-1
user_004512,33,100k-150k,desktop,new,Midwest,69,False,0,0,0,False,True,True,68,1,0,10.0,-68,-1
user_004513,51,50k-75k,desktop,new,West,65,False,0,0,0,True,False,True,133,1,0,8.49490758779757,-133,-1
user_004514,18,75k-100k,mobile,returning,Midwest,76,True,30,2,0,False,True,True,20,1,0,10.0,10,1
user_004515,25,30k-50k,mobile,new,East,70,True,159,4,0,False,True,True,111,7,0,6.966044477304416,48,-3
user_004516,18,100k-150k,mobile,returning,Midwest,76,True,62,3,0,True,True,True,41,1,0,10.0,21,2
user_004517,67,50k-75k,desktop,returning,Midwest,36,True,83,1,1,False,False,True,98,1,0,8.945539030268714,-15,0
user_004518,72,50k-75k,mobile,returning,Midwest,43,True,30,3,1,False,True,True,20,2,0,6.770805823697611,10,1
user_004519,45,100k-150k,desktop,new,East,70,True,125,2,0,False,False,True,89,2,0,7.435023175253506,36,0
user_004520,60,100k-150k,desktop,returning,East,29,True,148,1,1,True,False,True,107,1,0,7.894643389014098,41,0
user_004521,44,50k-75k,desktop,returning,East,78,True,89,1,0,True,True,True,101,1,0,7.274826011039531,-12,0
user_004522,31,30k-50k,mobile,returning,East,50,True,105,3,0,True,True,True,126,4,1,9.07606947341651,-21,-1
user_004523,52,30k-50k,desktop,new,South,24,False,0,0,0,True,True,True,82,1,0,8.893732121949316,-82,-1
user_004524,56,<30k,tablet,returning,South,34,True,83,5,0,False,False,True,93,5,0,6.365386388689941,-10,0
user_004525,23,100k-150k,mobile,returning,East,64,True,116,4,0,True,True,True,99,2,0,7.522076595096145,17,2
user_004526,74,<30k,mobile,returning,South,36,True,74,3,0,True,True,True,85,1,0,7.930596797473912,-11,2
user_004527,44,50k-75k,desktop,returning,Midwest,33,True,95,4,0,True,True,True,73,1,0,7.413600342518771,22,3
user_004528,28,>150k,mobile,returning,West,78,True,30,1,1,False,True,True,37,1,0,7.394105321769968,-7,0
user_004529,59,50k-75k,tablet,new,South,23,True,162,1,0,False,False,True,168,1,0,7.436859495152965,-6,0
user_004530,36,>150k,mobile,new,West,81,True,76,2,0,False,True,True,82,4,0,7.072955383651763,-6,-2
user_004531,71,30k-50k,mobile,returning,West,24,True,173,7,0,False,False,True,162,8,0,8.013658452516204,11,-1
user_004532,66,75k-100k,desktop,returning,East,48,True,90,2,0,True,False,True,106,2,0,7.251241951998325,-16,0
user_004533,54,30k-50k,mobile,new,East,17,False,0,0,0,False,True,True,87,2,0,5.557962725692529,-87,-2
user_004534,18,50k-75k,desktop,new,Midwest,83,True,69,4,0,False,True,True,42,7,0,9.312623656100014,27,-3
user_004535,49,50k-75k,desktop,new,South,56,True,87,1,1,False,True,True,79,1,1,7.747393961660552,8,0
user_004536,33,75k-100k,desktop,returning,South,57,True,91,5,0,True,True,True,68,6,0,7.896805678887085,23,-1
user_004537,61,30k-50k,desktop,new,South,25,True,154,1,0,True,True,True,126,2,1,8.811429032891908,28,-1
user_004538,55,30k-50k,mobile,new,East,49,True,162,5,1,False,True,True,118,4,0,8.237114635547767,44,1
user_004539,33,50k-75k,desktop,returning,West,80,True,39,1,0,False,True,True,36,1,0,8.07265892065975,3,0
user_004540,50,100k-150k,desktop,returning,Midwest,50,True,133,4,0,False,False,True,168,3,0,8.830811799291705,-35,1
user_004541,52,100k-150k,desktop,new,East,65,True,139,1,0,True,False,True,145,2,0,7.458417367432433,-6,-1
user_004542,55,100k-150k,mobile,returning,South,52,True,96,2,0,True,True,True,97,1,0,6.93531629037088,-1,1
user_004543,46,30k-50k,mobile,new,East,68,True,87,1,0,False,True,True,53,1,0,8.05615358496883,34,0
user_004544,33,<30k,mobile,returning,Midwest,57,True,72,4,0,False,True,True,52,5,0,8.972604102903501,20,-1
user_004545,48,75k-100k,desktop,returning,Midwest,55,True,113,5,1,True,True,True,125,3,0,7.669253411295672,-12,2
user_004546,37,75k-100k,desktop,new,Midwest,57,True,146,5,0,False,True,True,132,4,0,6.999828099974677,14,1
user_004547,62,100k-150k,desktop,returning,Midwest,40,True,61,4,0,False,False,True,102,5,0,9.240139448558566,-41,-1
user_004548,35,50k-75k,desktop,returning,Midwest,51,True,74,2,0,False,True,True,55,1,0,7.83191674951703,19,1
user_004549,51,100k-150k,desktop,returning,South,97,True,58,1,0,False,True,True,64,2,0,6.875730541566271,-6,-1
user_004550,48,30k-50k,mobile,returning,West,64,False,0,0,0,True,False,True,115,1,0,6.496051984545233,-115,-1
user_004551,31,75k-100k,mobile,new,East,64,True,139,3,0,False,True,True,102,4,1,7.6885501364532995,37,-1
user_004552,43,75k-100k,desktop,new,East,81,True,105,4,1,False,True,True,85,2,0,6.911042534302579,20,2
user_004553,27,75k-100k,desktop,returning,Midwest,59,True,121,3,1,True,True,True,100,5,0,7.706409404319895,21,-2
user_004554,47,100k-150k,mobile,returning,West,86,True,30,6,1,True,True,True,31,11,1,8.136335226797705,-1,-5
user_004555,43,75k-100k,mobile,returning,West,70,True,108,3,0,True,False,True,138,5,1,8.515894673880592,-30,-2
user_004556,71,75k-100k,desktop,returning,Midwest,37,True,160,5,0,False,True,True,113,8,0,8.407979624667274,47,-3
user_004557,44,75k-100k,mobile,new,West,24,True,173,6,1,False,False,True,190,7,0,7.976926347818315,-17,-1
user_004558,22,75k-100k,tablet,new,South,67,True,81,3,0,False,True,True,48,3,1,7.281931340644184,33,0
user_004559,42,75k-100k,tablet,new,East,44,True,100,1,0,True,False,True,118,1,0,6.99083680381458,-18,0
user_004560,40,75k-100k,desktop,returning,East,58,True,137,1,1,True,False,True,126,1,0,7.033845208512537,11,0
user_004561,42,75k-100k,desktop,returning,South,47,True,46,2,0,True,False,True,51,2,0,8.832826717505093,-5,0
user_004562,58,75k-100k,desktop,returning,East,28,True,161,2,1,False,False,True,150,6,1,6.092627045840598,11,-4
user_004563,24,100k-150k,mobile,returning,West,88,True,70,8,0,True,True,True,58,4,0,7.234763620769713,12,4
user_004564,38,100k-150k,desktop,returning,Midwest,42,True,44,5,0,True,True,True,37,5,0,7.994363885180399,7,0
user_004565,30,50k-75k,mobile,returning,Midwest,52,True,89,3,0,True,False,True,91,1,0,6.4277220104089565,-2,2
user_004566,34,<30k,mobile,returning,East,84,True,96,1,0,True,True,True,70,1,0,8.433733220884818,26,0
user_004567,24,30k-50k,desktop,new,East,60,True,153,1,0,True,True,False,0,0,0,,153,1
user_004568,38,30k-50k,mobile,returning,South,74,True,30,5,0,False,True,True,25,4,0,9.062047493978435,5,1
user_004569,34,50k-75k,mobile,new,East,69,True,135,5,0,True,True,True,119,4,1,7.342465233014641,16,1
user_004570,40,<30k,mobile,returning,East,33,False,0,0,0,False,False,True,84,1,0,7.6774073215683645,-84,-1
user_004571,32,30k-50k,mobile,new,West,100,True,88,3,0,False,True,True,79,2,0,7.152730941944243,9,1
user_004572,45,30k-50k,mobile,new,West,58,False,0,0,0,False,False,True,148,1,0,5.21081097609968,-148,-1
user_004573,75,30k-50k,mobile,returning,West,31,True,51,6,1,False,False,True,63,6,0,7.511638743538,-12,0
user_004574,48,50k-75k,tablet,returning,South,44,True,83,4,0,True,False,True,91,1,0,7.238390037211762,-8,3
user_004575,36,<30k,mobile,new,East,56,False,0,0,0,False,True,True,98,1,0,8.01808072543687,-98,-1
user_004576,48,100k-150k,desktop,returning,South,55,True,95,1,2,False,False,True,116,2,0,5.802448387102104,-21,-1
user_004577,72,30k-50k,mobile,returning,South,44,True,88,3,0,True,False,True,146,4,0,8.615593470190188,-58,-1
user_004578,37,75k-100k,mobile,returning,East,34,True,70,4,1,False,False,True,97,3,0,5.869854650553943,-27,1
user_004579,57,30k-50k,mobile,new,West,71,True,153,2,0,False,True,True,139,1,0,7.826680132912821,14,1
user_004580,20,75k-100k,mobile,returning,West,87,True,47,3,0,True,True,True,50,2,0,9.198147103122682,-3,1
user_004581,33,50k-75k,mobile,returning,South,73,True,44,2,0,False,False,True,31,1,0,7.344777331560344,13,1
user_004582,52,30k-50k,desktop,returning,South,43,True,115,2,1,False,False,True,101,2,0,5.999054881362271,14,0
user_004583,39,100k-150k,desktop,new,East,46,True,74,2,0,False,True,True,76,1,0,8.80569705378793,-2,1
user_004584,44,100k-150k,desktop,returning,South,71,True,34,4,0,True,True,True,31,2,0,7.313527860022576,3,2
user_004585,58,<30k,mobile,returning,South,36,True,121,4,0,False,True,True,138,3,0,6.797180744652148,-17,1
user_004586,45,<30k,desktop,new,Midwest,31,False,0,0,0,True,False,False,0,0,0,,0,0
user_004587,42,75k-100k,mobile,new,South,41,True,138,3,0,True,True,True,89,1,0,6.421732089025236,49,2
user_004588,26,50k-75k,desktop,new,South,41,True,121,2,0,False,False,True,141,1,0,6.261573482217264,-20,1
user_004589,36,<30k,desktop,new,Midwest,15,False,0,0,0,True,False,True,129,1,0,7.237128072574837,-129,-1
user_004590,33,100k-150k,desktop,new,Midwest,83,True,67,3,0,True,True,True,53,3,0,8.492303535612647,14,0
user_004591,22,50k-75k,mobile,returning,South,55,False,0,0,0,False,True,False,0,0,0,,0,0
user_004592,69,75k-100k,desktop,returning,West,55,True,42,1,0,False,True,False,0,0,0,,42,1
user_004593,58,100k-150k,mobile,returning,East,47,True,108,3,0,False,True,True,76,4,1,8.016055119693739,32,-1
user_004594,26,100k-150k,desktop,returning,South,94,True,44,4,0,False,True,True,27,4,0,7.877915912177799,17,0
user_004595,42,>150k,mobile,returning,Midwest,83,True,84,6,0,True,True,True,69,3,0,8.59197263116128,15,3
user_004596,33,30k-50k,desktop,new,West,83,False,0,0,0,False,True,True,119,1,0,6.762833586571324,-119,-1
user_004597,32,>150k,desktop,returning,East,83,True,78,7,2,False,True,True,93,9,0,8.431481873899218,-15,-2
user_004598,52,50k-75k,mobile,new,Midwest,35,True,128,2,0,True,False,True,131,2,0,7.270122402800396,-3,0
user_004599,51,50k-75k,desktop,returning,South,45,True,66,7,0,True,False,True,64,5,0,7.695522738118839,2,2
user_004600,64,<30k,desktop,returning,West,40,True,76,2,0,False,True,False,0,0,0,,76,2
user_004601,38,50k-75k,mobile,returning,West,49,True,68,2,0,False,False,False,0,0,0,,68,2
user_004602,60,75k-100k,tablet,new,West,38,True,63,2,0,False,False,True,101,2,0,8.089937856600608,-38,0
user_004603,19,50k-75k,mobile,returning,East,55,True,40,2,0,True,True,True,40,1,0,7.217206415237712,0,1
user_004604,28,100k-150k,desktop,returning,East,85,True,45,2,1,False,True,True,42,1,1,10.0,3,1
user_004605,56,75k-100k,desktop,returning,West,61,True,122,4,0,True,True,True,65,3,0,7.34681569295487,57,1
user_004606,50,30k-50k,desktop,returning,South,57,True,110,5,0,False,False,True,127,8,1,8.482680405714046,-17,-3
user_004607,32,30k-50k,mobile,new,West,91,False,0,0,0,False,True,True,80,1,0,6.800373278746106,-80,-1
user_004608,36,<30k,mobile,returning,West,53,False,0,0,0,True,True,True,138,1,0,7.368632957819895,-138,-1
user_004609,25,50k-75k,mobile,new,East,52,True,167,8,0,True,True,False,0,0,0,,167,8
user_004610,33,75k-100k,mobile,returning,South,80,True,63,5,1,False,True,True,28,3,0,7.776346359576411,35,2
user_004611,42,100k-150k,mobile,new,West,80,True,88,1,0,False,True,False,0,0,0,,88,1
user_004612,44,100k-150k,mobile,returning,South,72,True,83,1,0,True,True,True,44,2,0,7.910456357648315,39,-1
user_004613,30,100k-150k,tablet,new,East,100,True,35,1,0,False,False,False,0,0,0,,35,1
user_004614,29,75k-100k,mobile,returning,West,66,True,95,3,0,True,True,True,54,1,0,9.979988276444567,41,2
user_004615,21,100k-150k,mobile,returning,South,79,True,47,3,0,True,True,True,29,1,0,8.25958914365364,18,2
user_004616,52,30k-50k,desktop,new,East,51,True,126,3,0,False,False,True,116,5,0,6.652939588623512,10,-2
user_004617,18,100k-150k,desktop,returning,East,84,True,30,2,0,True,True,True,49,1,0,10.0,-19,1
user_004618,23,50k-75k,mobile,new,Midwest,100,True,88,4,1,True,True,True,92,1,0,9.651956232795852,-4,3
user_004619,24,<30k,desktop,new,West,94,False,0,0,0,True,True,False,0,0,0,,0,0
user_004620,27,<30k,mobile,returning,Midwest,47,True,54,2,0,False,True,True,20,1,0,7.046182508530635,34,1
user_004621,72,75k-100k,desktop,returning,South,32,True,107,2,0,False,True,True,90,1,0,8.199576953744856,17,1
user_004622,48,100k-150k,desktop,returning,East,76,True,89,2,1,True,True,True,58,3,0,9.311416504542155,31,-1
user_004623,52,100k-150k,mobile,returning,South,44,True,76,5,0,False,True,True,54,3,1,7.347540070064314,22,2
user_004624,36,100k-150k,mobile,returning,Midwest,60,True,84,2,0,True,True,True,41,1,0,8.68462693212703,43,1
user_004625,52,<30k,mobile,new,West,73,True,62,2,1,True,True,True,74,1,0,8.611844087203002,-12,1
user_004626,51,75k-100k,mobile,returning,East,61,True,97,1,0,True,True,True,69,1,0,8.615612668200894,28,0
user_004627,45,100k-150k,mobile,returning,East,84,True,33,4,0,True,True,True,45,1,0,8.25064895643437,-12,3
user_004628,43,50k-75k,mobile,returning,East,55,True,101,3,0,False,True,True,73,1,0,8.259409879025048,28,2
user_004629,40,100k-150k,tablet,returning,South,68,True,119,2,0,True,True,True,75,1,0,6.838821234639887,44,1
user_004630,54,30k-50k,desktop,returning,West,87,True,30,2,0,True,True,True,20,4,1,7.143151801218301,10,-2
user_004631,54,100k-150k,desktop,returning,East,64,True,141,1,0,True,True,True,159,1,0,6.751552639127943,-18,0
user_004632,30,<30k,mobile,returning,East,44,True,96,1,1,True,True,True,61,1,0,7.504378921067354,35,0
user_004633,35,30k-50k,mobile,returning,East,29,True,127,8,0,True,False,True,109,6,0,8.085850812511548,18,2
user_004634,60,<30k,desktop,returning,South,13,True,144,1,0,True,False,True,120,1,0,8.178783701877279,24,0
user_004635,36,30k-50k,mobile,new,Midwest,17,True,114,5,0,True,True,True,104,2,0,8.586953042651091,10,3
user_004636,64,100k-150k,mobile,new,South,44,True,128,5,1,True,False,True,102,6,0,6.991507840781603,26,-1
user_004637,63,50k-75k,mobile,new,South,24,False,0,0,0,True,False,True,139,1,0,6.875661887514786,-139,-1
user_004638,34,50k-75k,desktop,returning,West,64,True,101,1,0,True,True,True,94,1,0,7.758055459991305,7,0
user_004639,24,75k-100k,mobile,returning,South,55,True,97,3,0,False,True,True,95,7,0,8.127209322769449,2,-4
user_004640,45,75k-100k,desktop,new,Midwest,36,True,76,3,0,False,True,True,75,2,0,10.0,1,1
user_004641,49,30k-50k,mobile,returning,South,47,True,115,3,0,False,True,True,92,3,0,8.613386618206224,23,0
user_004642,37,75k-100k,mobile,new,South,32,True,127,6,0,False,False,True,116,4,0,7.468596522034272,11,2
user_004643,24,50k-75k,mobile,new,East,85,False,0,0,0,False,True,True,126,1,1,9.084495151535391,-126,-1
user_004644,59,<30k,desktop,returning,Midwest,18,True,131,2,0,True,True,True,117,1,0,6.804406562691655,14,1
user_004645,50,50k-75k,desktop,returning,East,17,False,0,0,0,True,False,False,0,0,0,,0,0
user_004646,55,50k-75k,desktop,new,Midwest,61,True,160,1,0,True,True,True,148,1,0,9.003402184761198,12,0
user_004647,37,50k-75k,tablet,returning,West,68,True,106,2,0,True,False,True,120,2,0,8.376691155845977,-14,0
user_004648,32,75k-100k,mobile,new,West,76,True,89,3,1,True,True,True,53,4,0,7.509109437925437,36,-1
user_004649,40,30k-50k,desktop,returning,South,62,True,115,5,0,True,True,True,104,1,0,10.0,11,4
user_004650,54,100k-150k,desktop,returning,Midwest,50,True,82,2,0,False,False,True,75,1,0,8.14758539671526,7,1
user_004651,24,50k-75k,mobile,new,West,65,False,0,0,0,True,False,True,118,3,0,7.482673971735033,-118,-3
user_004652,55,30k-50k,desktop,new,South,49,True,111,3,0,False,False,True,115,3,0,7.623967413453178,-4,0
user_004653,49,50k-75k,desktop,returning,South,62,True,73,4,0,True,True,True,65,4,0,9.40292547771045,8,0
user_004654,34,75k-100k,desktop,returning,Midwest,54,True,91,2,0,False,False,True,105,5,0,7.620450649414213,-14,-3
user_004655,62,75k-100k,desktop,new,West,53,True,109,3,0,False,False,True,93,4,0,6.709061132097342,16,-1
user_004656,48,75k-100k,desktop,returning,West,47,True,92,1,0,True,True,False,0,0,0,,92,1
user_004657,39,100k-150k,desktop,returning,South,62,True,30,1,0,False,True,True,66,2,0,8.278774035505878,-36,-1
user_004658,55,<30k,desktop,new,West,39,True,188,3,0,True,True,True,167,2,0,6.545093811472425,21,1
user_004659,30,<30k,mobile,returning,South,80,True,81,4,0,True,True,True,47,4,0,6.926171586033628,34,0
user_004660,18,<30k,desktop,returning,South,47,False,0,0,0,False,False,True,151,1,0,6.442375512443956,-151,-1
user_004661,27,30k-50k,desktop,returning,Midwest,69,True,107,3,0,True,True,False,0,0,0,,107,3
user_004662,40,<30k,desktop,returning,South,32,True,75,1,0,True,True,True,80,2,0,7.033418907824426,-5,-1
user_004663,32,50k-75k,desktop,returning,East,64,False,0,0,0,True,True,False,0,0,0,,0,0
user_004664,52,50k-75k,desktop,returning,East,36,True,153,4,0,True,False,False,0,0,0,,153,4
user_004665,80,75k-100k,mobile,returning,South,12,True,128,5,0,True,False,True,129,4,0,7.2687522531897715,-1,1
user_004666,52,75k-100k,desktop,new,West,50,True,82,5,0,False,False,True,80,6,0,6.97924462689971,2,-1
user_004667,39,50k-75k,desktop,returning,East,73,True,37,4,0,False,False,True,20,3,0,4.899537598133391,17,1
user_004668,37,50k-75k,mobile,returning,South,51,True,48,7,0,False,True,False,0,0,0,,48,7
user_004669,38,<30k,mobile,returning,Midwest,9,True,61,5,1,True,False,True,44,3,0,5.708500944671316,17,2
user_004670,54,30k-50k,mobile,returning,East,50,True,86,4,0,True,True,True,73,7,0,7.449488312264735,13,-3
user_004671,54,<30k,mobile,new,East,65,True,90,3,0,False,False,True,84,2,0,7.2394930644000794,6,1
user_004672,28,50k-75k,mobile,new,East,75,True,90,2,2,True,True,True,61,1,0,9.099421140251135,29,1
user_004673,41,75k-100k,desktop,new,East,29,True,181,2,0,True,False,True,149,1,0,5.771936321622703,32,1
user_004674,39,75k-100k,mobile,returning,Midwest,56,True,111,1,0,True,True,True,63,1,0,7.667133901576464,48,0
user_004675,48,100k-150k,mobile,new,South,59,True,148,2,0,False,True,True,110,1,0,8.431580915608949,38,1
user_004676,57,50k-75k,desktop,new,East,45,True,141,1,0,False,False,True,92,2,0,6.674340777603876,49,-1
user_004677,65,30k-50k,mobile,returning,West,41,True,151,1,0,False,False,True,166,2,0,6.292992892206385,-15,-1
user_004678,67,30k-50k,mobile,returning,West,53,True,77,1,0,True,True,True,45,1,0,7.772401814893793,32,0
user_004679,67,75k-100k,desktop,returning,West,47,True,145,3,0,False,True,True,107,1,0,7.4559995527561895,38,2
user_004680,54,<30k,mobile,returning,Midwest,33,True,139,3,1,True,True,True,100,1,0,7.287048172077846,39,2
user_004681,56,75k-100k,tablet,returning,East,52,True,132,2,1,False,False,True,130,3,0,6.369969431572103,2,-1
user_004682,56,100k-150k,desktop,new,West,51,True,179,2,0,False,False,True,210,4,0,6.935231715586726,-31,-2
user_004683,40,100k-150k,desktop,returning,South,58,True,121,2,0,False,True,True,138,3,0,8.219015456552981,-17,-1
user_004684,47,50k-75k,desktop,returning,East,41,True,82,2,0,False,False,True,71,4,1,6.845611243548658,11,-2
user_004685,41,100k-150k,desktop,returning,West,81,True,58,4,0,False,True,True,47,4,0,9.8746094242051,11,0
user_004686,22,30k-50k,desktop,returning,Midwest,80,True,30,4,0,False,True,True,20,2,0,8.043215239962336,10,2
user_004687,43,<30k,mobile,returning,West,52,True,155,2,0,True,True,True,142,1,0,10.0,13,1
user_004688,42,50k-75k,desktop,returning,East,65,True,86,5,1,True,True,True,79,6,0,8.66608963775411,7,-1
user_004689,58,75k-100k,desktop,new,Midwest,31,True,73,1,0,False,False,True,98,2,0,6.5704619008817255,-25,-1
user_004690,60,100k-150k,mobile,new,East,74,True,106,3,0,True,True,True,74,3,0,6.843651989608235,32,0
user_004691,47,75k-100k,mobile,new,East,37,True,137,4,0,False,True,True,109,7,0,9.97546773829064,28,-3
user_004692,25,50k-75k,mobile,new,West,74,True,72,9,1,True,True,True,72,5,2,9.260216506633606,0,4
user_004693,53,75k-100k,mobile,returning,West,63,True,87,3,0,False,False,True,42,3,0,7.123086610745272,45,0
user_004694,55,<30k,mobile,new,West,23,False,0,0,0,False,False,True,136,1,0,5.175746708065447,-136,-1
user_004695,45,<30k,mobile,new,Midwest,40,True,73,3,0,False,True,True,74,3,0,7.799775970540732,-1,0
user_004696,43,50k-75k,mobile,returning,West,67,True,117,2,0,True,False,True,101,2,1,10.0,16,0
user_004697,28,30k-50k,tablet,returning,Midwest,41,True,45,1,2,False,False,True,20,1,0,7.451987746717079,25,0
user_004698,47,30k-50k,desktop,returning,East,41,True,140,1,0,True,False,True,126,3,0,7.077905525680628,14,-2
user_004699,48,100k-150k,tablet,returning,West,56,True,104,2,0,False,True,True,100,2,0,7.100042978249405,4,0
user_004700,26,50k-75k,mobile,returning,West,87,True,79,1,0,False,False,False,0,0,0,,79,1
user_004701,23,50k-75k,desktop,new,East,75,False,0,0,0,False,True,True,105,1,0,7.685196541468039,-105,-1
user_004702,34,50k-75k,desktop,returning,West,84,True,46,2,0,True,True,True,20,2,0,6.283208275857208,26,0
user_004703,44,<30k,desktop,new,West,76,True,134,2,0,True,True,True,120,2,0,6.746553768096984,14,0
user_004704,54,75k-100k,desktop,returning,East,27,True,155,4,0,True,True,True,107,3,0,7.1191829245321125,48,1
user_004705,53,30k-50k,desktop,returning,West,62,True,77,4,0,True,True,True,45,6,0,7.377037089154488,32,-2
user_004706,43,<30k,mobile,returning,West,45,True,94,3,0,False,False,False,0,0,0,,94,3
user_004707,32,50k-75k,desktop,returning,South,64,True,154,5,0,False,True,False,0,0,0,,154,5
user_004708,24,>150k,mobile,returning,West,86,True,53,6,0,True,True,True,38,1,0,8.70518962972767,15,5
user_004709,23,30k-50k,desktop,new,Midwest,48,True,140,2,0,True,True,True,115,3,0,6.828947912904243,25,-1
user_004710,39,50k-75k,desktop,new,Midwest,54,False,0,0,0,False,False,False,0,0,0,,0,0
user_004711,24,30k-50k,desktop,new,West,89,True,102,3,0,False,True,True,59,3,0,10.0,43,0
user_004712,51,30k-50k,tablet,new,South,38,False,0,0,0,False,True,True,93,1,0,6.716870336200031,-93,-1
user_004713,52,50k-75k,mobile,returning,South,33,False,0,0,0,False,False,True,116,1,0,7.3944858148078385,-116,-1
user_004714,43,50k-75k,desktop,returning,West,40,True,185,4,2,False,False,True,193,4,0,5.744192335849893,-8,0
user_004715,56,100k-150k,mobile,returning,West,83,False,0,0,0,True,True,True,106,1,0,7.335695625608998,-106,-1
user_004716,59,75k-100k,desktop,new,East,49,True,160,1,0,False,False,True,134,1,0,4.739566831502508,26,0
user_004717,53,75k-100k,mobile,new,Midwest,29,True,117,5,1,False,False,True,113,1,0,7.170761019724631,4,4
user_004718,80,50k-75k,mobile,new,South,35,True,136,2,1,False,False,True,150,2,0,8.06118098173973,-14,0
user_004719,38,100k-150k,desktop,returning,West,88,True,42,2,0,True,True,True,20,1,0,9.254574988413628,22,1
user_004720,37,100k-150k,desktop,new,East,69,True,123,3,0,False,False,True,108,4,0,8.95669596395803,15,-1
user_004721,30,75k-100k,mobile,returning,East,72,True,82,3,1,False,True,False,0,0,0,,82,3
user_004722,42,30k-50k,mobile,returning,West,83,True,32,4,1,True,True,True,47,3,0,9.579708398453116,-15,1
user_004723,37,50k-75k,mobile,returning,East,40,True,55,2,0,False,False,True,67,4,0,8.630522689834946,-12,-2
user_004724,27,<30k,mobile,new,West,87,True,84,4,2,True,True,True,83,3,1,7.817219914082806,1,1
user_004725,62,30k-50k,mobile,returning,East,47,True,75,1,0,True,True,True,114,1,0,8.242472147989387,-39,0
user_004726,48,50k-75k,mobile,returning,East,54,True,123,3,0,False,True,True,99,2,0,8.259777842800915,24,1
user_004727,46,50k-75k,tablet,returning,East,36,True,110,3,0,False,False,False,0,0,0,,110,3
user_004728,63,100k-150k,desktop,returning,East,60,True,81,2,0,False,True,True,110,1,0,7.5408651840514045,-29,1
user_004729,39,50k-75k,desktop,returning,South,61,True,33,2,0,True,False,True,60,1,0,6.8957085771649025,-27,1
user_004730,55,50k-75k,desktop,returning,South,32,True,117,3,0,False,True,True,101,4,0,10.0,16,-1
user_004731,65,<30k,desktop,new,Midwest,27,True,181,8,1,False,False,False,0,0,0,,181,8
user_004732,69,50k-75k,mobile,returning,East,45,True,82,5,0,True,True,True,59,7,0,9.557555854290191,23,-2
user_004733,44,50k-75k,desktop,returning,Midwest,46,True,79,1,0,False,True,True,69,1,0,8.462341693195958,10,0
user_004734,42,75k-100k,desktop,returning,East,18,True,106,1,0,False,False,True,135,1,0,7.878759745599186,-29,0
user_004735,36,<30k,desktop,new,East,52,False,0,0,0,False,False,False,0,0,0,,0,0
user_004736,18,75k-100k,desktop,returning,South,65,True,146,4,0,True,True,True,106,1,0,8.553008780022749,40,3
user_004737,53,50k-75k,mobile,returning,East,33,True,108,7,0,False,True,True,106,7,1,6.758108986218381,2,0
user_004738,39,75k-100k,desktop,returning,Midwest,47,True,120,4,1,False,False,True,120,3,0,7.5736641485680085,0,1
user_004739,39,<30k,desktop,new,East,34,True,146,8,0,True,True,True,89,7,0,7.936275070883463,57,1
user_004740,62,75k-100k,mobile,returning,West,58,True,105,2,0,True,False,True,120,4,0,7.210673737030547,-15,-2
user_004741,40,50k-75k,desktop,new,Midwest,42,True,156,1,0,False,False,True,127,2,0,9.02252671322159,29,-1
user_004742,57,30k-50k,mobile,new,East,32,True,103,1,0,False,False,True,114,1,0,7.157977341392012,-11,0
user_004743,45,30k-50k,tablet,returning,South,46,True,94,2,0,True,False,True,108,4,1,8.717647180626544,-14,-2
user_004744,38,75k-100k,mobile,returning,South,43,True,160,5,0,False,False,True,174,8,0,8.265901196254328,-14,-3
user_004745,24,75k-100k,desktop,returning,West,89,False,0,0,0,False,True,True,105,1,0,7.205748871927622,-105,-1
user_004746,61,100k-150k,mobile,returning,West,37,True,84,2,0,False,True,True,50,1,0,10.0,34,1
user_004747,43,<30k,mobile,new,South,28,True,151,2,0,False,False,True,210,2,0,7.308213454793453,-59,0
user_004748,48,75k-100k,desktop,returning,South,47,True,75,1,0,True,False,True,92,1,0,7.358743430609246,-17,0
user_004749,19,30k-50k,desktop,returning,Midwest,37,False,0,0,0,True,False,True,98,1,0,9.492761568791353,-98,-1
user_004750,29,50k-75k,mobile,returning,Midwest,76,True,30,6,0,True,True,True,35,7,0,7.330894962054102,-5,-1
user_004751,80,>150k,desktop,new,South,64,False,0,0,0,False,False,True,85,1,0,6.78736769535585,-85,-1
user_004752,60,30k-50k,mobile,returning,East,17,True,127,8,0,False,True,True,131,8,0,9.136611304251794,-4,0
user_004753,74,30k-50k,desktop,returning,South,6,True,168,4,0,False,False,True,143,5,1,6.783231138123022,25,-1
user_004754,65,100k-150k,tablet,new,South,19,True,152,1,0,True,False,True,184,1,0,7.049271402667518,-32,0
user_004755,24,50k-75k,mobile,new,Midwest,68,False,0,0,0,True,True,True,89,1,0,9.69270360039138,-89,-1
user_004756,47,50k-75k,tablet,returning,East,62,True,79,5,0,True,True,True,42,3,0,7.934559135396261,37,2
user_004757,43,<30k,desktop,new,South,39,True,90,3,0,False,False,True,137,2,0,5.92529348037705,-47,1
user_004758,35,50k-75k,mobile,new,South,47,True,76,2,0,False,False,True,61,2,0,6.936486014391846,15,0
user_004759,34,100k-150k,mobile,returning,East,87,True,76,2,0,False,True,True,101,1,0,9.252245565821223,-25,1
user_004760,56,30k-50k,desktop,returning,South,31,True,81,3,0,True,False,True,104,3,0,6.110280927610855,-23,0
user_004761,52,>150k,desktop,returning,South,54,True,63,1,0,True,True,True,65,2,0,7.7681411745333495,-2,-1
user_004762,59,50k-75k,desktop,new,South,20,False,0,0,0,False,False,False,0,0,0,,0,0
user_004763,62,50k-75k,mobile,returning,South,53,True,52,2,0,False,True,True,50,3,0,6.6570390361957035,2,-1
user_004764,52,75k-100k,mobile,new,South,43,True,146,3,0,False,True,True,66,1,1,9.767710244015811,80,2
user_004765,57,30k-50k,tablet,returning,South,26,True,119,6,0,True,False,True,123,10,0,8.905079292669265,-4,-4
user_004766,43,50k-75k,desktop,new,Midwest,46,True,125,3,0,False,False,True,138,1,0,7.161591149005903,-13,2
user_004767,33,75k-100k,mobile,returning,South,60,True,58,3,0,True,True,False,0,0,0,,58,3
user_004768,39,75k-100k,mobile,returning,East,49,True,49,3,0,True,True,True,76,2,0,7.4879873126581,-27,1
user_004769,55,<30k,mobile,returning,Midwest,16,False,0,0,0,False,False,True,138,1,0,6.778132945216722,-138,-1
user_004770,43,100k-150k,mobile,returning,Midwest,54,True,89,2,0,False,False,True,83,1,0,6.461832636386305,6,1
user_004771,29,50k-75k,desktop,new,South,87,True,92,1,0,True,False,True,133,1,2,7.858225894263381,-41,0
user_004772,56,<30k,mobile,returning,East,38,False,0,0,0,True,False,False,0,0,0,,0,0
user_004773,36,30k-50k,desktop,new,East,71,True,103,1,0,False,False,True,103,3,0,9.362601825201237,0,-2
user_004774,62,100k-150k,tablet,returning,West,65,True,111,3,0,True,True,True,100,1,0,8.895090733609516,11,2
user_004775,54,75k-100k,desktop,returning,South,39,True,73,4,0,True,True,True,67,2,0,7.753278837650289,6,2
user_004776,62,75k-100k,mobile,returning,South,33,True,151,3,0,True,True,True,120,1,0,8.825684209874034,31,2
user_004777,22,30k-50k,mobile,new,East,69,True,140,6,1,False,True,True,138,4,0,8.658318665770615,2,2
user_004778,19,75k-100k,mobile,new,East,57,True,143,3,0,False,False,True,131,4,0,6.5359033767297,12,-1
user_004779,42,30k-50k,mobile,new,East,53,True,130,6,0,False,False,True,122,2,1,8.332100618370875,8,4
user_004780,43,75k-100k,mobile,returning,East,60,True,135,6,0,False,True,True,138,2,0,6.390336472072802,-3,4
user_004781,39,75k-100k,desktop,new,South,43,True,92,2,0,False,False,True,132,3,0,7.320471811730807,-40,-1
user_004782,63,30k-50k,mobile,new,Midwest,8,True,139,4,1,True,True,True,121,2,0,7.514137312952294,18,2
user_004783,32,<30k,tablet,new,Midwest,63,True,138,1,1,False,False,True,133,1,0,7.382503815095585,5,0
user_004784,32,<30k,mobile,new,West,96,True,126,5,1,True,True,False,0,0,0,,126,5
user_004785,35,50k-75k,mobile,returning,West,56,True,100,2,0,False,True,True,79,1,1,7.180144302728944,21,1
user_004786,54,<30k,desktop,returning,Midwest,36,True,130,7,0,True,False,True,118,10,0,7.1806089627873595,12,-3
user_004787,18,50k-75k,mobile,new,West,87,False,0,0,0,False,True,True,80,1,0,9.59647541685852,-80,-1
user_004788,58,50k-75k,mobile,returning,South,22,True,154,1,0,True,False,True,162,1,0,9.119045691851449,-8,0
user_004789,54,100k-150k,tablet,new,South,40,True,143,4,2,False,True,True,128,1,0,7.420477208407198,15,3
user_004790,23,75k-100k,desktop,new,South,59,True,176,2,0,False,True,True,133,2,0,7.963897322698537,43,0
user_004791,21,50k-75k,desktop,returning,Midwest,48,True,63,2,0,False,True,True,73,1,0,9.599693682468946,-10,1
user_004792,26,<30k,desktop,returning,South,28,True,93,3,0,False,False,True,122,1,0,7.475018699690027,-29,2
user_004793,21,30k-50k,mobile,returning,East,67,True,61,3,0,True,True,True,20,3,0,7.9689070759563485,41,0
user_004794,42,100k-150k,desktop,returning,Midwest,57,True,105,2,0,True,False,True,122,1,0,6.3740584843579295,-17,1
user_004795,35,50k-75k,mobile,returning,Midwest,42,True,89,7,0,True,True,True,83,5,0,8.70559912650772,6,2
user_004796,27,50k-75k,mobile,returning,South,67,True,93,2,1,False,False,True,103,3,1,6.58009644926609,-10,-1
user_004797,41,75k-100k,mobile,new,East,56,True,83,2,1,True,False,True,70,2,0,5.546575933331795,13,0
user_004798,36,100k-150k,mobile,new,Midwest,45,True,136,6,0,False,True,True,103,4,0,6.8507337859923485,33,2
user_004799,46,<30k,mobile,new,Midwest,35,False,0,0,0,False,True,True,97,1,0,7.486615223965533,-97,-1
user_004800,29,75k-100k,desktop,returning,South,48,True,106,3,0,True,True,True,65,1,1,8.629348014362883,41,2
user_004801,60,75k-100k,mobile,returning,East,24,True,89,3,0,True,True,True,63,1,0,6.263685821298606,26,2
user_004802,40,30k-50k,tablet,returning,Midwest,36,True,57,3,0,True,True,True,63,2,0,7.9480229744147985,-6,1
user_004803,45,50k-75k,desktop,new,West,47,True,116,1,0,True,True,True,102,1,0,8.465121508590286,14,0
user_004804,51,100k-150k,mobile,new,Midwest,67,True,92,4,0,True,True,True,66,4,0,6.341140993523454,26,0
user_004805,45,75k-100k,mobile,returning,South,45,True,70,1,0,False,True,True,47,1,1,6.234336601931556,23,0
user_004806,48,75k-100k,tablet,returning,West,61,True,63,1,0,False,False,True,74,2,0,7.793275623024042,-11,-1
user_004807,40,75k-100k,desktop,returning,West,59,True,62,3,0,False,True,True,58,1,0,8.554631389033766,4,2
user_004808,48,>150k,desktop,returning,East,52,True,99,3,1,True,True,True,83,2,0,6.596797459974656,16,1
user_004809,20,>150k,mobile,returning,West,74,True,166,3,0,False,True,False,0,0,0,,166,3
user_004810,60,100k-150k,desktop,returning,South,46,True,119,2,0,True,True,True,81,1,0,7.93537928155743,38,1
user_004811,44,50k-75k,mobile,returning,East,30,True,51,1,0,True,False,True,24,1,0,7.0744942053477935,27,0
user_004812,18,<30k,mobile,returning,West,62,False,0,0,0,True,True,True,116,1,0,7.607533595484866,-116,-1
user_004813,29,<30k,desktop,returning,Midwest,50,False,0,0,0,False,False,False,0,0,0,,0,0
user_004814,32,50k-75k,desktop,returning,West,96,True,62,1,0,False,True,True,46,1,0,8.365574887863573,16,0
user_004815,33,30k-50k,desktop,new,East,93,False,0,0,0,True,True,True,73,1,0,7.807972126688261,-73,-1
user_004816,48,<30k,mobile,returning,East,59,False,0,0,0,False,False,True,133,2,0,9.173268488467295,-133,-2
user_004817,69,100k-150k,desktop,returning,East,64,True,79,4,0,True,False,True,116,2,0,8.643384360504287,-37,2
user_004818,28,50k-75k,desktop,new,East,82,True,104,1,0,False,True,True,106,2,0,8.54943610399414,-2,-1
user_004819,59,50k-75k,tablet,returning,South,44,True,100,2,0,True,False,True,118,1,0,8.639228482391964,-18,1
user_004820,54,50k-75k,mobile,returning,East,30,True,131,4,1,True,True,True,96,7,0,6.346398199775616,35,-3
user_004821,27,50k-75k,mobile,new,South,64,True,128,6,0,True,True,True,129,3,1,7.270417877082045,-1,3
user_004822,38,50k-75k,mobile,new,South,42,True,100,6,0,True,False,True,103,3,0,8.658793947101726,-3,3
user_004823,39,>150k,desktop,new,East,78,True,81,4,0,False,True,True,61,6,0,9.591565329493195,20,-2
user_004824,38,50k-75k,desktop,returning,Midwest,44,True,94,2,0,False,False,True,92,2,0,7.92766269930816,2,0
user_004825,34,100k-150k,mobile,returning,Midwest,100,False,0,0,0,True,True,True,98,1,0,8.094058709220377,-98,-1
user_004826,47,75k-100k,mobile,returning,South,59,True,60,5,0,True,True,True,64,4,0,7.692601658070573,-4,1
user_004827,66,30k-50k,mobile,new,East,39,False,0,0,0,False,False,False,0,0,0,,0,0
user_004828,57,30k-50k,desktop,returning,West,13,True,166,5,0,True,True,True,159,1,0,8.120925332921985,7,4
user_004829,49,30k-50k,desktop,returning,West,49,True,51,3,1,True,False,True,50,6,0,5.706575504953759,1,-3
user_004830,39,50k-75k,desktop,returning,West,32,True,102,4,0,False,False,True,108,5,0,6.737099473900992,-6,-1
user_004831,56,30k-50k,mobile,new,South,11,True,141,3,0,False,False,True,166,1,0,6.046816516247829,-25,2
user_004832,44,>150k,mobile,returning,East,71,True,90,4,0,True,True,False,0,0,0,,90,4
user_004833,56,>150k,desktop,returning,South,66,True,68,3,0,True,True,True,74,3,0,7.732117671665465,-6,0
user_004834,60,50k-75k,desktop,returning,West,48,True,84,2,0,False,True,True,42,3,0,7.178549363513697,42,-1
user_004835,48,75k-100k,desktop,returning,South,49,True,84,3,0,False,False,True,89,5,0,6.637232823911889,-5,-2
user_004836,36,<30k,mobile,returning,Midwest,30,False,0,0,0,False,True,True,62,2,0,7.967758544173303,-62,-2
user_004837,22,30k-50k,desktop,returning,South,43,True,70,2,1,False,True,True,45,2,0,9.452854891835386,25,0
user_004838,44,50k-75k,mobile,returning,East,44,True,72,4,0,False,True,False,0,0,0,,72,4
user_004839,18,30k-50k,mobile,returning,West,74,True,121,1,1,True,True,True,119,1,0,9.717071737012542,2,0
user_004840,41,75k-100k,tablet,returning,Midwest,55,True,32,2,0,False,True,True,25,2,0,9.674517268325653,7,0
user_004841,39,30k-50k,mobile,returning,Midwest,49,False,0,0,0,False,True,True,103,1,0,8.66825337152712,-103,-1
user_004842,53,75k-100k,mobile,returning,East,46,True,80,4,0,True,True,True,76,5,0,7.128363423199082,4,-1
user_004843,65,<30k,mobile,returning,Midwest,37,True,93,4,0,True,True,True,98,5,0,9.878152984104261,-5,-1
user_004844,33,100k-150k,mobile,returning,Midwest,100,True,71,3,1,False,True,True,57,7,1,8.15037218138849,14,-4
user_004845,42,<30k,mobile,new,East,25,False,0,0,0,True,False,True,102,1,0,8.32909247225621,-102,-1
user_004846,54,30k-50k,desktop,returning,East,50,True,88,2,0,False,False,True,85,1,0,7.216329992505263,3,1
user_004847,38,50k-75k,tablet,new,South,44,False,0,0,0,True,False,True,103,1,0,7.171881235479372,-103,-1
user_004848,51,>150k,tablet,returning,South,47,True,70,1,0,True,True,True,31,1,0,7.125003685680271,39,0
user_004849,55,30k-50k,mobile,returning,East,33,True,125,5,0,False,False,True,175,5,0,7.729716921691725,-50,0
user_004850,59,30k-50k,desktop,new,East,14,True,148,2,1,False,False,True,134,2,1,7.581372003658233,14,0
user_004851,42,<30k,desktop,new,South,33,True,161,4,0,False,False,True,164,7,0,6.363055846870927,-3,-3
user_004852,21,50k-75k,tablet,new,East,53,True,121,2,0,False,True,True,94,2,0,6.198772824740925,27,0
user_004853,35,30k-50k,desktop,new,South,23,True,171,2,0,True,False,True,141,1,1,7.182624598888233,30,1
user_004854,58,50k-75k,mobile,new,West,36,True,153,4,0,False,True,True,113,1,0,5.946838836359148,40,3
user_004855,26,<30k,desktop,new,South,50,False,0,0,0,False,False,False,0,0,0,,0,0
user_004856,52,>150k,mobile,returning,Midwest,57,True,67,2,0,False,True,True,40,1,0,9.31423407067268,27,1
user_004857,48,100k-150k,desktop,returning,East,60,True,102,3,0,True,True,True,42,3,0,8.818848114145192,60,0
user_004858,49,50k-75k,mobile,returning,South,40,True,130,3,0,True,False,True,129,1,1,7.043794772498267,1,2
user_004859,29,50k-75k,mobile,returning,South,48,True,63,4,0,False,False,True,96,6,0,5.963331981684635,-33,-2
user_004860,33,50k-75k,desktop,new,West,100,True,59,3,0,True,True,True,25,5,0,7.96013452356811,34,-2
user_004861,51,30k-50k,desktop,returning,South,41,True,99,1,1,False,True,True,82,1,0,6.4967747121246155,17,0
user_004862,60,75k-100k,mobile,returning,West,58,True,60,9,0,True,True,True,57,10,0,8.831438284763472,3,-1
user_004863,47,75k-100k,mobile,returning,West,65,True,127,5,0,False,True,True,86,4,0,8.02006002945021,41,1
user_004864,31,<30k,mobile,returning,East,74,True,76,4,0,True,True,True,79,6,0,9.814328141265,-3,-2
user_004865,37,75k-100k,mobile,returning,South,47,True,132,2,0,False,False,True,136,4,0,7.223981530000064,-4,-2
user_004866,31,>150k,mobile,returning,East,76,True,93,6,0,True,True,True,61,4,0,7.148552660305047,32,2
user_004867,18,30k-50k,desktop,returning,East,61,True,54,2,0,True,True,True,22,2,0,8.384283253124327,32,0
user_004868,59,50k-75k,mobile,returning,Midwest,28,True,112,9,0,False,False,True,114,4,0,9.023844706964645,-2,5
user_004869,37,30k-50k,desktop,new,South,52,True,78,2,1,False,False,True,85,5,0,6.033831750772604,-7,-3
user_004870,59,75k-100k,tablet,returning,West,37,True,109,4,0,False,False,True,145,5,0,6.099685909605879,-36,-1
user_004871,34,50k-75k,desktop,returning,East,85,True,36,1,0,True,True,True,34,1,1,7.608404265342385,2,0
user_004872,64,50k-75k,desktop,new,East,54,True,152,2,0,False,True,True,112,3,0,7.651467422583159,40,-1
user_004873,31,50k-75k,desktop,returning,South,81,True,66,2,1,True,True,True,48,2,0,6.555810982871184,18,0
user_004874,29,50k-75k,desktop,returning,West,80,True,71,4,0,True,True,False,0,0,0,,71,4
user_004875,55,30k-50k,desktop,new,Midwest,33,True,75,5,0,True,False,True,90,6,0,9.997694819531974,-15,-1
user_004876,30,100k-150k,mobile,returning,South,80,True,42,5,0,True,True,True,62,8,0,7.106779324273253,-20,-3
user_004877,18,50k-75k,mobile,new,East,34,True,87,8,0,True,True,True,41,7,0,8.274238987816497,46,1
user_004878,37,<30k,desktop,returning,South,49,True,75,1,0,False,True,True,68,3,0,6.196901505708902,7,-2
user_004879,45,<30k,desktop,returning,West,42,True,90,1,0,False,False,True,126,1,0,5.456462930490552,-36,0
user_004880,42,<30k,tablet,returning,Midwest,28,True,91,4,0,False,True,True,53,2,1,7.450434840460804,38,2
user_004881,54,50k-75k,desktop,new,Midwest,43,True,173,3,0,False,False,True,185,6,0,5.7080547603737095,-12,-3
user_004882,49,100k-150k,desktop,returning,West,72,True,82,2,0,False,True,True,76,2,0,7.3159902064142495,6,0
user_004883,28,75k-100k,mobile,returning,South,57,True,64,4,0,True,True,True,39,2,1,6.739655430008293,25,2
user_004884,38,100k-150k,desktop,returning,East,63,True,57,6,0,False,True,True,64,3,0,8.77945347391359,-7,3
user_004885,43,50k-75k,mobile,new,East,41,True,108,1,0,False,False,True,69,2,0,7.662542518416898,39,-1
user_004886,36,30k-50k,desktop,new,East,54,False,0,0,0,True,True,True,80,3,0,9.010282046679034,-80,-3
user_004887,66,<30k,desktop,new,East,35,True,135,1,0,False,False,True,150,1,0,7.746376740452935,-15,0
user_004888,36,50k-75k,tablet,new,Midwest,39,True,128,4,0,False,False,True,134,5,0,7.332365531502893,-6,-1
user_004889,29,50k-75k,mobile,returning,Midwest,66,True,156,2,0,False,True,True,143,1,0,10.0,13,1
user_004890,61,50k-75k,desktop,new,East,34,True,93,3,0,False,False,True,100,6,0,6.452647173685416,-7,-3
user_004891,41,75k-100k,mobile,returning,South,69,True,54,2,0,True,True,True,26,4,0,9.064147184419259,28,-2
user_004892,43,75k-100k,desktop,returning,South,59,True,89,1,0,True,False,True,78,1,0,5.626712777853202,11,0
user_004893,30,100k-150k,mobile,new,East,91,False,0,0,0,True,True,False,0,0,0,,0,0
user_004894,34,50k-75k,mobile,returning,South,86,True,75,4,0,True,True,True,123,2,0,8.159982579572441,-48,2
user_004895,18,>150k,desktop,returning,Midwest,84,False,0,0,0,True,False,True,104,1,0,7.11191701338982,-104,-1
user_004896,69,75k-100k,desktop,returning,East,4,True,91,2,0,True,False,True,105,1,0,8.425840427318848,-14,1
user_004897,55,100k-150k,desktop,new,West,65,True,134,2,0,False,True,True,81,1,0,8.564348920820214,53,1
user_004898,47,100k-150k,mobile,returning,Midwest,52,True,122,2,0,False,True,True,107,3,0,10.0,15,-1
user_004899,40,75k-100k,mobile,returning,East,40,True,68,4,0,True,False,True,57,4,0,5.449682647742599,11,0
user_004900,51,<30k,desktop,new,Midwest,33,True,85,2,0,False,True,True,20,1,0,8.301179299131602,65,1
user_004901,57,75k-100k,mobile,returning,East,16,True,137,3,0,False,False,True,106,1,0,7.107940688649783,31,2
user_004902,32,50k-75k,mobile,new,South,90,True,106,1,0,True,True,True,112,1,0,8.261766251672793,-6,0
user_004903,45,100k-150k,mobile,returning,South,78,True,73,4,1,False,True,True,58,1,0,8.948143366315199,15,3
user_004904,23,75k-100k,mobile,returning,East,65,True,86,3,0,True,True,True,58,1,0,9.718324320500049,28,2
user_004905,42,<30k,desktop,returning,West,29,False,0,0,0,True,True,True,90,1,0,7.588253321959518,-90,-1
user_004906,64,75k-100k,mobile,new,East,16,False,0,0,0,False,False,True,106,2,0,6.191774351870006,-106,-2
user_004907,43,<30k,mobile,returning,South,7,False,0,0,0,True,True,True,85,1,0,7.579226263187162,-85,-1
user_004908,31,50k-75k,desktop,new,Midwest,87,True,81,1,1,False,True,True,37,2,0,8.435836906234595,44,-1
user_004909,40,50k-75k,mobile,returning,Midwest,63,True,99,5,0,True,True,True,119,3,0,7.652358030144871,-20,2
user_004910,52,75k-100k,desktop,returning,Midwest,77,True,75,1,0,True,True,True,41,1,0,7.869187843207052,34,0
user_004911,72,30k-50k,mobile,returning,West,59,True,150,2,0,True,False,True,169,1,0,8.80316525430924,-19,1
user_004912,25,50k-75k,mobile,new,West,65,True,152,2,0,False,True,True,120,1,0,7.518297313887086,32,1
user_004913,43,<30k,desktop,returning,West,26,True,135,6,1,False,False,True,145,6,0,7.580144890991046,-10,0
user_004914,21,50k-75k,mobile,returning,West,51,True,60,3,0,False,True,True,25,2,0,9.135750113023528,35,1
user_004915,27,50k-75k,desktop,new,West,86,True,47,4,0,False,True,True,44,2,0,7.496866462722066,3,2
user_004916,38,<30k,mobile,new,East,36,False,0,0,0,True,True,True,88,1,0,8.425338906712687,-88,-1
user_004917,59,50k-75k,mobile,returning,East,43,False,0,0,0,False,False,False,0,0,0,,0,0
user_004918,55,30k-50k,desktop,returning,West,49,True,82,1,1,True,False,True,78,1,0,8.502864840844511,4,0
user_004919,52,30k-50k,desktop,returning,South,44,True,155,6,0,False,True,True,154,4,0,9.378318722183227,1,2
user_004920,79,50k-75k,mobile,returning,Midwest,8,True,183,7,0,True,False,True,171,9,0,8.942968209911134,12,-2
user_004921,57,50k-75k,desktop,returning,East,23,False,0,0,0,False,False,True,144,1,0,6.708982876181477,-144,-1
user_004922,27,30k-50k,desktop,new,East,93,True,122,3,0,False,True,True,108,1,0,8.101416732967829,14,2
user_004923,63,100k-150k,desktop,new,Midwest,52,True,130,4,1,False,True,True,92,3,0,8.743845660900831,38,1
user_004924,57,75k-100k,mobile,returning,East,33,True,71,1,0,False,False,True,62,2,0,7.853172525348874,9,-1
user_004925,78,50k-75k,desktop,returning,West,28,True,124,3,1,False,True,True,115,2,0,7.559214244335378,9,1
user_004926,58,50k-75k,mobile,returning,West,36,True,151,2,0,True,True,True,128,1,0,6.26689837154852,23,1
user_004927,53,100k-150k,mobile,returning,West,68,True,75,3,0,False,False,True,65,4,0,8.27104767960735,10,-1
user_004928,58,100k-150k,mobile,new,West,48,True,110,1,0,False,False,True,91,1,0,6.803657066824043,19,0
user_004929,49,50k-75k,desktop,returning,South,36,True,75,5,1,False,True,True,67,4,0,7.250028987504344,8,1
user_004930,45,100k-150k,mobile,returning,Midwest,97,True,40,2,0,True,True,True,20,1,0,8.145130052752869,20,1
user_004931,21,50k-75k,mobile,returning,East,49,True,91,3,0,True,False,True,50,1,0,7.707114850228144,41,2
user_004932,42,75k-100k,mobile,new,West,56,True,120,2,0,False,True,True,91,1,0,7.51656811919321,29,1
user_004933,52,75k-100k,desktop,returning,East,35,True,87,4,1,False,True,True,52,5,0,7.0629929462347825,35,-1
user_004934,46,100k-150k,desktop,new,East,59,True,134,2,0,False,True,True,130,1,0,9.201609026593234,4,1
user_004935,35,75k-100k,desktop,new,South,51,True,42,3,0,False,False,True,48,4,0,7.242569324378765,-6,-1
user_004936,45,30k-50k,desktop,returning,West,59,True,123,4,0,True,False,True,140,3,0,7.137801188589844,-17,1
user_004937,37,30k-50k,mobile,returning,Midwest,81,True,62,1,0,True,True,True,41,1,0,10.0,21,0
user_004938,54,50k-75k,desktop,returning,West,90,True,46,2,0,False,True,True,42,1,0,8.370181694953997,4,1
user_004939,46,<30k,mobile,new,East,44,True,155,2,0,False,False,True,186,1,0,6.146057755295711,-31,1
user_004940,48,<30k,mobile,new,Midwest,34,True,191,1,0,False,True,True,148,1,0,9.169421744339843,43,0
user_004941,47,75k-100k,desktop,returning,Midwest,20,True,119,3,0,True,True,True,82,1,0,9.312246103769683,37,2
user_004942,48,50k-75k,desktop,new,West,68,False,0,0,0,True,False,True,111,2,0,7.090224505712974,-111,-2
user_004943,67,75k-100k,desktop,returning,South,17,True,125,3,0,False,False,True,117,6,0,6.327463100348891,8,-3
user_004944,42,50k-75k,desktop,returning,South,28,True,56,2,0,False,False,True,22,6,0,7.42324731346776,34,-4
user_004945,40,50k-75k,mobile,returning,East,54,True,110,6,0,True,False,True,112,3,0,6.1489350142517845,-2,3
user_004946,49,50k-75k,desktop,returning,West,76,True,38,3,0,True,True,True,31,1,0,8.289021019506391,7,2
user_004947,49,100k-150k,desktop,returning,South,64,True,85,1,0,True,True,True,43,2,0,8.741111492287597,42,-1
user_004948,31,50k-75k,mobile,returning,Midwest,45,True,152,3,0,True,True,True,127,2,0,7.77155286373431,25,1
user_004949,32,75k-100k,desktop,new,West,97,True,112,3,0,True,True,True,72,1,0,7.880233565004575,40,2
user_004950,47,50k-75k,desktop,returning,West,47,True,83,2,0,True,False,True,63,2,0,7.526122989650827,20,0
user_004951,43,75k-100k,mobile,returning,South,55,True,112,3,0,False,False,True,84,6,0,7.624165855961854,28,-3
user_004952,80,<30k,mobile,new,West,32,False,0,0,0,False,False,False,0,0,0,,0,0
user_004953,42,<30k,desktop,returning,Midwest,40,True,146,3,0,True,True,False,0,0,0,,146,3
user_004954,38,30k-50k,desktop,returning,West,88,True,68,4,1,True,True,True,54,2,1,6.6907679279446715,14,2
user_004955,37,75k-100k,desktop,returning,East,78,True,129,2,1,False,True,True,84,1,0,9.70732245753429,45,1
user_004956,37,100k-150k,desktop,returning,West,83,True,64,6,1,False,True,True,80,6,0,7.96517386111848,-16,0
user_004957,39,<30k,mobile,returning,Midwest,31,True,67,5,0,False,False,True,45,12,0,7.825433044097767,22,-7
user_004958,66,75k-100k,tablet,returning,Midwest,34,True,71,4,0,False,False,False,0,0,0,,71,4
user_004959,65,>150k,desktop,returning,South,50,True,56,4,0,True,True,False,0,0,0,,56,4
user_004960,58,50k-75k,mobile,returning,East,39,True,77,5,0,False,False,True,52,3,1,8.108309627962731,25,2
user_004961,62,100k-150k,desktop,returning,East,76,True,61,2,0,True,True,True,67,1,0,9.721746179738489,-6,1
user_004962,50,75k-100k,mobile,new,East,51,True,116,2,1,True,True,True,78,2,0,7.443162370040315,38,0
user_004963,62,>150k,mobile,new,West,54,True,88,1,0,False,True,True,52,1,0,5.9097485562448995,36,0
user_004964,61,100k-150k,mobile,new,West,51,True,145,2,1,True,True,True,192,2,0,7.558957654625747,-47,0
user_004965,52,75k-100k,desktop,returning,East,56,True,60,1,0,True,False,True,61,1,0,9.27665977741839,-1,0
user_004966,42,75k-100k,mobile,returning,West,45,True,54,1,0,False,False,True,65,4,0,9.232382885132855,-11,-3
user_004967,33,50k-75k,desktop,returning,West,65,True,33,2,0,True,True,True,22,2,0,8.715073544212741,11,0
user_004968,43,<30k,mobile,returning,West,68,True,61,5,1,True,False,False,0,0,0,,61,5
user_004969,52,30k-50k,mobile,returning,East,98,True,66,1,0,True,True,True,62,2,0,6.42984187990622,4,-1
user_004970,18,<30k,mobile,returning,South,61,True,76,3,0,False,True,False,0,0,0,,76,3
user_004971,42,<30k,desktop,new,West,81,True,45,7,0,True,True,False,0,0,0,,45,7
user_004972,38,<30k,mobile,returning,West,61,False,0,0,0,False,False,True,141,1,0,7.553079014887687,-141,-1
user_004973,40,<30k,desktop,returning,East,39,True,41,4,0,True,False,True,43,2,0,8.387277428889268,-2,2
user_004974,62,75k-100k,mobile,returning,Midwest,38,True,97,3,0,True,True,True,137,4,0,7.483634998378414,-40,-1
user_004975,55,75k-100k,mobile,returning,West,71,True,96,4,0,False,True,True,54,1,0,7.774750801185545,42,3
user_004976,44,30k-50k,desktop,returning,East,47,True,105,1,0,True,True,True,75,1,0,8.379418625417633,30,0
user_004977,50,75k-100k,mobile,returning,South,71,True,70,1,1,True,True,False,0,0,0,,70,1
user_004978,35,50k-75k,mobile,returning,South,49,True,90,3,0,True,False,True,78,1,0,6.962115166663597,12,2
user_004979,51,30k-50k,mobile,returning,West,87,True,82,3,0,True,True,True,67,3,0,8.676272287112745,15,0
user_004980,24,<30k,desktop,new,South,36,True,129,3,0,False,True,True,109,2,0,5.772570589393357,20,1
user_004981,49,<30k,tablet,returning,East,31,True,120,3,0,False,False,True,101,4,0,8.472073035422973,19,-1
user_004982,30,30k-50k,tablet,returning,Midwest,52,True,75,3,0,True,True,True,64,1,0,7.024194275344335,11,2
user_004983,35,<30k,tablet,new,South,54,True,134,2,0,False,False,True,158,3,0,9.376599150380029,-24,-1
user_004984,79,<30k,mobile,new,East,7,True,154,8,1,False,False,True,130,12,0,7.822037017895155,24,-4
user_004985,26,75k-100k,mobile,new,South,50,False,0,0,0,False,True,True,120,2,0,9.318672687037592,-120,-2
user_004986,31,75k-100k,desktop,returning,West,80,True,49,2,0,True,True,True,52,1,0,7.722753747920771,-3,1
user_004987,44,>150k,mobile,new,South,44,True,133,6,0,True,True,True,112,3,0,7.346710111973554,21,3
user_004988,46,100k-150k,desktop,new,West,91,True,75,5,0,True,True,True,26,5,0,7.427411487819638,49,0
user_004989,63,75k-100k,mobile,returning,South,12,True,105,4,0,False,False,True,119,4,0,8.028306513152845,-14,0
user_004990,30,30k-50k,mobile,returning,South,71,True,42,2,1,True,True,True,21,4,0,9.732268427433432,21,-2
user_004991,49,30k-50k,desktop,new,South,43,False,0,0,0,False,False,False,0,0,0,,0,0
user_004992,41,100k-150k,mobile,returning,West,52,True,85,4,0,False,True,False,0,0,0,,85,4
user_004993,45,50k-75k,mobile,returning,West,54,True,158,3,0,False,True,True,153,3,0,8.490686735544687,5,0
user_004994,41,50k-75k,desktop,returning,South,44,False,0,0,0,True,False,True,156,1,0,8.609783859645507,-156,-1
user_004995,31,75k-100k,desktop,returning,Midwest,58,True,100,2,1,True,True,True,114,3,0,8.790627779566648,-14,-1
user_004996,80,75k-100k,mobile,returning,East,26,True,147,3,1,False,False,True,200,6,0,8.5667307902707,-53,-3
user_004997,26,<30k,tablet,returning,East,77,False,0,0,0,True,True,True,73,1,0,7.708466936375716,-73,-1
user_004998,58,30k-50k,mobile,returning,Midwest,35,True,85,5,0,True,True,True,33,7,0,8.502058687355019,52,-2
user_004999,24,30k-50k,desktop,new,East,76,False,0,0,0,True,True,True,78,1,0,8.098389523397673,-78,-1
user_005000,45,50k-75k,desktop,new,East,61,True,75,1,0,True,True,True,33,2,0,8.184035277919245,42,-1
user_005001,56,75k-100k,desktop,new,West,57,True,133,1,0,False,True,True,123,1,0,9.112542371052886,10,0
user_005002,56,<30k,mobile,returning,South,17,True,123,6,1,True,False,True,109,11,0,7.871633104677238,14,-5
user_005003,46,>150k,desktop,returning,East,54,True,38,2,0,False,True,True,20,2,0,9.02776241811338,18,0
user_005004,36,50k-75k,mobile,returning,East,71,True,79,1,0,False,True,True,71,1,0,6.476420752565383,8,0
user_005005,37,30k-50k,desktop,returning,South,25,True,109,6,0,True,False,True,116,7,1,6.715637559519333,-7,-1
user_005006,18,100k-150k,mobile,new,East,100,True,76,5,0,True,True,True,27,5,0,8.865347152249097,49,0
user_005007,18,<30k,desktop,new,Midwest,99,True,46,1,0,False,True,True,24,2,0,7.6465009715360495,22,-1
user_005008,69,<30k,desktop,returning,East,47,True,89,5,1,False,True,True,75,3,2,8.955417877490234,14,2
user_005009,67,<30k,mobile,new,Midwest,26,False,0,0,0,False,False,True,85,1,0,8.660284033366477,-85,-1
user_005010,37,75k-100k,desktop,returning,East,59,True,105,4,0,True,False,True,125,2,0,7.454512170433507,-20,2
user_005011,55,50k-75k,mobile,returning,East,34,True,90,5,0,True,True,True,83,4,0,5.964908933842503,7,1
user_005012,61,30k-50k,desktop,returning,Midwest,21,True,54,2,1,False,False,True,79,3,1,7.396457327744017,-25,-1
user_005013,47,100k-150k,desktop,returning,West,85,True,75,1,0,True,True,True,82,3,0,8.902934038789835,-7,-2
user_005014,49,100k-150k,desktop,new,Midwest,51,True,72,3,0,False,True,True,109,2,0,7.717685012322391,-37,1
user_005015,47,50k-75k,mobile,returning,South,48,True,94,3,0,True,True,True,71,1,0,10.0,23,2
user_005016,50,75k-100k,desktop,new,South,52,False,0,0,0,True,False,True,130,1,0,6.090613085259151,-130,-1
user_005017,77,100k-150k,desktop,returning,South,36,True,54,2,0,True,True,True,61,1,1,8.970702817671897,-7,1
user_005018,18,50k-75k,desktop,returning,Midwest,67,True,55,2,0,True,True,True,39,1,0,7.948449271065421,16,1
user_005019,50,75k-100k,desktop,new,West,62,True,150,2,0,False,False,True,129,3,0,6.03590405812474,21,-1
user_005020,35,50k-75k,desktop,returning,West,25,False,0,0,0,False,True,True,87,2,0,7.915442722493811,-87,-2
user_005021,61,30k-50k,mobile,new,West,35,True,124,1,0,False,False,False,0,0,0,,124,1
user_005022,59,30k-50k,mobile,new,Midwest,34,True,155,3,0,True,True,True,126,3,0,8.852355215621888,29,0
user_005023,45,100k-150k,mobile,new,West,75,True,85,4,0,False,True,True,57,5,1,5.158667602671493,28,-1
user_005024,49,<30k,mobile,returning,West,70,True,73,3,0,True,False,True,80,2,0,8.498456826687491,-7,1
user_005025,32,75k-100k,desktop,new,Midwest,86,True,79,1,0,True,True,True,95,1,0,10.0,-16,0
user_005026,64,50k-75k,desktop,new,East,20,True,168,3,0,False,True,True,124,8,0,7.990711345738381,44,-5
user_005027,57,<30k,desktop,new,West,55,True,100,2,0,False,False,True,72,1,0,6.792173686208823,28,1
user_005028,42,100k-150k,desktop,returning,Midwest,58,True,98,3,0,False,False,True,60,3,0,7.3966181037425764,38,0
user_005029,49,30k-50k,mobile,new,South,22,True,136,3,0,False,False,True,120,3,0,5.731791949914943,16,0
user_005030,18,100k-150k,desktop,returning,West,75,True,111,2,0,False,True,True,116,1,1,7.212223644863074,-5,1
user_005031,72,50k-75k,desktop,new,South,36,True,99,6,0,False,False,True,106,1,0,5.006231066391732,-7,5
user_005032,39,30k-50k,desktop,returning,West,49,True,94,1,0,True,False,True,57,1,0,6.878752721493119,37,0
user_005033,57,30k-50k,mobile,returning,West,50,True,90,5,0,False,True,True,86,1,0,10.0,4,4
user_005034,25,75k-100k,mobile,returning,East,53,True,135,4,0,True,True,True,116,1,1,8.670242561292463,19,3
user_005035,62,100k-150k,desktop,new,East,24,True,168,2,1,True,True,False,0,0,0,,168,2
user_005036,27,50k-75k,mobile,returning,East,93,True,82,4,1,True,True,True,85,3,0,7.7764856221700915,-3,1
user_005037,29,75k-100k,desktop,returning,Midwest,63,True,90,2,0,False,True,True,97,1,0,7.616271381535976,-7,1
user_005038,33,30k-50k,mobile,new,Midwest,61,True,114,2,0,True,True,True,98,2,0,10.0,16,0
user_005039,42,100k-150k,desktop,returning,West,57,True,93,6,1,True,False,True,90,6,0,5.728041142096415,3,0
user_005040,31,100k-150k,mobile,returning,South,100,True,36,5,0,True,True,True,44,3,0,10.0,-8,2
user_005041,64,75k-100k,desktop,returning,South,30,True,42,4,0,True,True,True,36,4,0,8.082532864094786,6,0
user_005042,53,>150k,desktop,returning,Midwest,67,True,97,2,0,False,True,True,104,2,0,9.862446631012736,-7,0
user_005043,64,<30k,desktop,returning,Midwest,16,True,124,5,0,False,False,False,0,0,0,,124,5
user_005044,54,100k-150k,mobile,returning,South,80,True,36,1,0,False,True,True,20,2,0,7.809115742870766,16,-1
user_005045,39,<30k,desktop,returning,Midwest,57,False,0,0,0,False,False,False,0,0,0,,0,0
user_005046,61,>150k,desktop,returning,South,83,True,30,2,0,True,True,True,45,3,0,8.888840633010211,-15,-1
user_005047,47,30k-50k,mobile,returning,Midwest,43,True,117,1,1,False,False,True,125,2,0,6.509228071974728,-8,-1
user_005048,39,50k-75k,desktop,returning,West,70,True,121,1,0,True,True,True,65,1,0,9.250880730165226,56,0
user_005049,36,75k-100k,desktop,returning,East,37,True,102,4,1,True,True,True,75,6,0,8.887562007982627,27,-2
user_005050,48,50k-75k,desktop,returning,West,50,False,0,0,0,False,True,True,107,1,0,8.235117095125723,-107,-1
user_005051,18,50k-75k,mobile,returning,West,81,True,30,7,0,True,False,True,60,8,0,5.294125213520221,-30,-1
user_005052,61,100k-150k,mobile,returning,South,24,True,138,3,0,False,False,False,0,0,0,,138,3
user_005053,77,30k-50k,mobile,returning,South,17,True,67,6,0,True,False,False,0,0,0,,67,6
user_005054,30,75k-100k,mobile,returning,East,38,True,102,5,0,False,False,True,103,3,0,7.454482941896485,-1,2
user_005055,56,100k-150k,mobile,returning,West,40,True,89,2,0,True,True,True,23,1,0,7.4301189761333255,66,1
user_005056,51,75k-100k,desktop,new,South,34,False,0,0,0,False,True,True,120,2,0,7.797973437929791,-120,-2
user_005057,30,75k-100k,desktop,returning,Midwest,44,True,88,4,1,True,True,True,69,2,0,7.0136539464890415,19,2
user_005058,60,50k-75k,mobile,returning,West,58,True,103,2,1,False,True,True,59,1,0,7.732981138896795,44,1
user_005059,33,100k-150k,desktop,returning,East,100,True,63,5,0,True,True,True,61,6,1,6.060869721992455,2,-1
user_005060,55,100k-150k,mobile,new,East,77,True,100,3,0,False,True,True,105,1,0,8.768252590014006,-5,2
user_005061,18,30k-50k,mobile,new,East,89,True,109,3,0,True,True,True,136,4,1,9.437750802797982,-27,-1
user_005062,65,75k-100k,mobile,returning,East,58,True,116,6,0,False,False,True,117,6,0,6.206022848663542,-1,0
user_005063,18,30k-50k,mobile,returning,West,72,True,72,1,0,True,True,True,47,1,0,6.213663679014732,25,0
user_005064,50,30k-50k,mobile,returning,West,46,True,52,2,0,False,False,True,83,3,0,6.770436389277878,-31,-1
user_005065,45,75k-100k,desktop,new,West,50,True,117,3,0,False,False,True,104,1,0,7.844315183686932,13,2
user_005066,43,75k-100k,mobile,returning,Midwest,42,True,31,3,0,False,False,True,25,1,0,8.299531058123533,6,2
user_005067,28,<30k,desktop,new,Midwest,43,True,133,1,0,False,True,True,110,2,0,9.81299120502092,23,-1
user_005068,65,30k-50k,mobile,returning,South,67,True,95,3,0,True,True,True,33,2,0,8.549634260490784,62,1
user_005069,26,<30k,desktop,new,South,57,False,0,0,0,False,True,True,85,2,0,7.579705706575647,-85,-2
user_005070,48,50k-75k,tablet,new,East,35,True,129,4,0,False,True,True,90,1,0,6.68861911397418,39,3
user_005071,47,<30k,desktop,returning,South,20,True,151,3,0,False,False,True,171,3,0,5.6114408149726325,-20,0
user_005072,48,<30k,desktop,returning,East,44,True,73,1,0,False,False,True,64,1,0,9.43621391785632,9,0
user_005073,70,30k-50k,desktop,new,East,19,False,0,0,0,False,False,True,119,1,0,9.669129895597644,-119,-1
user_005074,52,75k-100k,desktop,returning,East,78,True,30,3,0,True,True,True,27,3,1,8.684101597133406,3,0
user_005075,37,50k-75k,mobile,new,South,18,True,160,3,1,False,True,True,154,1,1,8.707225861339563,6,2
user_005076,41,30k-50k,mobile,new,Midwest,53,False,0,0,0,False,True,True,90,1,0,9.3004648743142,-90,-1
user_005077,42,30k-50k,desktop,returning,South,9,True,153,3,0,False,False,True,136,5,2,8.547907925790442,17,-2
user_005078,50,50k-75k,desktop,returning,West,78,True,51,1,0,True,True,True,53,1,0,7.1821279586488425,-2,0
user_005079,33,50k-75k,mobile,returning,West,66,True,56,3,0,False,True,True,32,1,0,8.25870028114475,24,2
user_005080,69,30k-50k,desktop,new,South,58,True,108,2,0,True,True,True,95,2,0,6.5105340098666815,13,0
user_005081,62,30k-50k,mobile,new,South,18,True,195,5,1,False,False,True,200,3,0,7.904675807981386,-5,2
user_005082,53,50k-75k,tablet,new,West,61,True,143,1,0,True,False,True,128,1,0,8.58810945622249,15,0
user_005083,46,75k-100k,mobile,returning,South,31,True,57,4,0,False,True,True,22,8,0,6.76109525024819,35,-4
user_005084,38,75k-100k,desktop,returning,South,43,True,50,3,0,True,False,True,63,5,0,5.893328143866238,-13,-2
user_005085,71,50k-75k,desktop,new,South,30,False,0,0,0,True,False,True,157,2,0,6.288627098210537,-157,-2
user_005086,48,30k-50k,desktop,returning,West,52,True,53,2,0,False,False,True,39,2,0,7.915772709824001,14,0
user_005087,31,50k-75k,desktop,returning,East,64,True,68,4,0,False,True,False,0,0,0,,68,4
user_005088,36,50k-75k,desktop,returning,West,55,True,58,1,0,False,True,True,55,1,0,7.4538914251358435,3,0
user_005089,34,30k-50k,mobile,returning,Midwest,81,True,66,1,0,True,True,True,56,2,0,7.114388122683721,10,-1
user_005090,58,<30k,mobile,new,Midwest,13,True,206,1,0,False,False,True,199,1,0,6.94093687025887,7,0
user_005091,54,>150k,mobile,returning,Midwest,47,True,60,4,1,False,True,True,20,3,0,8.432509841385954,40,1
user_005092,36,30k-50k,mobile,returning,South,43,False,0,0,0,True,True,True,86,1,0,7.708074199303926,-86,-1
user_005093,47,75k-100k,desktop,returning,Midwest,49,True,135,1,0,False,True,True,126,1,0,6.399645962914968,9,0
user_005094,56,100k-150k,mobile,returning,South,50,True,90,1,0,True,True,True,71,1,0,9.293929404881302,19,0
user_005095,48,<30k,desktop,returning,West,59,False,0,0,0,False,False,False,0,0,0,,0,0
user_005096,38,100k-150k,mobile,returning,East,59,True,75,3,0,True,True,True,69,2,0,7.0101834712775295,6,1
user_005097,54,>150k,mobile,new,West,70,True,92,1,0,False,True,True,82,1,0,8.341346504693005,10,0
user_005098,37,50k-75k,desktop,returning,East,63,True,45,1,0,True,False,True,54,2,0,7.9141571919236755,-9,-1
user_005099,38,>150k,mobile,returning,Midwest,41,True,75,9,1,False,True,True,72,9,1,7.896236068742905,3,0
user_005100,70,30k-50k,mobile,returning,South,62,True,98,3,1,False,True,True,91,2,0,8.553942778995395,7,1
user_005101,39,<30k,mobile,returning,South,47,True,81,5,0,False,False,False,0,0,0,,81,5
user_005102,57,50k-75k,desktop,returning,Midwest,29,True,165,4,0,False,False,True,151,4,0,5.995118487132843,14,0
user_005103,42,50k-75k,mobile,new,Midwest,32,True,129,6,1,False,False,True,127,3,0,8.221263207076582,2,3
user_005104,68,30k-50k,desktop,new,Midwest,4,True,161,3,0,True,False,True,146,1,0,8.118628102700027,15,2
user_005105,48,30k-50k,desktop,returning,West,63,True,79,6,0,True,True,True,77,4,0,8.111148007291225,2,2
user_005106,47,<30k,desktop,returning,West,49,True,94,4,0,True,True,True,69,3,0,9.268349389547707,25,1
user_005107,48,50k-75k,desktop,returning,West,54,True,94,2,0,False,False,True,66,1,0,6.370277131877004,28,1
user_005108,32,50k-75k,mobile,returning,South,77,False,0,0,0,True,True,True,96,1,0,9.552280400163037,-96,-1
user_005109,39,30k-50k,tablet,returning,East,55,True,82,2,0,False,False,True,54,1,0,8.214892900491977,28,1
user_005110,21,30k-50k,mobile,new,South,72,True,144,3,0,False,True,True,151,2,0,8.633949663992528,-7,1
user_005111,59,100k-150k,desktop,new,Midwest,59,False,0,0,0,False,False,True,111,1,0,8.693614951138237,-111,-1
user_005112,40,75k-100k,mobile,new,South,53,True,203,3,0,False,False,True,178,1,0,6.697105215257678,25,2
user_005113,30,<30k,desktop,returning,East,33,True,69,2,1,False,False,True,68,1,0,6.443872627108834,1,1
user_005114,50,50k-75k,desktop,new,South,57,True,58,5,0,True,False,True,80,6,0,4.336111867638088,-22,-1
user_005115,48,30k-50k,mobile,new,East,50,True,111,1,0,True,False,True,127,1,1,6.813020703657045,-16,0
user_005116,45,50k-75k,desktop,returning,West,71,True,71,3,0,True,False,True,42,3,0,5.120501443113351,29,0
user_005117,68,30k-50k,desktop,returning,East,42,False,0,0,0,True,True,True,71,1,0,7.36439917223297,-71,-1
user_005118,57,30k-50k,desktop,returning,Midwest,36,True,93,5,0,True,True,True,77,7,0,8.082839951889072,16,-2
user_005119,48,50k-75k,tablet,returning,East,80,True,82,1,0,True,True,True,55,3,0,8.187776296254949,27,-2
user_005120,47,<30k,desktop,returning,South,16,False,0,0,0,True,False,True,134,1,1,8.882911746309677,-134,-1
user_005121,54,75k-100k,tablet,returning,South,37,True,151,2,0,True,False,True,169,2,0,6.9873807823144585,-18,0
user_005122,51,30k-50k,mobile,new,South,21,True,177,8,0,True,False,False,0,0,0,,177,8
user_005123,35,100k-150k,mobile,returning,West,68,True,140,4,0,True,True,True,81,3,0,7.804161735788252,59,1
user_005124,37,50k-75k,desktop,new,South,28,True,128,2,1,False,False,True,139,2,0,5.660670486868222,-11,0
user_005125,42,50k-75k,desktop,returning,West,29,True,105,2,0,True,True,True,56,2,1,8.369278176260774,49,0
user_005126,38,100k-150k,mobile,returning,East,54,True,91,1,0,True,True,True,63,1,0,7.781751151168787,28,0
user_005127,39,<30k,desktop,returning,West,49,False,0,0,0,True,True,True,87,1,0,8.010094406625107,-87,-1
user_005128,42,75k-100k,desktop,returning,East,62,True,121,2,0,False,True,False,0,0,0,,121,2
user_005129,35,50k-75k,desktop,returning,West,55,True,137,2,0,True,False,True,120,2,0,6.554802519854951,17,0
user_005130,40,50k-75k,desktop,new,Midwest,56,True,122,4,0,True,False,True,93,4,0,6.242391968811434,29,0
user_005131,70,30k-50k,desktop,returning,West,31,True,163,5,0,True,True,True,128,6,0,8.367697950348118,35,-1
user_005132,62,50k-75k,desktop,returning,South,14,True,188,1,0,False,False,True,192,1,0,6.07732839784513,-4,0
user_005133,49,>150k,mobile,returning,West,72,True,140,3,0,False,True,True,91,2,0,9.060561048941949,49,1
user_005134,27,<30k,mobile,returning,East,67,True,125,1,0,False,True,True,107,1,0,10.0,18,0
user_005135,60,<30k,mobile,returning,Midwest,53,True,78,3,0,True,True,False,0,0,0,,78,3
user_005136,31,30k-50k,desktop,new,West,94,True,112,2,0,False,False,True,86,3,0,7.830267118673475,26,-1
user_005137,57,50k-75k,mobile,returning,East,39,True,91,6,0,False,False,True,54,2,0,6.58734866178844,37,4
user_005138,48,75k-100k,desktop,returning,East,64,True,109,4,0,True,True,True,101,6,0,8.032413877892331,8,-2
user_005139,35,100k-150k,mobile,returning,West,99,True,76,3,0,True,True,True,62,3,0,9.392504723773447,14,0
user_005140,51,75k-100k,desktop,new,East,24,False,0,0,0,False,False,True,112,1,0,7.307600014425224,-112,-1
user_005141,47,75k-100k,mobile,returning,Midwest,44,True,129,3,0,False,True,True,86,4,0,7.209822375455878,43,-1
user_005142,27,50k-75k,mobile,new,East,62,True,31,6,0,False,True,True,21,5,0,9.81117661452135,10,1
user_005143,53,<30k,desktop,returning,West,51,True,77,1,0,True,True,True,42,3,0,10.0,35,-2
user_005144,42,>150k,desktop,returning,West,57,True,58,3,0,False,True,True,80,1,0,8.220090423931946,-22,2
user_005145,33,75k-100k,desktop,new,East,100,True,141,3,0,True,True,False,0,0,0,,141,3
user_005146,22,50k-75k,mobile,returning,East,72,True,35,3,0,True,True,True,36,3,0,8.908438151750982,-1,0
user_005147,57,50k-75k,mobile,new,East,31,True,146,1,0,False,False,False,0,0,0,,146,1
user_005148,52,<30k,mobile,returning,West,57,True,86,3,0,True,True,True,73,3,0,6.874072711868349,13,0
user_005149,39,30k-50k,desktop,returning,South,27,False,0,0,0,False,True,False,0,0,0,,0,0
user_005150,59,30k-50k,desktop,returning,East,55,True,39,1,0,False,False,True,53,1,0,7.97060569467219,-14,0
user_005151,71,75k-100k,mobile,returning,West,35,True,95,2,1,False,True,True,47,6,0,5.279791240027267,48,-4
user_005152,52,75k-100k,desktop,new,Midwest,42,True,108,1,0,True,False,True,137,1,0,6.462707342277631,-29,0
user_005153,18,30k-50k,desktop,returning,South,51,True,88,2,1,False,True,True,127,3,0,9.134928335234214,-39,-1
user_005154,47,50k-75k,mobile,returning,South,29,True,177,1,2,True,True,True,139,2,0,7.157760614830208,38,-1
user_005155,45,100k-150k,mobile,returning,South,74,False,0,0,0,True,True,True,103,1,0,10.0,-103,-1
user_005156,51,<30k,mobile,returning,West,41,True,55,4,0,True,True,True,25,3,0,10.0,30,1
user_005157,52,75k-100k,desktop,new,West,71,True,109,4,0,True,True,True,53,5,0,7.076912368814262,56,-1
user_005158,54,100k-150k,tablet,returning,East,38,True,107,7,0,False,False,True,128,5,0,8.861531988585613,-21,2
user_005159,62,75k-100k,mobile,returning,West,44,True,87,3,1,True,True,True,60,3,0,8.07870280878087,27,0
user_005160,50,<30k,desktop,new,South,43,False,0,0,0,True,False,False,0,0,0,,0,0
user_005161,34,30k-50k,mobile,returning,Midwest,75,True,93,2,0,True,False,True,51,2,0,8.662322267757046,42,0
user_005162,68,<30k,desktop,new,Midwest,27,False,0,0,0,True,False,False,0,0,0,,0,0
user_005163,40,<30k,tablet,new,East,41,True,111,4,0,True,True,True,111,4,0,8.13575340977161,0,0
user_005164,76,<30k,mobile,returning,South,37,True,97,7,0,False,True,False,0,0,0,,97,7
user_005165,52,30k-50k,mobile,new,South,30,True,151,3,0,False,False,True,192,1,0,5.222372068053907,-41,2
user_005166,30,100k-150k,mobile,returning,East,75,True,39,2,0,False,True,True,20,2,0,8.73723788888665,19,0
user_005167,32,100k-150k,mobile,new,South,53,True,118,3,0,False,True,True,110,3,0,8.568451836524446,8,0
user_005168,28,>150k,mobile,returning,South,68,True,37,1,0,True,True,True,32,1,0,8.196813452613593,5,0
user_005169,26,50k-75k,desktop,new,East,58,True,109,1,0,False,True,True,36,1,0,8.530415097499722,73,0
user_005170,34,75k-100k,mobile,returning,East,57,True,64,1,0,False,True,True,74,1,0,8.079458794094293,-10,0
user_005171,50,30k-50k,mobile,returning,Midwest,28,True,137,3,1,False,True,True,118,2,0,6.160770406766484,19,1
user_005172,38,>150k,mobile,returning,Midwest,77,True,42,2,0,True,True,True,21,2,0,6.944795091064922,21,0
user_005173,18,<30k,desktop,new,East,46,True,71,4,0,False,True,True,47,3,0,7.542377637345864,24,1
user_005174,52,30k-50k,mobile,new,Midwest,26,False,0,0,0,False,False,True,103,1,0,6.851902322009739,-103,-1
user_005175,32,30k-50k,desktop,returning,East,96,True,94,2,0,False,False,True,86,1,0,8.259268370377299,8,1
user_005176,46,100k-150k,desktop,returning,South,79,True,45,7,0,False,False,True,20,7,1,10.0,25,0
user_005177,64,<30k,desktop,returning,East,45,True,130,3,0,True,False,True,146,1,0,8.296556393075011,-16,2
user_005178,26,75k-100k,desktop,new,West,100,True,96,1,0,False,True,True,61,1,0,10.0,35,0
user_005179,18,75k-100k,mobile,new,Midwest,65,True,109,3,0,False,True,True,67,1,0,8.089619478557829,42,2
user_005180,60,50k-75k,mobile,new,West,48,False,0,0,0,False,False,True,129,2,0,5.874052938197725,-129,-2
user_005181,40,30k-50k,mobile,returning,South,29,True,157,6,0,True,True,True,125,3,0,8.157577093249767,32,3
user_005182,58,30k-50k,mobile,returning,South,27,True,189,6,0,False,False,True,209,4,2,8.015808942513384,-20,2
user_005183,62,30k-50k,mobile,returning,East,16,True,125,7,0,True,False,True,153,7,1,7.889957620413123,-28,0
user_005184,50,30k-50k,desktop,new,South,16,True,194,5,0,False,True,True,153,3,0,9.793962097387768,41,2
user_005185,34,<30k,desktop,returning,West,57,True,91,2,0,True,True,False,0,0,0,,91,2
user_005186,71,50k-75k,desktop,new,Midwest,6,True,173,2,1,False,False,False,0,0,0,,173,2
user_005187,73,50k-75k,mobile,new,West,58,True,99,3,0,True,True,True,62,3,0,5.439471841005105,37,0
user_005188,48,30k-50k,mobile,new,South,24,True,144,1,0,False,True,True,71,1,0,8.315806750328306,73,0
user_005189,53,75k-100k,desktop,returning,East,61,True,142,2,0,False,True,False,0,0,0,,142,2
user_005190,47,75k-100k,mobile,new,Midwest,63,True,87,3,1,True,True,True,44,2,0,7.416914136538804,43,1
user_005191,42,30k-50k,desktop,returning,Midwest,52,True,98,1,0,False,False,True,151,1,0,6.79777428297346,-53,0
user_005192,39,<30k,desktop,new,Midwest,46,False,0,0,0,True,True,True,99,1,0,7.4199129830615265,-99,-1
user_005193,64,100k-150k,mobile,returning,West,77,True,116,5,0,True,True,True,89,5,0,9.082182034585138,27,0
user_005194,44,50k-75k,desktop,returning,Midwest,53,True,115,3,0,False,True,True,75,4,0,8.177370937798905,40,-1
user_005195,24,50k-75k,mobile,returning,West,65,True,58,2,0,True,True,True,39,1,0,8.214091482848291,19,1
user_005196,61,50k-75k,desktop,returning,South,26,True,138,6,0,False,False,True,86,6,0,7.750253488019023,52,0
user_005197,31,50k-75k,mobile,returning,East,54,True,126,1,0,True,True,True,134,1,0,9.145903632151667,-8,0
user_005198,34,30k-50k,mobile,returning,East,36,True,60,5,0,True,True,True,50,6,0,9.101108573711453,10,-1
user_005199,38,30k-50k,mobile,returning,West,42,True,106,2,1,False,False,True,120,1,0,6.86636372055568,-14,1
user_005200,53,100k-150k,desktop,returning,South,23,True,90,3,0,False,False,True,88,6,0,3.3390638520357045,2,-3
user_005201,41,50k-75k,mobile,new,West,55,True,133,4,0,False,True,True,119,1,0,8.52849941784733,14,3
user_005202,30,<30k,desktop,returning,East,38,True,102,5,1,True,True,True,99,2,0,6.562004073255989,3,3
user_005203,45,50k-75k,desktop,returning,South,44,True,108,2,0,True,True,True,80,1,0,8.072760610758298,28,1
user_005204,59,30k-50k,mobile,returning,South,41,True,102,5,0,False,True,True,60,4,0,9.78060598213753,42,1
user_005205,78,75k-100k,mobile,returning,South,60,True,127,4,0,True,False,True,134,7,0,6.098071866651116,-7,-3
user_005206,36,75k-100k,desktop,new,South,55,True,106,2,0,False,True,True,88,3,0,8.117770287813325,18,-1
user_005207,45,75k-100k,mobile,new,Midwest,64,True,138,1,0,False,True,True,87,1,1,7.0363523620461415,51,0
user_005208,40,100k-150k,desktop,returning,South,65,True,35,5,0,True,True,True,20,3,0,7.977807641490387,15,2
user_005209,47,30k-50k,mobile,returning,West,57,True,60,3,0,True,True,True,63,2,0,10.0,-3,1
user_005210,32,75k-100k,desktop,new,East,47,True,113,3,0,False,False,True,139,3,0,7.966984273578936,-26,0
user_005211,60,<30k,desktop,returning,West,48,True,135,1,0,True,False,True,115,1,1,7.125220901094126,20,0
user_005212,18,100k-150k,desktop,returning,South,100,True,74,4,1,True,True,True,87,2,0,9.03407052357002,-13,2
user_005213,31,<30k,desktop,returning,South,48,True,72,3,0,False,False,True,71,4,0,5.916726695686427,1,-1
user_005214,31,75k-100k,desktop,new,South,67,False,0,0,0,False,False,True,129,1,0,7.260591993103225,-129,-1
user_005215,44,50k-75k,desktop,returning,South,55,True,44,1,0,False,False,True,20,1,0,7.369788877546203,24,0
user_005216,28,30k-50k,desktop,returning,West,75,True,46,2,0,True,True,True,70,2,0,9.201780888823562,-24,0
user_005217,59,50k-75k,desktop,returning,East,37,True,69,3,2,False,True,True,68,2,0,5.196680564968942,1,1
user_005218,45,30k-50k,desktop,returning,East,31,True,56,5,0,False,True,True,56,5,0,8.611811672679352,0,0
user_005219,40,50k-75k,mobile,returning,East,55,True,73,6,0,False,True,True,88,5,0,5.979439590798208,-15,1
user_005220,80,100k-150k,desktop,returning,East,44,True,138,3,1,False,False,False,0,0,0,,138,3
user_005221,47,75k-100k,desktop,new,South,54,True,129,3,1,False,True,True,100,3,0,8.187944339440667,29,0
user_005222,39,30k-50k,desktop,returning,South,81,True,125,1,1,True,True,True,61,1,0,5.268620061760633,64,0
user_005223,51,100k-150k,mobile,new,South,47,True,57,3,0,False,False,True,75,2,1,8.390828990246865,-18,1
user_005224,26,30k-50k,desktop,returning,East,40,True,72,3,0,False,True,True,52,7,0,7.973158308746828,20,-4
user_005225,18,75k-100k,mobile,new,South,50,False,0,0,0,False,False,True,97,1,0,7.189769722599953,-97,-1
user_005226,38,50k-75k,mobile,new,West,52,True,103,2,0,False,True,True,62,1,0,7.846428792798314,41,1
user_005227,43,50k-75k,desktop,returning,West,65,True,73,3,0,False,True,True,66,2,1,9.85852379194712,7,1
user_005228,43,75k-100k,mobile,returning,West,29,True,123,4,0,False,False,True,147,3,0,10.0,-24,1
user_005229,67,50k-75k,desktop,new,East,63,False,0,0,0,False,False,False,0,0,0,,0,0
user_005230,40,<30k,mobile,new,East,65,True,145,1,0,True,True,True,114,1,0,7.282171360259097,31,0
user_005231,44,<30k,mobile,new,South,15,True,152,5,0,True,False,True,171,6,0,8.276459339501312,-19,-1
user_005232,46,75k-100k,mobile,new,Midwest,35,True,136,3,0,False,False,True,133,1,0,5.952938481929871,3,2
user_005233,47,75k-100k,mobile,returning,South,44,True,81,5,0,True,False,True,89,6,0,6.689203199277906,-8,-1
user_005234,41,30k-50k,desktop,returning,South,37,False,0,0,0,True,True,True,119,1,0,8.927834689921259,-119,-1
user_005235,34,<30k,desktop,returning,South,49,True,65,3,0,False,False,True,53,1,0,5.494748981145079,12,2
user_005236,42,30k-50k,desktop,returning,East,54,True,93,3,0,False,False,True,71,1,0,7.347879109143079,22,2
user_005237,38,75k-100k,desktop,new,West,58,True,104,3,0,False,False,True,97,3,0,7.28428141603549,7,0
user_005238,43,100k-150k,tablet,returning,Midwest,59,True,70,1,0,True,True,True,53,1,0,9.170354237589484,17,0
user_005239,28,100k-150k,desktop,returning,South,75,True,101,3,0,False,True,True,90,3,0,8.361302449619624,11,0
user_005240,36,75k-100k,desktop,returning,East,42,True,88,5,0,False,True,False,0,0,0,,88,5
user_005241,21,75k-100k,desktop,returning,East,74,True,119,1,0,True,True,True,100,1,0,8.092759732249258,19,0
user_005242,39,50k-75k,mobile,returning,East,32,True,122,1,0,True,True,True,52,1,0,7.145030861734264,70,0
user_005243,28,50k-75k,mobile,returning,West,87,True,44,7,0,False,True,True,44,1,0,9.054485478565901,0,6
user_005244,36,100k-150k,desktop,returning,South,53,True,83,1,1,True,True,True,37,1,0,8.503050859087942,46,0
user_005245,69,30k-50k,mobile,returning,East,24,False,0,0,0,False,True,True,71,3,0,6.786188920712948,-71,-3
user_005246,21,30k-50k,mobile,returning,East,70,True,150,3,1,True,True,True,83,3,0,6.15825791435158,67,0
user_005247,23,100k-150k,mobile,new,East,83,True,86,3,0,True,True,True,70,4,0,8.358616262529832,16,-1
user_005248,52,75k-100k,desktop,new,West,82,True,83,4,0,True,True,True,76,3,0,9.632647959424872,7,1
user_005249,59,100k-150k,mobile,returning,West,40,True,117,5,1,False,True,True,78,4,0,5.738765495618979,39,1
user_005250,57,100k-150k,mobile,returning,Midwest,39,True,99,3,0,False,False,True,98,1,0,6.080145566544168,1,2
user_005251,37,50k-75k,desktop,returning,East,61,True,93,2,0,True,True,True,70,1,0,8.194405643146899,23,1
user_005252,53,<30k,desktop,returning,East,24,True,103,3,0,True,True,True,88,1,0,7.5654771051736756,15,2
user_005253,46,<30k,mobile,new,Midwest,30,False,0,0,0,False,False,True,139,2,0,5.682449906255772,-139,-2
user_005254,39,75k-100k,desktop,new,West,30,True,130,7,1,False,True,True,131,4,0,8.197631168072784,-1,3
user_005255,18,75k-100k,mobile,returning,Midwest,54,True,109,1,0,False,False,True,105,3,0,5.751357821502775,4,-2
user_005256,30,100k-150k,desktop,returning,East,49,True,118,4,1,True,True,False,0,0,0,,118,4
user_005257,58,50k-75k,desktop,new,South,31,True,101,4,0,False,False,True,83,6,0,7.039336844552395,18,-2
user_005258,32,<30k,desktop,returning,East,71,True,48,2,0,True,True,True,55,1,0,8.299989781626106,-7,1
user_005259,18,30k-50k,desktop,returning,West,62,True,108,6,0,True,True,True,92,6,0,7.644978784606664,16,0
user_005260,52,75k-100k,mobile,returning,Midwest,49,True,104,2,0,False,False,True,104,1,0,7.29126067578098,0,1
user_005261,39,50k-75k,mobile,new,East,69,True,107,4,0,False,True,True,93,4,0,4.473515094209475,14,0
user_005262,56,30k-50k,mobile,returning,South,8,True,165,6,0,False,False,True,154,8,0,7.5196910053648685,11,-2
user_005263,40,30k-50k,mobile,new,Midwest,35,False,0,0,0,False,True,True,101,1,0,7.124216340604333,-101,-1
user_005264,28,75k-100k,mobile,returning,East,60,True,90,4,0,True,True,True,60,3,0,9.626352236501981,30,1
user_005265,56,30k-50k,mobile,new,South,35,False,0,0,0,False,False,False,0,0,0,,0,0
user_005266,44,<30k,desktop,new,Midwest,34,False,0,0,0,False,False,False,0,0,0,,0,0
user_005267,32,<30k,mobile,new,East,35,True,103,7,0,False,True,True,53,10,0,8.678299030691802,50,-3
user_005268,61,50k-75k,desktop,new,West,73,False,0,0,0,True,True,False,0,0,0,,0,0
user_005269,18,30k-50k,desktop,new,East,58,True,137,1,1,False,True,True,108,1,0,6.731073316335239,29,0
user_005270,61,50k-75k,mobile,new,South,13,False,0,0,0,False,True,True,138,1,0,6.853068770519012,-138,-1
user_005271,45,30k-50k,mobile,new,South,60,True,82,1,0,False,False,True,127,1,0,7.037673619878194,-45,0
user_005272,70,50k-75k,desktop,new,Midwest,27,False,0,0,0,False,False,True,120,1,0,6.9726941833265865,-120,-1
user_005273,56,<30k,desktop,returning,South,25,True,139,1,0,False,True,True,103,1,0,7.855742759416024,36,0
user_005274,30,100k-150k,mobile,new,Midwest,82,True,173,4,0,False,True,True,160,2,0,6.400235679207986,13,2
user_005275,18,<30k,desktop,returning,Midwest,55,True,90,2,0,True,True,True,49,1,0,7.647044621728057,41,1
user_005276,30,75k-100k,desktop,returning,South,49,True,30,2,0,False,True,True,23,2,1,5.310710237087112,7,0
user_005277,29,100k-150k,desktop,new,East,95,True,131,2,0,True,True,False,0,0,0,,131,2
user_005278,38,75k-100k,mobile,new,Midwest,37,True,92,3,0,False,True,True,85,3,0,5.450576466130223,7,0
user_005279,58,100k-150k,desktop,returning,West,32,True,102,5,0,True,False,True,95,6,0,5.704917308248176,7,-1
user_005280,65,30k-50k,desktop,returning,East,29,True,168,5,0,True,False,True,156,4,0,7.620093605721027,12,1
user_005281,67,75k-100k,mobile,new,East,62,True,161,1,0,False,False,True,142,1,0,7.361625586193539,19,0
user_005282,36,100k-150k,desktop,returning,South,76,True,52,1,0,True,True,True,65,1,0,6.938367465637372,-13,0
user_005283,23,30k-50k,desktop,returning,East,100,True,86,1,0,False,True,True,61,1,0,8.709389354330293,25,0
user_005284,36,100k-150k,mobile,new,South,83,True,96,2,0,True,True,True,77,1,0,10.0,19,1
user_005285,36,100k-150k,mobile,returning,Midwest,47,True,97,2,0,False,False,True,83,4,0,7.65306837847827,14,-2
user_005286,48,100k-150k,mobile,new,East,52,True,108,1,0,False,True,True,90,1,0,9.239840273841647,18,0
user_005287,47,30k-50k,desktop,returning,East,50,True,105,2,0,True,False,True,84,2,1,7.640960525006483,21,0
user_005288,33,75k-100k,desktop,new,West,73,True,77,4,0,False,True,True,38,4,0,8.906232343232555,39,0
user_005289,56,30k-50k,mobile,returning,South,49,True,108,4,0,True,False,True,69,4,0,8.587581142714539,39,0
user_005290,59,75k-100k,desktop,returning,East,17,False,0,0,0,True,False,True,138,3,0,8.217901528616892,-138,-3
user_005291,51,>150k,desktop,returning,West,80,True,80,3,0,False,False,True,85,1,0,7.862926965841474,-5,2
user_005292,49,75k-100k,desktop,returning,West,38,True,48,3,0,False,False,False,0,0,0,,48,3
user_005293,24,100k-150k,mobile,returning,South,67,True,80,4,0,False,True,False,0,0,0,,80,4
user_005294,61,30k-50k,mobile,new,Midwest,45,True,102,3,0,False,False,True,98,2,0,4.538035869345724,4,1
user_005295,59,50k-75k,tablet,returning,South,25,False,0,0,0,True,True,True,125,1,0,8.585807866223501,-125,-1
user_005296,38,75k-100k,mobile,new,Midwest,33,True,91,3,0,True,True,True,72,1,0,8.233650054800233,19,2
user_005297,26,50k-75k,desktop,returning,Midwest,81,True,119,2,0,True,True,True,76,3,0,8.505048563700582,43,-1
user_005298,18,75k-100k,mobile,returning,East,52,True,102,3,0,True,True,True,68,7,0,8.91289527109767,34,-4
user_005299,54,100k-150k,tablet,new,East,69,True,102,1,0,True,True,True,64,1,0,8.30617665500954,38,0
user_005300,25,50k-75k,mobile,returning,Midwest,59,True,30,1,1,True,True,True,55,2,1,9.437790122300818,-25,-1
user_005301,58,<30k,desktop,returning,South,27,True,119,3,1,True,False,True,147,2,0,4.459342857620333,-28,1
user_005302,66,30k-50k,desktop,new,Midwest,32,True,167,4,0,False,True,True,128,3,0,7.989483083007776,39,1
user_005303,53,100k-150k,mobile,returning,East,52,True,92,5,0,True,True,False,0,0,0,,92,5
user_005304,55,30k-50k,mobile,returning,South,37,True,43,7,2,False,False,True,69,11,0,6.024782543606703,-26,-4
user_005305,24,100k-150k,desktop,returning,West,83,True,53,4,0,False,True,True,36,2,0,8.969129320834558,17,2
user_005306,56,30k-50k,mobile,returning,Midwest,32,True,130,3,0,True,True,True,86,1,1,7.5102353475060974,44,2
user_005307,45,<30k,mobile,returning,West,72,True,112,5,0,False,True,True,103,3,0,8.63702543134967,9,2
user_005308,27,50k-75k,mobile,returning,East,70,True,128,5,0,False,True,True,128,4,0,6.678016795428555,0,1
user_005309,40,75k-100k,mobile,new,West,58,True,111,7,0,False,False,True,130,7,0,10.0,-19,0
user_005310,39,<30k,mobile,new,South,41,False,0,0,0,False,False,True,80,1,0,7.254928500611414,-80,-1
user_005311,56,<30k,desktop,returning,South,28,True,129,3,0,True,False,True,124,1,0,7.015231583820753,5,2
user_005312,26,<30k,desktop,new,West,69,False,0,0,0,True,True,True,71,1,0,7.270515735347913,-71,-1
user_005313,73,75k-100k,desktop,returning,East,30,True,118,2,0,False,False,True,133,3,1,8.932897713507435,-15,-1
user_005314,29,50k-75k,desktop,returning,West,100,True,30,3,0,False,True,True,20,3,0,9.610591494658701,10,0
user_005315,37,100k-150k,desktop,new,East,68,True,188,1,0,False,True,True,126,1,0,8.162045886305688,62,0
user_005316,18,75k-100k,mobile,returning,South,90,True,161,1,0,True,True,True,101,1,0,6.291683441817531,60,0
user_005317,54,<30k,mobile,returning,East,36,True,101,3,0,True,False,True,104,3,0,4.811409906917419,-3,0
user_005318,18,30k-50k,desktop,returning,East,65,True,100,2,0,True,True,True,63,1,1,8.11643116360139,37,1
user_005319,77,100k-150k,desktop,returning,Midwest,47,True,102,4,1,False,True,True,90,1,0,8.531227281902236,12,3
user_005320,57,75k-100k,desktop,returning,South,11,False,0,0,0,True,True,True,98,1,0,8.363649563208922,-98,-1
user_005321,46,<30k,mobile,new,East,35,True,124,4,0,True,True,False,0,0,0,,124,4
user_005322,19,30k-50k,desktop,new,West,59,False,0,0,0,False,False,True,89,1,0,6.7849847047457805,-89,-1
user_005323,50,<30k,tablet,new,Midwest,30,True,96,5,0,True,False,False,0,0,0,,96,5
user_005324,80,50k-75k,desktop,new,West,73,True,94,3,0,True,False,True,99,6,0,6.696301113232545,-5,-3
user_005325,80,<30k,mobile,returning,West,18,False,0,0,0,True,True,True,78,1,1,8.363963776949412,-78,-1
user_005326,44,75k-100k,mobile,returning,West,33,True,60,6,0,True,True,True,33,4,0,9.112520650241343,27,2
user_005327,66,100k-150k,mobile,new,Midwest,23,True,144,7,0,False,True,True,89,8,0,6.228324411159538,55,-1
user_005328,18,>150k,tablet,returning,East,72,True,55,4,1,False,True,True,24,4,0,7.666518196180304,31,0
user_005329,44,30k-50k,tablet,returning,East,69,True,135,5,0,True,False,True,152,3,0,8.499434930020346,-17,2
user_005330,18,100k-150k,mobile,new,West,100,True,106,2,0,False,True,True,72,1,1,9.260608947916467,34,1
user_005331,48,<30k,tablet,returning,Midwest,65,True,81,3,0,False,True,True,70,4,0,7.517230623496644,11,-1
user_005332,55,100k-150k,desktop,new,East,63,True,129,7,0,False,False,True,130,6,0,7.9943582603923415,-1,1
user_005333,31,75k-100k,desktop,returning,East,79,True,85,2,0,False,True,True,51,2,0,7.23708846804883,34,0
user_005334,57,50k-75k,desktop,returning,South,17,True,134,5,0,True,False,True,141,5,0,6.846435858356058,-7,0
user_005335,39,30k-50k,desktop,returning,Midwest,31,True,154,3,0,False,True,True,108,1,0,7.342851130911377,46,2
user_005336,24,75k-100k,desktop,returning,East,50,True,79,2,1,False,False,True,91,1,0,5.931708747828238,-12,1
user_005337,54,50k-75k,mobile,new,West,41,True,94,1,1,True,True,True,91,3,0,7.693564750262123,3,-2
user_005338,40,50k-75k,mobile,returning,South,60,True,91,7,0,True,False,True,67,10,0,7.212287967504942,24,-3
user_005339,53,<30k,mobile,new,West,62,True,123,1,0,False,True,True,63,1,0,9.035494725306572,60,0
user_005340,40,50k-75k,desktop,returning,Midwest,40,True,142,1,0,False,True,True,103,1,0,8.74858678493612,39,0
user_005341,18,50k-75k,mobile,returning,Midwest,64,False,0,0,0,True,True,False,0,0,0,,0,0
user_005342,54,75k-100k,mobile,returning,Midwest,48,True,71,3,0,False,True,True,68,2,1,8.165168378559034,3,1
user_005343,31,>150k,mobile,returning,West,93,False,0,0,0,True,False,True,159,1,0,6.963976688949258,-159,-1
user_005344,22,75k-100k,desktop,returning,Midwest,77,True,85,2,0,True,True,True,57,2,0,8.720265510946032,28,0
user_005345,48,100k-150k,desktop,returning,South,32,True,86,2,0,False,True,True,95,1,0,7.159395582374552,-9,1
user_005346,44,75k-100k,mobile,returning,South,20,True,134,3,0,False,False,True,123,6,0,6.846578465684107,11,-3
user_005347,68,75k-100k,desktop,returning,South,17,True,92,3,0,False,False,True,123,2,0,8.010701197241678,-31,1
user_005348,59,75k-100k,mobile,returning,South,12,True,153,3,1,True,True,True,146,2,0,5.53241411638057,7,1
user_005349,27,75k-100k,mobile,returning,Midwest,74,True,94,6,0,True,True,True,69,3,0,9.080099972551688,25,3
user_005350,41,50k-75k,mobile,returning,Midwest,36,True,59,1,0,False,True,True,69,1,0,8.540324410237448,-10,0
user_005351,39,50k-75k,desktop,returning,East,40,True,83,4,0,False,False,True,82,5,0,7.197466986533515,1,-1
user_005352,47,30k-50k,desktop,new,East,51,True,170,3,0,False,False,True,155,6,0,7.000231581441514,15,-3
user_005353,53,>150k,tablet,returning,Midwest,65,True,80,3,0,False,True,True,71,3,1,7.5965831827721635,9,0
user_005354,62,>150k,mobile,returning,East,60,True,132,2,0,False,True,True,85,4,0,7.289885989671233,47,-2
user_005355,34,100k-150k,desktop,returning,South,69,False,0,0,0,True,True,True,127,1,0,8.069003492304336,-127,-1
user_005356,49,75k-100k,mobile,returning,East,31,True,85,4,1,False,True,True,34,4,0,5.6839233417097015,51,0
user_005357,28,50k-75k,desktop,new,South,45,True,177,1,0,False,True,True,129,2,0,8.435842448596356,48,-1
user_005358,38,30k-50k,mobile,returning,East,51,False,0,0,0,False,True,True,103,1,0,6.040299664691799,-103,-1
user_005359,28,75k-100k,mobile,returning,East,34,False,0,0,0,True,True,True,77,1,1,7.729594099065895,-77,-1
user_005360,52,50k-75k,mobile,returning,East,40,True,120,3,0,False,False,True,182,3,0,7.513272326846399,-62,0
user_005361,73,30k-50k,mobile,returning,Midwest,42,True,93,3,0,True,True,True,59,3,0,5.544696667765478,34,0
user_005362,43,<30k,desktop,returning,South,31,False,0,0,0,False,True,True,67,1,1,8.241643845612783,-67,-1
user_005363,18,100k-150k,tablet,returning,West,100,False,0,0,0,False,True,True,92,1,0,7.449950429730616,-92,-1
user_005364,52,100k-150k,mobile,new,East,52,True,79,5,0,False,True,True,39,2,0,7.957430914452694,40,3
user_005365,38,100k-150k,desktop,returning,South,50,True,107,2,0,False,False,True,124,1,0,6.348109339156823,-17,1
user_005366,27,50k-75k,mobile,new,East,68,True,102,2,1,True,False,True,116,2,0,4.9071944618263235,-14,0
user_005367,57,30k-50k,mobile,new,West,71,False,0,0,0,True,True,True,88,1,0,9.235244319051729,-88,-1
user_005368,27,30k-50k,desktop,returning,East,81,True,77,2,0,False,True,True,72,3,1,7.66958877105476,5,-1
user_005369,70,75k-100k,mobile,returning,East,33,True,82,4,0,False,False,True,83,5,0,6.987993084781159,-1,-1
user_005370,20,75k-100k,mobile,new,East,62,True,128,4,0,False,True,True,119,4,0,6.858640510890566,9,0
user_005371,50,75k-100k,mobile,returning,South,32,True,156,7,0,False,True,True,103,1,1,9.037611330575633,53,6
user_005372,36,>150k,mobile,returning,Midwest,61,True,104,4,0,True,True,True,80,2,0,6.400921332488264,24,2
user_005373,19,75k-100k,desktop,returning,South,67,True,80,3,0,False,True,True,83,4,1,6.869205836909102,-3,-1
user_005374,21,<30k,mobile,returning,West,53,True,30,3,0,True,False,False,0,0,0,,30,3
user_005375,36,100k-150k,desktop,returning,Midwest,54,True,78,2,0,False,False,True,69,2,0,8.593721324120091,9,0
user_005376,24,50k-75k,desktop,new,West,88,True,88,4,0,False,True,True,52,5,0,7.992875724745112,36,-1
user_005377,25,50k-75k,mobile,returning,East,82,True,52,1,0,True,True,True,20,1,0,10.0,32,0
user_005378,33,30k-50k,desktop,returning,Midwest,68,False,0,0,0,False,False,True,122,1,0,8.818895990688931,-122,-1
user_005379,52,100k-150k,desktop,returning,South,46,True,63,2,0,True,False,True,81,4,0,7.580872527204679,-18,-2
user_005380,47,>150k,mobile,new,Midwest,52,False,0,0,0,False,False,True,137,2,0,7.788275299555675,-137,-2
user_005381,25,50k-75k,mobile,returning,Midwest,50,True,111,3,1,True,True,True,111,3,0,8.736432277384456,0,0
user_005382,53,75k-100k,desktop,returning,Midwest,38,True,133,2,0,False,False,True,146,1,0,5.389404307118402,-13,1
user_005383,53,75k-100k,desktop,returning,Midwest,55,True,65,2,0,False,False,True,57,3,0,4.758861586897211,8,-1
user_005384,40,100k-150k,desktop,returning,South,37,True,121,1,1,False,True,True,125,2,0,7.184605035533645,-4,-1
user_005385,33,75k-100k,desktop,new,West,63,True,108,2,0,True,True,True,97,1,0,9.985645254410715,11,1
user_005386,53,30k-50k,desktop,returning,Midwest,39,True,61,1,0,True,True,True,43,1,0,8.180806582611893,18,0
user_005387,52,75k-100k,mobile,returning,South,68,True,108,2,0,True,True,True,56,2,0,9.784989172172374,52,0
user_005388,25,<30k,desktop,new,South,67,True,125,1,0,True,True,True,111,1,0,10.0,14,0
user_005389,66,30k-50k,mobile,new,West,69,True,116,2,0,True,False,True,112,2,0,9.57016542555809,4,0
user_005390,51,50k-75k,desktop,returning,South,23,False,0,0,0,False,True,True,71,1,0,8.688516492170136,-71,-1
user_005391,38,<30k,mobile,returning,East,62,True,93,5,0,True,True,True,108,3,0,7.375934726697825,-15,2
user_005392,45,<30k,desktop,new,West,9,True,174,4,1,False,False,True,172,3,0,4.900165373355494,2,1
user_005393,19,75k-100k,desktop,returning,East,49,True,77,1,0,True,True,False,0,0,0,,77,1
user_005394,27,100k-150k,desktop,returning,South,83,True,84,5,0,True,True,True,67,6,0,10.0,17,-1
user_005395,35,30k-50k,desktop,new,East,57,True,173,2,0,False,False,False,0,0,0,,173,2
user_005396,53,<30k,desktop,returning,West,66,True,158,3,0,True,False,True,207,1,0,5.704498010597173,-49,2
user_005397,80,30k-50k,mobile,new,South,36,False,0,0,0,False,True,True,78,4,0,7.05546023677999,-78,-4
user_005398,45,100k-150k,mobile,new,West,72,True,96,9,0,True,True,True,82,6,0,5.295844568474372,14,3
user_005399,46,75k-100k,mobile,new,West,63,True,110,1,0,False,True,True,84,2,1,10.0,26,-1
user_005400,64,50k-75k,mobile,returning,West,71,True,58,1,0,True,True,True,40,1,0,8.059419413677865,18,0
user_005401,57,50k-75k,mobile,new,East,36,True,122,2,0,False,False,True,105,2,0,7.34179217246076,17,0
user_005402,51,100k-150k,mobile,new,Midwest,72,True,131,4,0,True,True,True,95,1,0,6.403413353960706,36,3
user_005403,38,30k-50k,mobile,new,Midwest,48,True,94,1,1,False,False,True,70,3,1,9.070336940267495,24,-2
user_005404,37,100k-150k,desktop,returning,South,41,True,85,10,0,False,False,True,104,12,0,8.237411186713047,-19,-2
user_005405,54,<30k,desktop,returning,South,19,False,0,0,0,False,False,True,97,1,0,6.193037708436061,-97,-1
user_005406,26,>150k,desktop,new,Midwest,67,True,151,4,0,True,True,True,120,2,1,8.523744813611398,31,2
user_005407,36,75k-100k,mobile,returning,West,40,True,30,2,0,True,True,True,20,2,1,7.881650774394178,10,0
user_005408,59,75k-100k,tablet,returning,West,55,True,107,5,0,True,False,True,105,7,0,7.825105451734005,2,-2
user_005409,53,<30k,mobile,new,South,17,True,169,6,0,True,False,True,156,8,0,5.266447332975251,13,-2
user_005410,59,50k-75k,desktop,new,Midwest,22,True,171,2,1,False,False,False,0,0,0,,171,2
user_005411,26,30k-50k,desktop,new,West,86,True,119,5,0,False,True,True,101,2,0,9.450385578108907,18,3
user_005412,54,75k-100k,desktop,returning,West,59,True,40,1,0,False,True,True,20,1,0,7.395108568768145,20,0
user_005413,63,75k-100k,mobile,returning,South,26,True,119,4,0,False,False,True,110,3,1,8.419381647589267,9,1
user_005414,46,50k-75k,mobile,new,West,58,True,107,3,0,True,False,True,127,4,0,7.116974306069529,-20,-1
user_005415,18,75k-100k,desktop,returning,East,100,False,0,0,0,True,True,True,103,1,0,9.34661988240467,-103,-1
user_005416,40,>150k,mobile,returning,South,57,True,78,1,0,False,True,True,69,1,0,8.249288308923871,9,0
user_005417,64,>150k,mobile,new,East,58,True,84,8,0,False,True,True,71,5,0,8.99979082965499,13,3
user_005418,30,100k-150k,desktop,returning,West,100,False,0,0,0,False,True,True,94,1,0,8.401604924759605,-94,-1
user_005419,41,30k-50k,desktop,returning,South,41,True,99,3,0,True,True,True,95,3,0,7.3427630667599955,4,0
user_005420,25,50k-75k,mobile,returning,South,79,True,53,2,1,True,True,False,0,0,0,,53,2
user_005421,58,30k-50k,mobile,returning,Midwest,18,False,0,0,0,False,False,True,119,3,0,5.912422376913208,-119,-3
user_005422,51,<30k,desktop,returning,West,67,True,124,1,0,True,True,True,56,1,0,7.882600542868399,68,0
user_005423,24,75k-100k,desktop,returning,Midwest,55,True,75,1,0,False,True,True,69,1,0,7.001788324262742,6,0
user_005424,52,<30k,mobile,returning,East,38,True,107,10,0,True,True,True,59,9,1,7.4772844146639645,48,1
user_005425,46,<30k,desktop,returning,South,36,True,132,5,0,False,True,True,124,7,0,7.852362526599312,8,-2
user_005426,19,75k-100k,mobile,returning,South,67,True,63,4,0,True,True,True,59,1,1,10.0,4,3
user_005427,71,50k-75k,desktop,new,Midwest,50,True,157,3,0,False,True,True,103,4,0,6.917687363516387,54,-1
user_005428,26,30k-50k,mobile,returning,Midwest,49,True,69,4,0,True,True,True,44,3,0,8.028481321185422,25,1
user_005429,45,30k-50k,desktop,returning,South,62,True,81,3,0,True,True,True,80,3,0,6.3909563025519915,1,0
user_005430,36,50k-75k,mobile,returning,East,72,True,62,4,0,True,True,True,54,2,0,9.004998559646332,8,2
user_005431,48,<30k,mobile,returning,East,37,True,90,5,0,False,False,True,54,3,0,7.299460830556315,36,2
user_005432,67,75k-100k,mobile,new,East,43,True,90,4,0,False,True,True,54,5,0,7.672510859795351,36,-1
user_005433,50,30k-50k,desktop,new,West,69,True,119,4,1,True,True,True,129,3,0,7.096042490332432,-10,1
user_005434,23,<30k,desktop,returning,South,22,True,159,5,0,False,True,True,120,7,0,7.074233170818203,39,-2
user_005435,51,<30k,desktop,new,West,38,False,0,0,0,False,False,False,0,0,0,,0,0
user_005436,46,100k-150k,mobile,new,West,69,True,158,6,0,True,True,True,133,8,0,8.548044976381556,25,-2
user_005437,57,50k-75k,desktop,returning,South,31,True,104,1,0,True,False,True,130,1,0,5.516862179316046,-26,0
user_005438,70,50k-75k,desktop,returning,East,42,True,113,4,2,False,True,False,0,0,0,,113,4
user_005439,41,75k-100k,desktop,returning,East,61,True,131,2,0,True,False,True,155,3,0,6.879572189917637,-24,-1
user_005440,26,75k-100k,mobile,new,East,87,True,63,2,0,False,True,True,59,1,0,7.923468818897432,4,1
user_005441,54,<30k,mobile,new,West,39,True,106,4,0,False,False,True,108,5,0,7.721777403240387,-2,-1
user_005442,41,50k-75k,mobile,returning,East,56,True,76,6,0,True,True,True,69,3,0,8.617377927116774,7,3
user_005443,56,50k-75k,mobile,returning,Midwest,20,True,119,6,1,True,True,True,88,10,0,6.60595998518819,31,-4
user_005444,52,50k-75k,mobile,returning,South,42,True,118,1,0,True,True,True,89,1,1,9.29092882905161,29,0
user_005445,45,75k-100k,desktop,returning,West,48,True,92,2,0,False,False,True,108,2,0,9.280052873976038,-16,0
user_005446,18,<30k,desktop,returning,East,56,True,78,3,0,False,True,True,61,2,0,8.201815762643667,17,1
user_005447,53,75k-100k,mobile,new,South,53,True,161,2,0,False,False,True,144,2,1,6.684133116337209,17,0
user_005448,41,75k-100k,desktop,returning,East,37,True,110,3,0,False,False,True,103,4,0,6.368161531611778,7,-1
user_005449,65,30k-50k,mobile,new,Midwest,15,True,187,6,0,True,True,True,151,5,0,6.8013552184467745,36,1
user_005450,50,50k-75k,desktop,new,Midwest,47,True,133,2,0,True,False,True,132,1,0,9.183355910581065,1,1
user_005451,63,50k-75k,mobile,new,East,35,True,120,3,0,True,False,True,135,4,0,4.267006242294008,-15,-1
user_005452,28,30k-50k,mobile,new,West,67,False,0,0,0,True,False,True,109,2,0,6.82949102782924,-109,-2
user_005453,42,100k-150k,mobile,returning,South,60,True,141,1,0,True,True,True,112,1,0,7.642365511772685,29,0
user_005454,52,30k-50k,desktop,new,East,56,True,123,3,0,False,False,True,100,4,0,6.802841057085554,23,-1
user_005455,56,50k-75k,mobile,returning,East,25,True,143,6,0,True,True,True,98,6,0,8.176805457033163,45,0
user_005456,59,30k-50k,mobile,new,East,45,True,167,2,0,False,True,True,121,2,0,6.995353325206494,46,0
user_005457,67,75k-100k,desktop,returning,East,12,True,198,4,2,True,False,True,184,7,0,6.823130039835891,14,-3
user_005458,72,<30k,mobile,returning,East,23,False,0,0,0,True,True,False,0,0,0,,0,0
user_005459,39,50k-75k,desktop,returning,East,62,True,103,1,0,False,True,True,99,1,0,7.776381193363028,4,0
user_005460,31,30k-50k,desktop,new,East,47,True,149,2,0,False,False,False,0,0,0,,149,2
user_005461,56,75k-100k,desktop,returning,Midwest,42,True,160,3,0,False,False,True,179,1,0,6.366827855377501,-19,2
user_005462,48,30k-50k,mobile,new,West,80,True,79,3,1,False,True,True,63,1,0,6.146004390271961,16,2
user_005463,34,30k-50k,desktop,returning,East,69,True,85,2,0,True,True,True,134,1,0,9.044667681412474,-49,1
user_005464,60,50k-75k,mobile,returning,East,63,False,0,0,0,False,False,False,0,0,0,,0,0
user_005465,39,50k-75k,mobile,returning,South,37,True,36,8,1,False,False,True,42,12,0,6.850391622613409,-6,-4
user_005466,29,50k-75k,mobile,new,East,56,True,59,2,0,False,False,True,57,4,0,4.69518005597695,2,-2
user_005467,54,>150k,mobile,new,West,88,True,95,1,0,False,True,False,0,0,0,,95,1
user_005468,45,<30k,mobile,returning,East,45,True,51,2,1,False,False,True,76,1,2,8.914008498755386,-25,1
user_005469,61,30k-50k,desktop,new,East,24,True,106,1,1,False,False,True,112,1,0,5.930716330507206,-6,0
user_005470,26,30k-50k,mobile,new,South,53,True,166,3,0,False,True,True,119,1,0,9.109572758398759,47,2
user_005471,42,50k-75k,desktop,returning,East,70,True,107,2,0,True,True,True,100,2,0,7.1699297565760265,7,0
user_005472,46,<30k,desktop,returning,Midwest,45,True,30,1,0,True,False,False,0,0,0,,30,1
user_005473,35,<30k,desktop,new,East,25,True,195,4,1,True,False,True,218,4,0,6.372148623204422,-23,0
user_005474,57,75k-100k,mobile,returning,South,1,True,159,3,0,False,False,True,160,4,0,8.297940661494446,-1,-1
user_005475,23,75k-100k,desktop,returning,East,40,True,107,4,1,True,False,True,78,4,0,8.563031918367988,29,0
user_005476,34,30k-50k,desktop,new,South,79,True,107,9,0,True,True,True,88,8,0,7.472203839286273,19,1
user_005477,40,<30k,desktop,returning,South,32,True,140,5,0,False,True,True,159,9,0,9.861183165919998,-19,-4
user_005478,37,100k-150k,mobile,returning,West,80,True,91,4,0,True,True,True,123,2,0,7.921773175697886,-32,2
user_005479,39,75k-100k,desktop,returning,West,57,True,70,3,0,False,False,True,76,6,0,7.2331865590808055,-6,-3
user_005480,18,100k-150k,desktop,returning,West,90,True,30,4,1,True,True,True,24,1,0,8.807312997860981,6,3
user_005481,32,30k-50k,desktop,new,Midwest,79,True,120,3,0,True,True,True,64,3,0,8.84465526805984,56,0
user_005482,47,75k-100k,mobile,new,Midwest,30,False,0,0,0,False,True,True,106,1,0,7.358231302629235,-106,-1
user_005483,61,30k-50k,desktop,new,West,47,True,93,3,1,True,False,False,0,0,0,,93,3
user_005484,60,75k-100k,desktop,new,South,24,True,206,3,0,False,False,True,213,3,0,7.378599610290113,-7,0
user_005485,31,50k-75k,mobile,new,Midwest,46,True,139,5,0,False,True,True,125,4,0,6.557220954007516,14,1
user_005486,41,30k-50k,mobile,returning,Midwest,52,True,70,3,0,True,True,True,51,5,0,5.363474294642844,19,-2
user_005487,35,100k-150k,mobile,returning,Midwest,56,True,52,1,0,False,False,True,35,3,0,8.43455735511054,17,-2
user_005488,32,75k-100k,mobile,returning,Midwest,47,True,30,3,0,False,True,True,20,4,0,9.609328517116802,10,-1
user_005489,54,30k-50k,desktop,returning,South,34,True,133,8,0,False,True,True,96,4,0,5.8356773339705015,37,4
user_005490,52,75k-100k,mobile,returning,West,68,True,76,3,0,True,True,True,73,5,0,10.0,3,-2
user_005491,31,>150k,mobile,returning,East,48,True,110,5,0,True,True,True,75,4,0,9.869047299603602,35,1
user_005492,35,75k-100k,tablet,returning,South,22,True,111,7,0,False,True,True,106,8,0,8.14609242463267,5,-1
user_005493,69,50k-75k,mobile,returning,Midwest,27,False,0,0,0,True,False,True,117,1,0,6.737224304212335,-117,-1
user_005494,30,50k-75k,mobile,returning,Midwest,65,True,76,3,0,True,True,True,79,2,0,6.989819090065327,-3,1
user_005495,22,<30k,desktop,new,Midwest,56,False,0,0,0,False,True,False,0,0,0,,0,0
user_005496,33,50k-75k,mobile,returning,West,70,True,96,3,0,False,True,True,97,2,0,8.576066029724062,-1,1
user_005497,31,75k-100k,desktop,returning,East,72,True,72,4,1,True,True,True,71,2,0,8.036371252670648,1,2
user_005498,56,30k-50k,mobile,returning,West,44,True,41,1,0,False,True,True,26,3,0,8.504827011916067,15,-2
user_005499,56,<30k,desktop,returning,East,55,False,0,0,0,True,True,True,58,1,0,9.119052988686432,-58,-1
user_005500,32,30k-50k,desktop,returning,East,82,True,68,1,2,True,True,True,73,1,0,6.860461378708401,-5,0
user_005501,26,75k-100k,mobile,returning,West,84,True,65,1,0,True,True,True,60,1,1,9.552128312808012,5,0
user_005502,47,75k-100k,mobile,new,West,44,True,114,2,0,False,True,True,115,2,0,8.609663651610774,-1,0
user_005503,39,>150k,desktop,returning,West,59,True,105,1,0,True,True,True,57,1,0,7.091204056710445,48,0
user_005504,58,75k-100k,mobile,returning,South,24,True,100,4,0,True,False,True,112,3,1,7.85088162685073,-12,1
user_005505,76,30k-50k,mobile,new,West,81,True,105,3,0,False,True,True,82,6,0,8.387011652691461,23,-3
user_005506,50,75k-100k,mobile,returning,East,51,True,51,3,0,True,True,False,0,0,0,,51,3
user_005507,45,50k-75k,mobile,returning,South,47,True,109,3,0,False,True,True,66,2,0,7.016039146345407,43,1
user_005508,53,30k-50k,mobile,new,Midwest,24,True,229,3,0,False,True,True,189,5,0,9.006319770558049,40,-2
user_005509,47,100k-150k,tablet,new,East,83,True,95,2,0,False,True,True,54,2,0,8.806235113309798,41,0
user_005510,75,100k-150k,desktop,returning,East,41,True,54,1,1,False,True,True,54,1,0,7.121419082288895,0,0
user_005511,46,50k-75k,desktop,returning,East,55,True,32,1,0,False,False,True,20,1,0,6.12011405468923,12,0
user_005512,31,100k-150k,mobile,new,East,77,True,147,3,0,False,True,True,115,1,0,9.176886837567546,32,2
user_005513,47,100k-150k,mobile,returning,Midwest,43,True,120,3,0,True,False,True,112,4,0,7.5147272834463115,8,-1
user_005514,56,>150k,desktop,new,South,28,False,0,0,0,True,False,True,147,1,0,6.538078971159438,-147,-1
user_005515,45,50k-75k,mobile,new,South,58,True,116,1,0,True,True,True,56,1,0,9.133427214087655,60,0
user_005516,42,30k-50k,mobile,new,East,49,True,121,2,0,False,True,True,75,4,0,8.047482866788028,46,-2
user_005517,32,50k-75k,desktop,returning,Midwest,85,False,0,0,0,True,True,False,0,0,0,,0,0
user_005518,56,50k-75k,desktop,returning,East,36,True,104,5,0,True,False,True,120,7,0,6.563582387500146,-16,-2
user_005519,53,75k-100k,desktop,returning,West,60,True,87,1,2,False,False,True,111,1,0,6.100448350744621,-24,0
user_005520,27,50k-75k,mobile,returning,West,82,True,39,4,1,False,True,True,32,1,0,8.210677928962896,7,3
user_005521,33,50k-75k,desktop,returning,East,52,True,78,2,0,False,True,True,53,2,0,8.257327919362867,25,0
user_005522,37,50k-75k,mobile,returning,Midwest,40,True,30,1,1,True,True,True,20,1,0,7.6086431284501455,10,0
user_005523,50,<30k,desktop,new,West,48,False,0,0,0,False,False,True,144,3,0,7.265096622717055,-144,-3
user_005524,39,75k-100k,desktop,new,West,32,True,95,6,0,False,False,True,110,4,0,7.903071777999359,-15,2
user_005525,44,50k-75k,desktop,new,East,51,True,63,6,0,False,True,False,0,0,0,,63,6
user_005526,52,50k-75k,desktop,returning,East,39,True,87,4,0,True,True,True,61,3,0,7.471912709490997,26,1
user_005527,47,50k-75k,desktop,returning,Midwest,40,True,107,4,0,False,False,True,77,2,0,7.795302322028715,30,2
user_005528,31,75k-100k,desktop,new,South,58,True,140,1,0,False,True,True,127,1,0,6.746489945456364,13,0
user_005529,30,>150k,desktop,returning,South,88,True,76,3,0,False,True,True,47,3,0,8.159895755999466,29,0
user_005530,45,100k-150k,desktop,new,South,51,True,145,2,0,False,False,True,140,3,0,6.754113591272651,5,-1
user_005531,46,100k-150k,desktop,returning,West,52,True,60,2,0,True,True,True,50,2,0,8.61774957894597,10,0
user_005532,26,50k-75k,mobile,returning,South,61,True,101,1,0,False,True,True,84,1,0,8.922148351908078,17,0
user_005533,39,>150k,mobile,returning,West,34,True,119,6,0,True,True,True,102,3,1,6.417755282806747,17,3
user_005534,23,50k-75k,desktop,new,East,68,True,112,5,0,False,False,True,143,3,2,6.6578597129334,-31,2
user_005535,48,>150k,desktop,returning,Midwest,42,True,112,4,0,False,True,True,89,1,0,9.79884977988268,23,3
user_005536,36,100k-150k,mobile,returning,East,46,True,119,4,0,False,False,True,132,3,0,4.788736980095981,-13,1
user_005537,54,>150k,desktop,new,Midwest,38,True,185,2,0,False,True,True,165,3,0,7.755648390981106,20,-1
user_005538,73,100k-150k,desktop,returning,East,53,True,113,4,0,True,False,True,105,4,0,7.010458993613313,8,0
user_005539,53,100k-150k,desktop,returning,South,66,True,57,1,0,False,False,True,26,2,0,6.851624148094222,31,-1
user_005540,49,30k-50k,mobile,returning,East,46,True,101,2,0,False,True,True,88,4,0,7.348240419424786,13,-2
user_005541,53,<30k,mobile,returning,South,36,True,80,6,0,False,False,True,80,5,0,7.278706815213211,0,1
user_005542,33,30k-50k,desktop,new,West,79,True,154,3,0,False,False,True,123,5,0,9.336346642199025,31,-2
user_005543,47,50k-75k,mobile,new,South,44,True,181,2,0,False,False,True,178,3,0,8.565747498844527,3,-1
user_005544,39,100k-150k,mobile,returning,Midwest,61,True,30,1,0,True,True,True,25,1,0,8.6677193764464,5,0
user_005545,40,50k-75k,desktop,returning,South,46,True,69,2,0,False,False,True,66,1,0,7.4599569823505805,3,1
user_005546,68,>150k,desktop,new,West,63,True,152,1,0,False,False,True,140,1,0,7.35543200527831,12,0
user_005547,64,50k-75k,mobile,returning,East,14,True,119,2,0,True,False,True,132,2,0,7.573343598445637,-13,0
user_005548,18,100k-150k,desktop,returning,Midwest,87,True,48,1,0,True,True,True,64,1,0,7.360117756756492,-16,0
user_005549,57,50k-75k,mobile,returning,South,32,True,57,2,1,True,False,True,66,2,0,7.3281727136426404,-9,0
user_005550,67,100k-150k,desktop,new,Midwest,55,True,145,4,0,False,True,True,144,3,0,8.46918244611367,1,1
user_005551,35,30k-50k,desktop,returning,South,54,True,96,2,0,False,True,True,104,6,0,10.0,-8,-4
user_005552,54,30k-50k,desktop,returning,Midwest,51,True,109,2,1,True,True,True,89,2,0,9.534177594690506,20,0
user_005553,36,30k-50k,desktop,returning,South,40,True,115,2,0,False,False,True,94,1,0,7.980899589070412,21,1
user_005554,58,30k-50k,desktop,returning,East,60,False,0,0,0,False,True,True,95,1,0,7.345162288679311,-95,-1
user_005555,55,50k-75k,mobile,returning,South,44,True,96,5,0,False,True,True,66,6,0,5.162348772997695,30,-1
user_005556,46,30k-50k,desktop,returning,West,59,True,139,3,0,False,True,True,146,3,0,10.0,-7,0
user_005557,24,30k-50k,desktop,returning,West,72,True,110,2,0,True,True,True,97,2,0,6.748445234276511,13,0
user_005558,52,30k-50k,mobile,returning,Midwest,48,True,108,5,0,True,False,True,97,5,0,6.308674404320059,11,0
user_005559,44,<30k,mobile,new,West,32,True,109,3,0,False,False,True,83,4,2,6.870518997265565,26,-1
user_005560,39,100k-150k,tablet,new,South,77,True,89,1,0,False,True,True,65,2,0,7.951763386261703,24,-1
user_005561,18,<30k,tablet,returning,South,49,False,0,0,0,False,True,False,0,0,0,,0,0
user_005562,18,30k-50k,tablet,new,West,83,True,118,4,0,True,True,True,101,3,0,8.311665449071738,17,1
user_005563,45,30k-50k,desktop,returning,East,44,True,92,4,0,False,True,True,49,2,0,8.376592891031498,43,2
user_005564,49,<30k,mobile,returning,East,22,True,150,3,0,True,False,True,154,3,0,5.663354162668992,-4,0
user_005565,43,30k-50k,mobile,returning,Midwest,70,True,164,5,0,True,True,True,120,1,0,10.0,44,4
user_005566,30,50k-75k,desktop,new,West,100,False,0,0,0,False,False,True,119,3,0,7.809182764143042,-119,-3
user_005567,72,75k-100k,mobile,new,South,6,False,0,0,0,False,False,True,137,1,0,8.689060093276922,-137,-1
user_005568,59,<30k,mobile,new,East,30,True,119,2,0,False,True,True,96,2,0,10.0,23,0
user_005569,39,50k-75k,mobile,new,Midwest,25,False,0,0,0,False,True,True,91,1,1,7.921468020899037,-91,-1
user_005570,20,100k-150k,mobile,new,West,100,False,0,0,0,True,True,False,0,0,0,,0,0
user_005571,44,50k-75k,mobile,returning,East,56,True,140,3,0,False,True,True,123,2,1,9.882006694902502,17,1
user_005572,75,75k-100k,desktop,returning,West,46,True,123,1,0,False,False,True,158,1,0,7.42060333466284,-35,0
user_005573,39,50k-75k,mobile,new,East,32,True,106,3,1,False,False,True,110,2,0,4.775638832363059,-4,1
user_005574,36,75k-100k,desktop,returning,West,35,True,130,3,0,True,True,True,107,1,0,8.02601056218064,23,2
user_005575,44,50k-75k,mobile,new,South,38,True,111,5,1,True,True,True,89,3,0,8.850441943730377,22,2
user_005576,56,>150k,desktop,returning,West,65,True,62,1,1,False,False,True,66,2,0,6.909662090604557,-4,-1
user_005577,60,<30k,desktop,returning,Midwest,16,True,149,5,0,True,True,True,109,3,0,5.643292903319955,40,2
user_005578,26,50k-75k,desktop,returning,West,75,True,52,2,0,False,True,True,34,3,0,7.528982143156184,18,-1
user_005579,42,100k-150k,desktop,returning,East,39,True,89,5,0,True,True,True,45,5,0,5.704175096709813,44,0
user_005580,50,75k-100k,desktop,new,Midwest,69,True,118,4,0,False,False,True,113,4,0,8.564632505857013,5,0
user_005581,30,30k-50k,desktop,returning,East,68,True,119,7,0,True,True,True,89,5,0,7.376868025480843,30,2
user_005582,33,30k-50k,mobile,new,East,59,True,132,3,0,False,True,True,124,1,0,5.032603788832747,8,2
user_005583,50,75k-100k,desktop,new,East,65,True,92,5,0,True,False,True,95,4,0,6.510161308895175,-3,1
user_005584,41,30k-50k,desktop,new,Midwest,52,False,0,0,0,True,True,True,82,1,0,7.948127660976999,-82,-1
user_005585,64,50k-75k,desktop,returning,West,54,False,0,0,0,True,True,True,84,1,0,6.789911646433784,-84,-1
user_005586,42,50k-75k,mobile,new,Midwest,58,True,66,5,1,True,True,True,44,4,0,7.206735240959254,22,1
user_005587,37,50k-75k,mobile,returning,East,57,True,65,3,0,True,True,True,62,4,0,6.932113285323151,3,-1
user_005588,63,50k-75k,mobile,new,West,27,True,171,4,0,False,False,True,179,5,0,7.470788572972287,-8,-1
user_005589,27,50k-75k,desktop,new,East,58,True,107,4,1,True,True,True,82,3,0,5.766790865431203,25,1
user_005590,40,>150k,mobile,returning,East,61,False,0,0,0,True,True,True,54,1,0,6.790248315593923,-54,-1
user_005591,54,100k-150k,mobile,returning,East,44,True,88,3,0,True,True,True,49,3,1,8.426913414787727,39,0
user_005592,25,<30k,mobile,returning,East,61,True,117,3,0,True,True,True,80,4,0,7.0227688936736365,37,-1
user_005593,67,<30k,mobile,returning,South,20,True,133,2,1,False,False,True,127,1,0,7.039042596905403,6,1
user_005594,36,<30k,mobile,new,South,41,True,75,3,0,True,True,True,72,1,0,7.4440558663402445,3,2
user_005595,50,<30k,desktop,returning,South,14,True,143,4,0,True,False,True,132,3,0,5.48416141552798,11,1
user_005596,43,75k-100k,mobile,returning,East,62,True,92,4,0,True,True,True,59,3,0,7.419304813352249,33,1
user_005597,53,<30k,desktop,new,West,15,False,0,0,0,True,False,True,109,1,0,7.446388333718047,-109,-1
user_005598,47,<30k,desktop,new,South,40,True,118,1,0,True,False,True,97,2,1,6.25939551533225,21,-1
user_005599,43,50k-75k,mobile,returning,South,26,True,175,1,0,True,True,True,144,1,0,8.396339307254285,31,0
user_005600,44,30k-50k,mobile,returning,South,19,True,148,2,0,False,False,True,130,2,0,8.809097380056148,18,0
user_005601,18,>150k,desktop,returning,West,86,True,79,2,0,False,True,True,58,1,0,8.589485974323434,21,1
user_005602,31,50k-75k,mobile,returning,East,75,True,47,3,0,True,True,True,61,1,0,9.049634789506516,-14,2
user_005603,36,100k-150k,desktop,returning,East,48,True,116,2,1,True,True,True,105,1,0,8.195101052232761,11,1
user_005604,55,75k-100k,desktop,returning,West,61,True,132,2,0,False,False,True,169,3,0,6.0412583448641755,-37,-1
user_005605,53,<30k,mobile,returning,East,70,False,0,0,0,True,True,False,0,0,0,,0,0
user_005606,53,>150k,desktop,returning,East,59,True,135,1,0,True,True,True,129,1,1,8.722097599771326,6,0
user_005607,30,50k-75k,desktop,returning,West,72,True,54,2,0,True,True,True,34,2,0,7.7616907282780865,20,0
user_005608,50,75k-100k,desktop,new,Midwest,55,True,119,1,0,False,False,True,116,1,0,8.361656264240537,3,0
user_005609,50,50k-75k,mobile,returning,East,57,False,0,0,0,True,True,True,74,1,0,8.498713705076227,-74,-1
user_005610,37,100k-150k,tablet,returning,West,75,True,69,3,0,True,False,True,94,3,0,7.252371867559285,-25,0
user_005611,47,50k-75k,desktop,returning,South,21,True,78,1,0,False,False,True,85,2,1,4.42397348709691,-7,-1
user_005612,56,30k-50k,desktop,returning,West,30,True,74,1,0,False,False,True,71,1,0,6.795336039642097,3,0
user_005613,49,75k-100k,desktop,new,East,32,True,96,7,1,False,False,True,134,10,0,7.015015206050265,-38,-3
user_005614,73,30k-50k,desktop,returning,East,19,False,0,0,0,True,True,True,136,1,0,7.218210544276863,-136,-1
user_005615,37,30k-50k,mobile,returning,East,44,True,124,2,0,False,True,True,88,1,0,6.7013956769856105,36,1
user_005616,37,50k-75k,desktop,new,Midwest,29,True,165,1,0,False,False,True,172,1,0,7.428721638575517,-7,0
user_005617,40,75k-100k,desktop,new,West,36,True,159,6,0,True,True,True,142,2,0,5.970625768147662,17,4
user_005618,25,75k-100k,mobile,returning,West,77,True,63,5,1,True,False,True,86,6,0,7.387141522290678,-23,-1
user_005619,30,30k-50k,mobile,returning,Midwest,61,True,61,3,0,True,True,True,28,1,1,7.750574735159232,33,2
user_005620,24,30k-50k,desktop,returning,South,84,True,73,8,0,False,True,True,42,5,0,8.516860137496709,31,3
user_005621,40,75k-100k,mobile,returning,West,57,True,179,4,0,True,True,True,120,8,0,6.377551666734211,59,-4
user_005622,80,50k-75k,desktop,returning,South,13,True,65,7,0,False,False,True,64,6,0,8.355806208576253,1,1
user_005623,59,100k-150k,mobile,new,East,46,True,121,3,0,False,False,True,143,3,0,8.105038717380056,-22,0
user_005624,50,<30k,mobile,returning,West,45,True,47,2,0,False,True,True,44,1,0,9.49414662308401,3,1
user_005625,55,75k-100k,tablet,new,East,44,True,121,3,0,False,False,True,117,3,0,7.823878287466878,4,0
user_005626,18,30k-50k,mobile,new,South,46,False,0,0,0,False,True,True,116,1,0,7.557412114769193,-116,-1
user_005627,41,30k-50k,mobile,returning,West,54,True,66,6,0,False,True,True,47,4,0,10.0,19,2
user_005628,22,>150k,mobile,returning,South,66,True,93,5,0,True,True,True,75,7,0,8.149490515306246,18,-2
user_005629,58,75k-100k,desktop,returning,South,13,True,167,6,1,True,False,True,170,3,0,7.818894881522966,-3,3
user_005630,59,<30k,desktop,returning,West,32,True,123,6,0,True,True,True,128,5,0,7.665228716744966,-5,1
user_005631,33,50k-75k,desktop,new,West,63,True,155,4,0,True,True,True,159,2,0,7.132455968689521,-4,2
user_005632,48,50k-75k,desktop,returning,East,42,True,79,1,1,True,True,True,83,2,1,6.402128060492193,-4,-1
user_005633,48,50k-75k,mobile,returning,East,39,True,80,4,0,True,True,True,50,1,0,8.374366931905897,30,3
user_005634,49,75k-100k,mobile,returning,West,62,True,63,2,0,True,True,True,30,1,0,10.0,33,1
user_005635,58,50k-75k,mobile,returning,East,53,True,85,6,0,False,False,True,50,6,0,8.132050509328849,35,0
user_005636,68,<30k,desktop,returning,West,26,False,0,0,0,False,False,True,120,1,0,6.082435937776693,-120,-1
user_005637,46,75k-100k,mobile,new,South,51,True,85,3,0,True,True,True,49,1,0,7.884368501120559,36,2
user_005638,37,100k-150k,desktop,returning,West,82,True,94,2,0,False,False,True,73,2,0,8.210352596636717,21,0
user_005639,23,<30k,desktop,new,West,60,False,0,0,0,False,True,False,0,0,0,,0,0
user_005640,28,30k-50k,desktop,returning,East,64,True,75,2,0,True,True,True,85,1,0,7.9466027024065555,-10,1
user_005641,32,50k-75k,mobile,returning,West,76,True,94,2,0,True,True,True,74,3,0,10.0,20,-1
user_005642,57,75k-100k,mobile,new,East,20,True,179,2,1,False,False,True,195,1,0,6.782604259210543,-16,1
user_005643,73,<30k,mobile,returning,West,7,False,0,0,0,False,False,False,0,0,0,,0,0
user_005644,35,100k-150k,desktop,returning,East,74,True,49,3,0,True,True,True,22,1,0,6.902079702958186,27,2
user_005645,71,>150k,mobile,returning,West,42,True,101,2,0,False,False,True,82,2,0,5.648460932411424,19,0
user_005646,46,75k-100k,desktop,returning,East,51,True,76,1,0,False,False,True,67,1,0,6.565241913774522,9,0
user_005647,56,30k-50k,desktop,returning,Midwest,7,True,133,1,0,False,False,True,120,1,0,7.713402858825658,13,0
user_005648,25,30k-50k,desktop,returning,South,72,True,61,3,0,False,True,True,71,2,0,6.18058162671808,-10,1
user_005649,68,75k-100k,mobile,new,East,37,False,0,0,0,True,False,True,134,1,0,7.376551178908629,-134,-1
user_005650,44,30k-50k,desktop,returning,East,57,False,0,0,0,False,True,True,100,2,0,8.30150040814358,-100,-2
user_005651,48,75k-100k,mobile,new,South,68,True,80,3,0,True,True,True,71,4,0,8.496918804165968,9,-1
user_005652,22,100k-150k,desktop,returning,East,100,True,80,1,0,False,True,True,57,1,0,8.398435367405437,23,0
user_005653,43,50k-75k,tablet,new,West,56,True,109,2,0,False,False,True,108,1,0,8.488477364698493,1,1
user_005654,31,50k-75k,mobile,returning,Midwest,69,True,30,3,0,True,True,True,20,4,0,8.37125294140968,10,-1
user_005655,57,<30k,desktop,returning,West,22,True,105,7,0,False,False,True,84,11,0,7.104821337103262,21,-4
user_005656,51,50k-75k,desktop,new,Midwest,49,False,0,0,0,False,False,True,104,2,0,6.623763580480462,-104,-2
user_005657,51,75k-100k,desktop,returning,East,45,True,84,2,1,False,True,True,58,1,0,7.693107831526618,26,1
user_005658,38,50k-75k,desktop,returning,South,46,True,72,2,0,True,True,True,70,3,1,4.048895459697851,2,-1
user_005659,47,50k-75k,desktop,new,South,32,False,0,0,0,False,False,True,143,1,0,6.345027602184781,-143,-1
user_005660,36,50k-75k,mobile,returning,Midwest,24,True,174,1,0,True,False,True,167,1,1,7.010341174947225,7,0
user_005661,35,75k-100k,mobile,returning,West,53,True,81,1,0,True,False,True,86,2,0,7.430228285507847,-5,-1
user_005662,34,<30k,mobile,returning,West,56,False,0,0,0,True,True,True,120,1,0,9.063388115326228,-120,-1
user_005663,63,75k-100k,desktop,returning,West,66,True,30,3,0,True,False,True,20,5,0,8.085525957735854,10,-2
user_005664,33,50k-75k,mobile,returning,East,54,True,123,3,0,True,True,True,74,3,0,7.369280614502656,49,0
user_005665,26,50k-75k,mobile,returning,South,97,True,55,4,0,True,True,True,58,1,0,7.26640899490947,-3,3
user_005666,31,75k-100k,desktop,returning,Midwest,77,True,68,4,0,True,False,True,46,1,0,6.911548778198538,22,3
user_005667,43,50k-75k,mobile,returning,West,40,True,36,3,0,True,False,True,69,3,0,9.26426037618516,-33,0
user_005668,60,100k-150k,mobile,returning,Midwest,51,True,79,2,0,True,True,True,56,1,0,7.648117532399185,23,1
user_005669,49,<30k,desktop,returning,South,38,True,74,5,0,False,True,True,61,4,0,8.55744344315733,13,1
user_005670,35,30k-50k,mobile,new,West,66,True,170,3,0,False,True,True,125,3,0,7.885009187196192,45,0
user_005671,50,<30k,desktop,returning,South,52,True,76,4,1,False,False,True,39,3,0,8.111228087719953,37,1
user_005672,52,100k-150k,desktop,returning,West,91,True,90,2,0,True,True,True,96,1,0,8.854443893655114,-6,1
user_005673,37,50k-75k,desktop,returning,South,37,True,69,4,0,False,False,True,49,5,0,6.754374933231175,20,-1
user_005674,69,<30k,mobile,new,Midwest,17,True,198,3,1,False,False,False,0,0,0,,198,3
user_005675,33,50k-75k,desktop,new,South,80,False,0,0,0,True,True,True,69,1,0,8.255770400728112,-69,-1
user_005676,24,30k-50k,mobile,returning,Midwest,73,True,103,5,0,True,True,True,80,4,0,8.05863693766205,23,1
user_005677,46,30k-50k,mobile,new,West,46,True,102,1,1,False,False,True,91,1,1,5.3922221678532,11,0
user_005678,25,50k-75k,mobile,returning,Midwest,76,True,97,3,0,False,True,True,56,3,0,10.0,41,0
user_005679,36,100k-150k,desktop,new,West,88,True,102,5,0,False,True,True,83,2,0,8.94363824869298,19,3
user_005680,37,100k-150k,mobile,returning,West,69,True,119,2,0,True,True,True,84,1,0,8.91913104943051,35,1
user_005681,65,100k-150k,mobile,new,East,63,True,133,2,1,True,True,False,0,0,0,,133,2
user_005682,52,100k-150k,desktop,returning,East,76,True,30,1,0,True,True,True,47,1,0,8.606466470801978,-17,0
user_005683,29,100k-150k,tablet,new,East,91,True,45,1,0,False,True,True,82,1,0,7.50822101863036,-37,0
user_005684,68,<30k,desktop,returning,Midwest,25,True,145,9,0,False,False,True,152,11,0,6.649101106196002,-7,-2
user_005685,55,<30k,desktop,returning,South,35,True,119,3,0,False,False,True,120,3,1,6.006789169225426,-1,0
user_005686,26,50k-75k,tablet,returning,Midwest,42,True,30,2,0,False,False,True,46,2,0,8.424140963993334,-16,0
user_005687,38,75k-100k,desktop,returning,Midwest,22,True,124,6,0,False,True,True,68,7,1,8.95667522211629,56,-1
user_005688,53,100k-150k,mobile,new,East,53,True,68,3,0,True,True,True,57,2,0,7.923132969231551,11,1
user_005689,59,50k-75k,desktop,returning,East,58,True,75,2,0,True,True,True,76,2,0,8.684346775572317,-1,0
user_005690,33,100k-150k,mobile,new,Midwest,63,True,160,6,0,False,True,True,105,3,0,7.663352278802928,55,3
user_005691,18,75k-100k,mobile,new,Midwest,48,True,68,2,0,False,True,True,29,2,0,6.139739307113697,39,0
user_005692,70,30k-50k,mobile,returning,South,4,True,149,1,0,False,False,True,155,3,1,10.0,-6,-2
user_005693,57,30k-50k,mobile,returning,East,29,True,135,2,0,False,False,True,111,4,0,5.413261192032303,24,-2
user_005694,55,75k-100k,desktop,returning,West,50,True,117,3,2,True,True,True,96,3,0,6.6956294543692145,21,0
user_005695,46,50k-75k,desktop,new,East,33,False,0,0,0,True,True,True,128,2,0,9.556911814199934,-128,-2
user_005696,61,30k-50k,desktop,returning,South,24,True,81,3,1,True,False,True,43,3,0,6.236639750811429,38,0
user_005697,37,50k-75k,desktop,returning,East,68,True,76,5,0,False,False,True,45,5,0,7.366947229212476,31,0
user_005698,25,30k-50k,desktop,returning,East,54,True,78,2,0,False,True,True,67,4,0,7.883815419248859,11,-2
user_005699,56,75k-100k,desktop,returning,South,31,True,95,4,0,False,False,True,85,3,1,5.123474605076968,10,1
user_005700,47,50k-75k,desktop,returning,South,34,True,78,3,1,True,True,True,50,3,0,6.840256314581865,28,0
user_005701,38,50k-75k,desktop,returning,South,15,True,128,4,0,True,False,False,0,0,0,,128,4
user_005702,46,30k-50k,mobile,returning,West,39,True,83,6,0,True,True,True,66,6,1,8.97003635002814,17,0
user_005703,25,<30k,mobile,returning,South,35,False,0,0,0,False,True,False,0,0,0,,0,0
user_005704,32,100k-150k,mobile,returning,Midwest,50,True,77,2,0,False,True,True,55,1,0,6.90259157274183,22,1
user_005705,51,75k-100k,tablet,returning,Midwest,28,True,105,4,0,True,False,True,111,5,0,6.585042848086454,-6,-1
user_005706,36,100k-150k,desktop,returning,West,100,True,77,3,0,True,True,True,63,1,0,10.0,14,2
user_005707,27,75k-100k,mobile,returning,East,72,True,30,3,0,False,True,True,65,2,0,7.478709408134698,-35,1
user_005708,48,50k-75k,mobile,returning,Midwest,56,True,79,7,0,True,True,True,64,2,0,7.524816392339071,15,5
user_005709,36,30k-50k,desktop,returning,West,65,True,45,3,0,True,True,True,35,2,0,9.842978843284959,10,1
user_005710,55,30k-50k,desktop,returning,South,38,True,64,2,0,True,True,True,45,3,0,10.0,19,-1
user_005711,49,75k-100k,desktop,returning,Midwest,35,True,109,3,0,False,False,True,96,1,0,8.073639730414747,13,2
user_005712,18,75k-100k,mobile,returning,Midwest,78,True,43,2,0,False,False,True,25,2,0,6.481405789859426,18,0
user_005713,54,<30k,mobile,returning,East,22,True,138,5,0,True,True,True,124,3,0,7.85546070843845,14,2
user_005714,47,100k-150k,desktop,returning,South,76,True,30,1,0,True,True,True,33,1,0,10.0,-3,0
user_005715,49,50k-75k,desktop,returning,South,61,False,0,0,0,False,False,True,100,1,0,7.238578330875072,-100,-1
user_005716,31,50k-75k,mobile,new,South,46,False,0,0,0,False,True,True,132,1,1,7.273889172303511,-132,-1
user_005717,43,100k-150k,mobile,returning,West,85,False,0,0,0,True,True,True,83,2,0,8.656138507780511,-83,-2
user_005718,55,<30k,desktop,returning,East,31,False,0,0,0,False,True,True,88,1,0,8.641329177708085,-88,-1
user_005719,76,30k-50k,mobile,new,East,22,False,0,0,0,False,False,True,99,2,0,8.945257251077331,-99,-2
user_005720,25,75k-100k,desktop,new,South,57,True,125,5,0,False,False,True,151,3,0,6.987133667334011,-26,2
user_005721,45,50k-75k,desktop,new,East,69,True,72,3,0,True,False,True,81,4,1,6.9677416878004275,-9,-1
user_005722,36,50k-75k,desktop,new,Midwest,41,False,0,0,0,False,False,True,110,1,1,7.679149823830283,-110,-1
user_005723,31,30k-50k,desktop,new,Midwest,59,True,105,5,0,False,True,True,48,3,0,7.374676883047612,57,2
user_005724,28,50k-75k,mobile,returning,South,60,True,85,6,0,False,True,True,59,6,0,10.0,26,0
user_005725,58,100k-150k,desktop,returning,East,48,True,112,2,0,False,False,True,113,3,0,6.2122440942018935,-1,-1
user_005726,21,30k-50k,desktop,new,South,65,False,0,0,0,True,True,False,0,0,0,,0,0
user_005727,38,<30k,desktop,new,Midwest,31,True,138,1,0,False,False,True,139,1,0,7.58142543052011,-1,0
user_005728,55,50k-75k,desktop,returning,East,87,True,71,2,1,False,False,True,38,3,1,7.605870609227639,33,-1
user_005729,18,<30k,mobile,new,Midwest,70,True,162,6,0,False,True,True,127,6,0,8.628079779511236,35,0
user_005730,57,75k-100k,mobile,returning,West,61,True,113,2,0,True,True,True,110,3,0,8.449917994982076,3,-1
user_005731,25,100k-150k,desktop,returning,South,60,True,180,5,1,False,False,False,0,0,0,,180,5
user_005732,39,100k-150k,desktop,returning,East,77,True,88,2,0,False,True,True,70,4,0,9.137551692968522,18,-2
user_005733,35,30k-50k,desktop,new,East,63,True,129,1,1,True,False,False,0,0,0,,129,1
user_005734,80,100k-150k,tablet,returning,South,61,True,129,2,0,True,True,True,120,2,0,7.921608369705492,9,0
user_005735,63,100k-150k,desktop,returning,Midwest,56,False,0,0,0,False,False,True,109,1,0,7.319275805404592,-109,-1
user_005736,50,75k-100k,desktop,returning,East,43,True,79,1,0,False,False,True,100,2,0,6.065926766229622,-21,-1
user_005737,46,<30k,tablet,returning,Midwest,40,True,74,4,0,False,True,True,62,3,0,6.758736585951271,12,1
user_005738,67,<30k,desktop,new,East,21,True,145,8,0,True,False,True,168,7,0,6.392322531588549,-23,1
user_005739,32,50k-75k,desktop,new,East,56,True,146,3,0,False,True,True,102,2,0,6.800522140301516,44,1
user_005740,61,75k-100k,mobile,new,East,42,True,145,4,0,False,False,True,154,2,0,5.778338270836908,-9,2
user_005741,49,>150k,desktop,returning,East,50,True,77,2,0,False,True,True,77,1,0,6.956037330483367,0,1
user_005742,58,50k-75k,desktop,new,East,25,False,0,0,0,False,True,True,97,2,0,8.152633131483793,-97,-2
user_005743,40,30k-50k,desktop,new,East,38,True,112,2,2,False,False,True,110,1,0,7.607964849576561,2,1
user_005744,69,30k-50k,desktop,new,West,58,False,0,0,0,True,False,False,0,0,0,,0,0
user_005745,27,30k-50k,desktop,returning,East,71,True,30,2,0,False,True,True,20,1,0,9.399728379385527,10,1
user_005746,70,<30k,tablet,new,East,35,True,158,1,0,False,False,True,144,2,0,4.64558646865435,14,-1
user_005747,38,75k-100k,desktop,new,East,47,True,67,5,0,False,True,True,49,3,0,9.088982939151684,18,2
user_005748,60,50k-75k,desktop,new,East,62,True,201,2,0,True,False,True,142,1,0,6.526580373373013,59,1
user_005749,56,100k-150k,desktop,returning,Midwest,51,True,105,1,1,False,True,True,92,1,0,7.733512841374671,13,0
user_005750,49,100k-150k,desktop,returning,East,71,True,43,1,0,True,True,True,20,1,0,8.691083307225476,23,0
user_005751,59,100k-150k,mobile,new,East,32,True,85,4,1,False,True,True,50,5,0,7.5096077766609275,35,-1
user_005752,40,<30k,mobile,returning,South,46,True,31,5,0,False,True,True,30,8,0,7.489579633349906,1,-3
user_005753,39,50k-75k,desktop,new,South,55,True,121,3,0,False,True,True,95,1,0,7.2017727701368415,26,2
user_005754,46,50k-75k,mobile,returning,Midwest,45,True,84,3,0,False,False,True,67,1,0,7.284799080925603,17,2
user_005755,56,<30k,desktop,returning,West,30,True,109,1,0,True,False,True,103,1,0,9.611689947340206,6,0
user_005756,76,50k-75k,mobile,returning,West,39,False,0,0,0,False,False,False,0,0,0,,0,0
user_005757,70,75k-100k,mobile,returning,Midwest,41,True,93,4,0,False,True,True,107,1,0,7.043630688807774,-14,3
user_005758,44,30k-50k,desktop,returning,South,41,False,0,0,0,True,True,True,71,4,0,8.208241926669064,-71,-4
user_005759,41,30k-50k,desktop,new,Midwest,49,False,0,0,0,False,True,True,103,2,0,8.196202625582918,-103,-2
user_005760,39,30k-50k,desktop,returning,East,28,True,141,2,0,False,False,True,148,2,0,9.353199165533542,-7,0
user_005761,45,30k-50k,desktop,returning,South,15,True,109,3,0,True,True,True,86,4,0,9.062786596785005,23,-1
user_005762,39,30k-50k,desktop,returning,West,56,True,108,3,0,True,True,True,104,2,0,8.35442394347984,4,1
user_005763,52,<30k,desktop,new,South,27,True,218,2,0,False,False,True,202,1,0,5.239593042019131,16,1
user_005764,66,30k-50k,mobile,returning,South,44,True,114,2,1,True,True,True,102,1,0,6.527128805929696,12,1
user_005765,63,>150k,desktop,new,West,79,False,0,0,0,True,True,True,143,1,0,9.65863140580534,-143,-1
user_005766,40,75k-100k,mobile,returning,Midwest,46,True,92,5,1,False,True,True,86,2,1,5.914460048886506,6,3
user_005767,46,>150k,desktop,returning,South,63,True,91,3,0,True,True,True,55,1,0,7.491795035037884,36,2
user_005768,30,<30k,mobile,returning,Midwest,65,False,0,0,0,False,True,False,0,0,0,,0,0
user_005769,36,100k-150k,desktop,returning,South,69,False,0,0,0,False,True,True,116,1,1,7.700554470548228,-116,-1
user_005770,45,75k-100k,tablet,new,South,38,True,206,3,0,False,False,False,0,0,0,,206,3
user_005771,64,75k-100k,desktop,returning,East,50,True,107,1,0,False,False,True,110,1,0,7.641025777616504,-3,0
user_005772,41,50k-75k,desktop,returning,East,50,True,78,4,0,True,True,True,70,2,0,8.610784600706372,8,2
user_005773,44,75k-100k,mobile,returning,West,53,True,129,1,0,False,True,True,113,1,1,7.324559283990246,16,0
user_005774,33,50k-75k,mobile,new,South,73,True,39,3,0,False,True,True,20,2,0,7.538949611459568,19,1
user_005775,18,50k-75k,tablet,returning,West,44,True,68,2,0,False,True,True,35,1,0,7.237551742581874,33,1
user_005776,60,100k-150k,desktop,new,East,52,True,132,3,0,False,True,True,127,3,0,5.587447424944537,5,0
user_005777,65,50k-75k,desktop,new,South,26,True,154,6,0,False,False,False,0,0,0,,154,6
user_005778,63,30k-50k,desktop,returning,West,12,True,112,5,1,True,False,True,129,6,0,5.743597796726243,-17,-1
user_005779,21,30k-50k,mobile,returning,East,35,True,121,3,0,True,True,True,82,2,0,10.0,39,1
user_005780,31,<30k,mobile,returning,West,96,True,85,2,0,True,False,True,99,2,0,4.7443896529206855,-14,0
user_005781,19,>150k,mobile,returning,East,72,False,0,0,0,True,True,True,107,2,0,6.3169017360261694,-107,-2
user_005782,55,50k-75k,desktop,returning,East,59,False,0,0,0,False,False,True,107,1,0,7.911352596412693,-107,-1
user_005783,25,<30k,desktop,returning,West,58,True,80,4,0,False,False,False,0,0,0,,80,4
user_005784,57,50k-75k,desktop,returning,Midwest,35,True,107,1,0,False,False,True,79,2,0,6.973133162787841,28,-1
user_005785,18,100k-150k,desktop,new,East,85,False,0,0,0,False,False,True,93,1,0,4.5287483941875335,-93,-1
user_005786,35,<30k,mobile,returning,East,64,False,0,0,0,True,True,True,104,1,0,7.813037887468675,-104,-1
user_005787,43,<30k,tablet,returning,Midwest,42,False,0,0,0,False,False,True,92,1,0,6.809947348743274,-92,-1
user_005788,41,75k-100k,mobile,returning,West,44,True,131,3,3,False,False,True,173,2,0,8.130702239403586,-42,1
user_005789,68,<30k,desktop,returning,Midwest,36,True,88,1,0,True,True,True,95,3,0,7.977339241300212,-7,-2
user_005790,18,<30k,desktop,returning,West,56,True,62,3,1,True,True,False,0,0,0,,62,3
user_005791,50,100k-150k,mobile,new,South,29,True,89,8,0,True,False,True,59,5,0,7.543703724594153,30,3
user_005792,18,<30k,tablet,returning,Midwest,60,True,92,7,0,True,False,True,77,5,0,9.456583955272787,15,2
user_005793,66,75k-100k,desktop,returning,East,41,True,86,3,1,True,False,True,93,1,0,9.824528257398864,-7,2
user_005794,42,50k-75k,desktop,new,Midwest,51,True,83,5,0,False,False,True,82,2,0,9.174459570116579,1,3
user_005795,18,50k-75k,mobile,returning,Midwest,94,True,65,1,0,False,False,True,51,1,0,9.700765721444405,14,0
user_005796,34,100k-150k,mobile,returning,Midwest,76,True,89,4,0,True,True,True,101,4,0,8.28293835208231,-12,0
user_005797,20,<30k,mobile,returning,South,45,True,30,2,0,False,False,True,34,4,0,9.00809308240543,-4,-2
user_005798,55,50k-75k,mobile,new,West,50,True,108,5,0,False,False,True,105,3,0,8.573706287287898,3,2
user_005799,57,30k-50k,mobile,returning,Midwest,63,True,60,3,0,True,False,True,50,5,0,6.8349965501918515,10,-2
user_005800,21,<30k,mobile,returning,Midwest,49,True,130,2,1,False,True,True,97,1,0,8.875583042177995,33,1
user_005801,36,<30k,mobile,returning,West,48,True,104,1,0,False,True,True,69,1,0,7.865365450116069,35,0
user_005802,67,50k-75k,desktop,returning,East,25,True,135,4,2,False,False,True,117,1,0,5.952840774571004,18,3
user_005803,38,<30k,desktop,new,East,45,True,127,3,1,False,True,True,86,5,0,8.86088030352335,41,-2
user_005804,49,100k-150k,desktop,returning,West,78,True,52,4,1,False,True,True,68,3,0,7.889245382122919,-16,1
user_005805,41,30k-50k,desktop,returning,East,70,False,0,0,0,True,True,True,132,2,1,9.065058331668354,-132,-2
user_005806,39,50k-75k,mobile,new,Midwest,51,True,118,3,0,True,True,True,93,2,0,8.420280547529314,25,1
user_005807,61,30k-50k,desktop,new,South,2,True,169,2,0,False,False,True,145,5,0,5.332346284910612,24,-3
user_005808,80,30k-50k,mobile,new,West,31,False,0,0,0,False,True,True,65,1,0,6.74891199138807,-65,-1
user_005809,32,<30k,mobile,returning,South,58,True,65,3,0,True,True,False,0,0,0,,65,3
user_005810,55,100k-150k,desktop,new,Midwest,59,True,84,1,0,False,False,True,51,2,0,7.216786927303145,33,-1
user_005811,55,50k-75k,tablet,new,East,60,True,116,2,0,True,True,True,109,1,0,7.373923387458599,7,1
user_005812,18,75k-100k,desktop,returning,Midwest,29,True,201,5,0,True,True,True,152,4,0,7.994032372536916,49,1
user_005813,20,50k-75k,desktop,returning,West,74,False,0,0,0,True,True,True,125,1,0,10.0,-125,-1
user_005814,39,50k-75k,mobile,new,South,48,True,100,5,0,True,True,True,63,3,0,8.48356413890276,37,2
user_005815,58,75k-100k,desktop,returning,East,16,True,161,6,0,False,False,False,0,0,0,,161,6
user_005816,18,50k-75k,mobile,returning,South,61,True,126,3,1,True,True,True,83,5,0,7.212628705114104,43,-2
user_005817,36,100k-150k,desktop,returning,East,67,True,71,2,0,False,False,True,49,2,0,7.261950391804655,22,0
user_005818,46,75k-100k,desktop,returning,West,56,True,85,1,0,False,True,True,84,1,0,8.57283475504628,1,0
user_005819,18,30k-50k,desktop,returning,West,89,True,58,1,0,True,True,True,20,1,0,7.83390860370451,38,0
user_005820,60,75k-100k,mobile,new,South,41,True,86,1,1,False,True,True,65,1,0,6.758194249688709,21,0
user_005821,60,<30k,mobile,returning,South,0,False,0,0,0,False,False,True,132,2,0,8.497170798226579,-132,-2
user_005822,44,30k-50k,desktop,returning,South,55,True,75,2,0,False,True,True,94,1,0,6.470764913341093,-19,1
user_005823,30,50k-75k,desktop,returning,West,94,True,58,2,0,True,True,True,47,2,0,8.844642658115765,11,0
user_005824,54,<30k,mobile,returning,East,38,True,112,1,0,False,True,True,68,4,0,5.2412670533579595,44,-3
user_005825,59,50k-75k,mobile,returning,West,27,True,117,2,0,False,False,True,75,4,0,8.973381671702933,42,-2
user_005826,49,50k-75k,mobile,returning,West,27,True,106,5,1,True,False,True,133,1,0,5.5907279431191235,-27,4
user_005827,36,30k-50k,desktop,new,East,75,False,0,0,0,True,False,True,118,1,0,8.713292172187975,-118,-1
user_005828,47,100k-150k,desktop,returning,East,74,True,75,1,0,True,True,True,62,1,0,7.063538681299591,13,0
user_005829,79,75k-100k,desktop,returning,South,44,True,111,3,0,False,False,True,101,5,1,4.339469300244696,10,-2
user_005830,55,50k-75k,mobile,returning,South,56,True,84,4,0,True,True,True,48,6,0,8.470463581846532,36,-2
user_005831,36,75k-100k,mobile,new,West,72,True,94,4,0,True,True,True,83,6,0,10.0,11,-2
user_005832,32,<30k,mobile,new,East,41,True,102,1,0,False,True,True,109,1,0,6.274246590980773,-7,0
user_005833,60,100k-150k,mobile,returning,Midwest,37,True,56,4,0,True,True,True,26,7,0,9.524291524820049,30,-3
user_005834,18,50k-75k,mobile,new,South,46,False,0,0,0,False,True,True,122,1,0,7.084445985903113,-122,-1
user_005835,18,<30k,mobile,returning,South,62,False,0,0,0,True,True,False,0,0,0,,0,0
user_005836,61,100k-150k,desktop,returning,West,57,True,93,2,0,True,True,True,90,6,0,8.176269036369618,3,-4
user_005837,39,30k-50k,desktop,returning,West,63,True,80,4,0,True,False,True,77,3,0,8.122962544634104,3,1
user_005838,74,75k-100k,tablet,returning,South,35,False,0,0,0,True,True,True,104,1,0,8.055355504594955,-104,-1
user_005839,19,75k-100k,mobile,new,Midwest,63,False,0,0,0,True,True,True,92,2,1,8.950117631693173,-92,-2
user_005840,51,50k-75k,desktop,returning,West,81,True,102,1,0,True,True,True,67,2,0,9.080889086566538,35,-1
user_005841,35,50k-75k,desktop,new,East,45,True,163,1,0,False,True,True,139,1,0,10.0,24,0
user_005842,73,<30k,mobile,returning,West,57,True,141,1,0,False,False,False,0,0,0,,141,1
user_005843,34,100k-150k,desktop,returning,West,100,True,30,2,0,False,True,True,23,1,0,8.00232881451177,7,1
user_005844,41,75k-100k,mobile,new,Midwest,27,True,203,8,0,False,False,True,202,18,0,8.262143140954166,1,-10
user_005845,18,30k-50k,mobile,returning,Midwest,92,True,59,1,0,True,True,True,41,1,0,7.697392960859579,18,0
user_005846,22,100k-150k,mobile,returning,East,100,True,70,2,0,False,True,True,26,1,0,8.50463575034943,44,1
user_005847,35,100k-150k,desktop,returning,Midwest,56,True,69,2,0,True,True,True,57,1,0,8.016213588632954,12,1
user_005848,61,100k-150k,mobile,returning,Midwest,19,True,136,4,0,True,False,True,132,2,0,7.9173008076753915,4,2
user_005849,43,75k-100k,desktop,returning,West,69,True,69,2,0,False,False,True,74,3,0,6.018762309481213,-5,-1
user_005850,47,100k-150k,mobile,new,Midwest,100,True,67,4,0,False,False,True,64,1,0,7.987045098532611,3,3
user_005851,57,50k-75k,mobile,new,West,55,True,175,1,0,False,False,False,0,0,0,,175,1
user_005852,56,75k-100k,tablet,returning,East,32,True,78,2,1,True,False,True,72,4,0,8.640560450656467,6,-2
user_005853,38,75k-100k,mobile,returning,South,56,True,70,7,0,False,True,True,60,4,0,7.1221661156678175,10,3
user_005854,26,>150k,tablet,new,South,96,True,92,2,0,False,True,True,79,1,0,8.602279402757935,13,1
user_005855,41,75k-100k,desktop,returning,East,40,True,92,3,0,False,False,True,85,4,0,8.329930684823468,7,-1
user_005856,51,75k-100k,desktop,returning,West,75,True,30,4,0,True,True,True,25,2,0,4.843188635919426,5,2
user_005857,46,50k-75k,mobile,returning,South,35,True,111,1,0,False,False,True,116,1,0,7.718218324872974,-5,0
user_005858,76,30k-50k,desktop,new,Midwest,60,True,125,2,0,True,True,True,88,3,0,7.306070614057914,37,-1
user_005859,42,100k-150k,desktop,returning,East,45,True,103,2,1,True,True,True,43,1,0,5.889973004497103,60,1
user_005860,45,50k-75k,desktop,returning,Midwest,60,False,0,0,0,True,True,True,84,1,0,8.617893876282988,-84,-1
user_005861,60,30k-50k,mobile,returning,West,8,True,184,2,0,False,False,True,181,1,0,6.072448481338411,3,1
user_005862,52,<30k,desktop,returning,South,48,True,80,3,0,True,False,True,63,2,0,6.146259464575309,17,1
user_005863,55,50k-75k,mobile,returning,East,46,True,101,5,0,True,True,True,89,6,0,5.471477217630187,12,-1
user_005864,29,>150k,desktop,returning,South,95,True,58,2,0,True,True,True,73,1,0,7.813990625330254,-15,1
user_005865,22,>150k,desktop,new,East,91,True,107,3,0,False,True,True,87,5,1,8.619956234238419,20,-2
user_005866,30,30k-50k,tablet,returning,East,69,True,91,1,0,True,True,True,103,2,0,9.952113323016206,-12,-1
user_005867,33,<30k,desktop,returning,East,61,True,82,4,0,False,True,False,0,0,0,,82,4
user_005868,68,100k-150k,mobile,new,West,51,True,178,5,0,False,False,True,184,6,0,7.206214714588055,-6,-1
user_005869,37,30k-50k,mobile,returning,East,56,True,34,3,0,True,True,True,36,1,0,8.879165988279674,-2,2
user_005870,46,30k-50k,desktop,new,South,36,True,117,2,0,False,True,True,109,1,0,7.41777594328267,8,1
user_005871,56,75k-100k,mobile,returning,East,43,True,30,3,0,False,False,True,23,1,0,6.479585596518741,7,2
user_005872,40,30k-50k,desktop,new,West,59,True,79,1,0,False,True,True,67,1,0,8.31306912887522,12,0
user_005873,54,<30k,mobile,new,East,44,False,0,0,0,True,True,False,0,0,0,,0,0
user_005874,48,50k-75k,desktop,new,South,50,True,121,2,0,False,True,True,133,1,0,7.804786409965956,-12,1
user_005875,43,100k-150k,desktop,new,Midwest,59,True,131,2,0,False,False,True,136,2,0,8.33663297294323,-5,0
user_005876,30,50k-75k,desktop,new,Midwest,71,True,46,2,0,False,True,True,46,4,0,9.310682431941451,0,-2
user_005877,32,50k-75k,tablet,returning,East,64,True,67,1,0,True,True,True,53,1,0,6.246724831453789,14,0
user_005878,37,<30k,mobile,returning,South,51,True,75,6,1,False,True,True,53,9,0,6.041852739200722,22,-3
user_005879,61,<30k,desktop,returning,East,37,False,0,0,0,False,False,False,0,0,0,,0,0
user_005880,28,75k-100k,desktop,returning,West,91,True,58,3,0,True,True,True,62,5,0,8.515782072517348,-4,-2
user_005881,55,30k-50k,mobile,new,South,42,True,138,1,0,False,False,True,107,1,0,6.4110411417731115,31,0
user_005882,29,30k-50k,mobile,returning,East,97,False,0,0,0,True,True,True,82,1,0,8.554546188771605,-82,-1
user_005883,59,100k-150k,mobile,returning,East,69,True,159,9,1,False,True,True,133,3,0,7.950304755275426,26,6
user_005884,49,50k-75k,mobile,returning,South,39,True,84,5,0,True,False,True,71,7,0,7.481242384073726,13,-2
user_005885,45,50k-75k,desktop,returning,Midwest,64,True,129,3,0,True,True,True,103,2,0,8.036105544470644,26,1
user_005886,35,30k-50k,desktop,returning,South,29,True,88,2,0,True,True,True,54,2,0,8.197151690821782,34,0
user_005887,57,50k-75k,desktop,new,West,58,False,0,0,0,False,False,True,97,2,0,6.5776195478579975,-97,-2
user_005888,49,100k-150k,desktop,new,South,61,True,147,2,0,True,False,True,174,1,0,6.630792082160068,-27,1
user_005889,53,30k-50k,mobile,returning,South,56,True,48,3,0,True,True,True,38,1,0,7.366483760883162,10,2
user_005890,40,50k-75k,desktop,returning,South,46,True,71,1,0,False,False,True,76,1,0,5.946521429874964,-5,0
user_005891,41,75k-100k,desktop,returning,Midwest,37,True,77,5,0,True,False,True,63,5,0,6.525370135164709,14,0
user_005892,31,75k-100k,mobile,new,South,67,True,145,4,0,True,False,True,160,5,0,5.742510250733537,-15,-1
user_005893,48,30k-50k,mobile,returning,West,76,True,67,2,0,True,True,True,20,1,0,8.43850589684131,47,1
user_005894,58,<30k,mobile,returning,East,25,True,113,5,0,False,False,True,125,7,0,8.757123919470295,-12,-2
user_005895,49,50k-75k,mobile,returning,East,27,True,181,3,1,True,True,True,185,1,0,8.237713237379573,-4,2
user_005896,37,<30k,desktop,new,West,64,False,0,0,0,False,True,False,0,0,0,,0,0
user_005897,44,<30k,desktop,returning,Midwest,48,True,86,2,0,False,True,True,86,5,0,8.491015534355489,0,-3
user_005898,40,<30k,mobile,new,West,50,False,0,0,0,True,True,True,101,1,0,6.277448668732434,-101,-1
user_005899,25,50k-75k,mobile,returning,Midwest,46,True,65,3,0,True,True,True,50,1,0,7.690409287116578,15,2
user_005900,40,>150k,desktop,returning,Midwest,61,True,64,3,0,False,True,True,38,1,0,7.178196512726481,26,2
user_005901,34,<30k,desktop,returning,West,64,True,63,3,0,False,True,True,51,1,0,9.306748773300132,12,2
user_005902,80,100k-150k,mobile,new,Midwest,56,True,182,3,0,False,False,True,160,2,1,6.174366545679928,22,1
user_005903,52,50k-75k,desktop,returning,West,58,False,0,0,0,False,True,True,89,2,1,8.988024645505805,-89,-2
user_005904,38,30k-50k,mobile,new,West,44,True,164,1,1,False,True,True,113,1,0,7.335016065432048,51,0
user_005905,33,<30k,desktop,returning,East,69,True,39,2,0,True,True,True,20,5,0,7.43179864451039,19,-3
user_005906,32,100k-150k,desktop,new,Midwest,96,True,87,1,0,False,True,True,59,1,0,9.52490124082061,28,0
user_005907,75,50k-75k,mobile,new,West,59,True,144,1,0,True,False,True,131,1,0,7.792033500608684,13,0
user_005908,44,100k-150k,desktop,new,West,90,True,113,2,0,True,True,True,73,2,0,8.98908461629146,40,0
user_005909,18,75k-100k,mobile,returning,East,72,True,30,2,0,False,True,True,35,1,0,5.035492287494373,-5,1
user_005910,55,100k-150k,mobile,new,South,52,True,103,2,0,True,True,False,0,0,0,,103,2
user_005911,64,100k-150k,mobile,returning,West,47,False,0,0,0,True,True,True,70,1,0,8.68917746763909,-70,-1
user_005912,61,30k-50k,mobile,returning,East,46,True,85,3,0,True,False,True,55,6,0,6.610364472913944,30,-3
user_005913,50,75k-100k,desktop,new,Midwest,43,True,155,1,0,True,True,True,109,1,0,8.045744843674973,46,0
user_005914,18,50k-75k,tablet,returning,Midwest,58,True,84,2,0,True,True,True,73,2,0,8.509699242887669,11,0
user_005915,40,50k-75k,mobile,returning,South,65,True,77,5,0,True,False,True,62,2,1,5.771752702606038,15,3
user_005916,37,<30k,desktop,returning,South,40,True,44,1,0,False,True,False,0,0,0,,44,1
user_005917,34,75k-100k,desktop,returning,East,58,False,0,0,0,True,False,True,109,1,0,6.958886536411748,-109,-1
user_005918,30,75k-100k,mobile,returning,East,96,True,89,2,0,False,True,True,56,1,0,9.06735491862637,33,1
user_005919,35,50k-75k,mobile,new,Midwest,56,True,67,5,0,False,True,True,36,5,0,7.502185195542536,31,0
user_005920,47,50k-75k,desktop,returning,West,58,True,99,1,0,False,False,True,116,1,0,7.091459105705529,-17,0
user_005921,62,<30k,desktop,returning,East,23,True,132,5,0,False,False,False,0,0,0,,132,5
user_005922,56,30k-50k,mobile,returning,East,37,True,46,3,0,False,False,True,20,2,0,9.689004332994534,26,1
user_005923,42,100k-150k,mobile,new,West,85,True,88,4,0,True,True,True,79,2,0,8.710036995618982,9,2
user_005924,75,50k-75k,desktop,returning,West,30,True,97,3,0,True,False,True,92,2,0,6.868958399913201,5,1
user_005925,53,75k-100k,desktop,new,East,55,True,86,1,1,False,False,True,56,1,1,6.687700355534278,30,0
user_005926,47,<30k,mobile,returning,East,22,True,57,7,1,False,False,True,51,6,0,6.0170530024173505,6,1
user_005927,38,>150k,desktop,returning,South,39,True,78,4,0,False,True,True,66,5,0,6.244279040297612,12,-1
user_005928,36,50k-75k,desktop,returning,East,30,True,132,1,0,False,True,True,103,1,0,6.980082158311452,29,0
user_005929,51,50k-75k,tablet,returning,East,51,True,132,1,0,False,False,True,141,2,0,7.749460158812195,-9,-1
user_005930,61,100k-150k,mobile,returning,South,64,True,30,2,0,True,False,True,20,1,0,4.984258421969553,10,1
user_005931,33,50k-75k,desktop,returning,West,70,True,51,5,0,False,True,False,0,0,0,,51,5
user_005932,51,100k-150k,desktop,returning,South,63,True,74,2,0,True,False,True,130,2,0,8.517145700508681,-56,0
user_005933,32,<30k,desktop,returning,West,43,True,83,1,0,False,False,True,99,1,0,5.8157748509927965,-16,0
user_005934,55,75k-100k,desktop,returning,East,22,True,127,1,0,False,False,True,159,2,0,7.607025171391665,-32,-1
user_005935,29,<30k,mobile,returning,South,48,True,89,1,0,True,True,True,54,1,1,8.691709389993456,35,0
user_005936,56,30k-50k,mobile,returning,East,50,True,54,3,1,True,False,True,36,3,1,4.8405587525949185,18,0
user_005937,57,30k-50k,desktop,returning,Midwest,32,True,84,3,1,False,False,True,85,4,0,6.902187828156759,-1,-1
user_005938,43,75k-100k,desktop,returning,South,29,True,184,3,1,False,False,True,192,4,0,5.1619978044388475,-8,-1
user_005939,54,50k-75k,desktop,returning,East,43,True,91,1,0,True,True,True,65,1,0,6.937728031278255,26,0
user_005940,32,75k-100k,desktop,new,Midwest,87,True,115,4,0,True,True,True,100,3,0,7.9439238127223595,15,1
user_005941,78,100k-150k,mobile,returning,Midwest,53,True,61,4,0,True,True,True,50,5,0,10.0,11,-1
user_005942,40,30k-50k,desktop,new,East,19,True,171,6,0,False,True,True,101,4,1,7.653979941908146,70,2
user_005943,74,75k-100k,desktop,returning,East,33,True,30,4,0,False,True,True,20,5,0,9.86993487400903,10,-1
user_005944,38,30k-50k,mobile,returning,East,44,True,82,1,1,False,False,True,81,1,0,5.668609653659053,1,0
user_005945,23,50k-75k,mobile,returning,West,68,True,81,4,0,False,True,True,87,4,0,8.180870596950289,-6,0
user_005946,44,75k-100k,desktop,returning,East,50,True,104,1,0,False,False,True,99,1,0,5.851243272310934,5,0
user_005947,29,<30k,mobile,new,East,61,False,0,0,0,False,True,False,0,0,0,,0,0
user_005948,50,100k-150k,desktop,returning,West,81,True,101,4,1,True,True,True,68,2,0,8.523414179313551,33,2
user_005949,45,100k-150k,desktop,returning,West,68,True,77,1,0,True,True,True,37,1,0,9.76283164952625,40,0
user_005950,66,>150k,desktop,new,East,39,True,156,5,1,True,True,True,127,4,0,8.24338579276461,29,1
user_005951,40,30k-50k,mobile,returning,East,89,True,34,1,0,False,False,True,20,1,1,6.997474109945251,14,0
user_005952,68,75k-100k,desktop,returning,South,46,True,47,5,0,False,False,True,47,3,0,8.23171839486505,0,2
user_005953,34,75k-100k,desktop,new,East,96,True,57,5,0,False,True,True,40,7,0,8.704021146515752,17,-2
user_005954,18,50k-75k,desktop,new,Midwest,61,True,137,2,0,True,True,True,146,3,0,8.168093060815702,-9,-1
user_005955,73,30k-50k,mobile,new,East,24,True,150,3,0,True,False,True,154,1,0,7.2525122360086725,-4,2
user_005956,39,50k-75k,desktop,returning,West,56,True,78,3,1,False,False,True,113,2,0,7.405761943561013,-35,1
user_005957,20,100k-150k,desktop,new,Midwest,79,False,0,0,0,True,True,True,89,3,0,8.350023727811674,-89,-3
user_005958,43,30k-50k,desktop,returning,East,51,True,95,1,0,True,True,True,47,1,0,7.684441476626415,48,0
user_005959,50,<30k,desktop,new,East,51,False,0,0,0,True,True,True,93,1,0,8.23638598702526,-93,-1
user_005960,46,30k-50k,desktop,returning,South,0,True,101,7,1,False,False,True,109,8,0,7.252726444767745,-8,-1
user_005961,28,30k-50k,mobile,returning,South,69,False,0,0,0,False,True,False,0,0,0,,0,0
user_005962,34,<30k,desktop,returning,East,68,True,61,2,0,False,True,False,0,0,0,,61,2
user_005963,64,50k-75k,desktop,returning,South,30,True,86,1,0,False,False,True,99,1,0,6.530032323388448,-13,0
user_005964,42,<30k,mobile,returning,South,41,True,44,3,0,True,True,True,20,4,0,7.974331127411896,24,-1
user_005965,47,30k-50k,desktop,returning,East,54,True,123,1,0,False,False,True,120,1,0,5.32768294267995,3,0
user_005966,44,50k-75k,desktop,new,West,72,True,163,1,0,False,True,True,122,1,0,8.423736803847794,41,0
user_005967,43,50k-75k,desktop,new,East,36,True,137,2,2,False,False,True,157,5,0,6.6161489123816555,-20,-3
user_005968,55,75k-100k,desktop,returning,Midwest,39,True,63,5,0,True,True,True,44,2,0,7.2412722629645225,19,3
user_005969,24,100k-150k,desktop,new,Midwest,94,True,115,1,0,False,True,False,0,0,0,,115,1
user_005970,53,>150k,mobile,new,East,61,True,132,5,0,True,False,True,142,2,0,8.54094641461609,-10,3
user_005971,56,50k-75k,mobile,returning,West,56,True,65,5,0,False,False,True,40,7,0,6.456721028673481,25,-2
user_005972,48,50k-75k,tablet,returning,Midwest,53,True,105,4,0,True,True,True,86,3,0,8.886642951681928,19,1
user_005973,18,50k-75k,mobile,returning,South,59,True,38,1,0,False,True,True,29,1,0,7.013034131859913,9,0
user_005974,46,50k-75k,desktop,new,South,59,True,98,2,1,False,True,True,51,1,0,9.936787062935155,47,1
user_005975,47,<30k,desktop,new,East,27,True,127,4,1,True,True,True,66,2,0,6.689398222091614,61,2
user_005976,32,30k-50k,desktop,returning,South,63,True,47,2,0,True,True,True,42,1,0,8.332110670385559,5,1
user_005977,65,30k-50k,desktop,returning,West,7,False,0,0,0,False,False,True,130,2,0,7.803417826515101,-130,-2
user_005978,39,30k-50k,desktop,new,East,59,True,137,2,0,False,True,True,136,1,0,9.120549847700477,1,1
user_005979,42,75k-100k,mobile,returning,South,62,True,56,5,0,False,True,False,0,0,0,,56,5
user_005980,34,50k-75k,desktop,returning,West,89,True,42,3,0,False,True,True,34,1,0,6.03373816721898,8,2
user_005981,67,50k-75k,desktop,returning,West,45,True,112,7,0,True,True,True,78,7,0,6.754435428603604,34,0
user_005982,63,50k-75k,mobile,returning,South,42,True,108,2,0,True,True,True,96,1,0,8.598812162688999,12,1
user_005983,40,75k-100k,mobile,returning,East,44,True,87,2,0,False,False,True,122,4,0,6.493660557415834,-35,-2
user_005984,44,75k-100k,mobile,new,East,40,True,122,2,1,True,False,True,121,2,0,6.827898399192581,1,0
user_005985,68,75k-100k,mobile,new,Midwest,40,False,0,0,0,False,False,True,106,3,0,7.649338987524311,-106,-3
user_005986,34,30k-50k,desktop,returning,Midwest,75,True,126,2,0,True,True,True,115,3,0,9.176907672622598,11,-1
user_005987,45,<30k,desktop,returning,Midwest,71,True,49,1,0,True,True,True,29,1,0,8.740588027597322,20,0
user_005988,54,50k-75k,desktop,returning,Midwest,39,False,0,0,0,False,True,True,89,1,0,6.82052041554801,-89,-1
user_005989,65,<30k,desktop,returning,Midwest,6,True,153,4,2,False,False,True,156,2,0,6.504881900608409,-3,2
user_005990,44,<30k,mobile,returning,East,29,False,0,0,0,False,False,False,0,0,0,,0,0
user_005991,36,>150k,mobile,new,Midwest,37,True,101,2,0,True,True,True,100,1,0,8.586083508111624,1,1
user_005992,80,100k-150k,mobile,returning,East,43,True,93,4,0,False,False,True,73,5,0,7.932754627839633,20,-1
user_005993,50,75k-100k,mobile,new,South,62,True,161,5,1,False,True,True,114,4,0,9.835086890743566,47,1
user_005994,42,30k-50k,mobile,new,South,51,False,0,0,0,False,True,True,105,1,0,9.55162740293902,-105,-1
user_005995,18,100k-150k,mobile,returning,East,87,True,90,2,1,True,False,True,78,2,1,8.355109829151525,12,0
user_005996,40,<30k,mobile,new,South,12,True,167,2,0,False,True,True,135,2,0,9.93425612116291,32,0
user_005997,29,50k-75k,mobile,new,East,90,True,100,5,0,False,True,True,77,4,0,8.672587478810488,23,1
user_005998,35,75k-100k,mobile,new,East,59,True,177,2,0,False,False,True,174,1,0,7.85977437912473,3,1
user_005999,51,50k-75k,mobile,new,West,92,True,72,7,0,False,True,True,54,5,0,8.830834634296195,18,2
user_006000,40,75k-100k,mobile,new,Midwest,37,True,154,5,0,False,True,True,102,3,0,7.36287494703595,52,2
user_006001,68,30k-50k,desktop,returning,West,56,True,88,4,1,False,False,True,76,6,0,6.724991548104116,12,-2
user_006002,48,50k-75k,mobile,returning,Midwest,36,True,80,5,0,True,True,True,70,9,0,9.050233043272797,10,-4
user_006003,27,50k-75k,desktop,new,East,100,True,138,2,0,True,True,True,119,1,0,10.0,19,1
user_006004,52,50k-75k,desktop,returning,Midwest,34,False,0,0,0,False,True,True,98,2,0,7.229851878957942,-98,-2
user_006005,18,50k-75k,mobile,new,West,72,True,136,7,1,True,True,True,156,8,0,8.122376983150996,-20,-1
user_006006,35,>150k,desktop,returning,East,77,True,85,4,0,True,True,True,94,2,0,8.884695768954737,-9,2
user_006007,31,50k-75k,mobile,new,West,81,True,42,4,0,True,True,True,59,6,0,7.415966002359644,-17,-2
user_006008,31,75k-100k,desktop,new,East,84,True,117,1,0,True,True,True,88,1,0,8.966980206597349,29,0
user_006009,36,100k-150k,desktop,new,West,73,True,114,3,0,True,True,True,76,3,0,8.882655190628885,38,0
user_006010,25,75k-100k,mobile,returning,South,78,True,30,8,0,True,True,True,20,10,0,9.995463929586949,10,-2
user_006011,69,75k-100k,mobile,new,East,33,True,157,5,0,True,False,False,0,0,0,,157,5
user_006012,62,100k-150k,mobile,returning,East,37,True,46,2,0,True,True,True,32,3,0,8.50745985449823,14,-1
user_006013,38,50k-75k,desktop,returning,West,43,True,46,2,0,True,True,True,49,1,0,8.193977951376317,-3,1
user_006014,51,30k-50k,mobile,new,South,30,True,118,2,0,False,True,True,92,3,0,7.165494055314971,26,-1
user_006015,80,<30k,mobile,new,East,24,False,0,0,0,False,False,True,130,2,0,6.464386321111271,-130,-2
user_006016,40,50k-75k,desktop,returning,South,47,True,106,3,0,True,True,True,49,5,0,8.471589805804607,57,-2
user_006017,57,>150k,desktop,returning,East,37,True,78,5,0,False,True,True,46,9,0,7.6467001508773595,32,-4
user_006018,65,100k-150k,desktop,returning,West,47,True,88,3,1,False,True,True,64,1,0,7.977538445430303,24,2
user_006019,39,<30k,desktop,returning,East,25,True,94,3,1,False,True,True,57,4,0,8.25579676258501,37,-1
user_006020,62,75k-100k,desktop,returning,East,33,True,92,1,0,False,True,True,107,1,0,8.270714782131417,-15,0
user_006021,18,50k-75k,desktop,returning,East,65,True,96,4,0,True,True,True,110,2,0,8.131337713896352,-14,2
user_006022,61,30k-50k,tablet,new,East,8,True,144,2,0,False,False,True,160,2,0,7.155366921207736,-16,0
user_006023,43,100k-150k,desktop,returning,South,61,True,112,1,0,False,True,True,66,1,0,7.2309519799101825,46,0
user_006024,69,50k-75k,mobile,returning,Midwest,8,True,179,5,0,False,False,True,168,4,0,6.808389737306764,11,1
user_006025,50,50k-75k,mobile,returning,South,46,True,119,1,1,True,False,True,117,1,0,5.799390063672429,2,0
user_006026,40,100k-150k,desktop,new,Midwest,86,True,63,5,0,False,False,True,77,10,0,7.822734014942459,-14,-5
user_006027,23,30k-50k,desktop,new,South,78,True,95,1,0,True,True,True,89,1,0,7.452779212862053,6,0
user_006028,66,30k-50k,desktop,returning,Midwest,54,True,132,3,0,True,True,True,104,2,0,9.299671590357358,28,1
user_006029,31,50k-75k,desktop,returning,West,74,True,103,2,0,False,False,True,114,1,0,4.616378026561809,-11,1
user_006030,21,50k-75k,desktop,new,South,77,True,76,3,0,True,True,True,55,2,0,7.475725498994731,21,1
user_006031,44,30k-50k,desktop,new,West,56,True,165,3,1,False,True,True,106,2,0,6.888446850929815,59,1
user_006032,25,<30k,mobile,returning,East,60,True,90,8,0,True,True,True,65,8,1,8.822161253503769,25,0
user_006033,41,<30k,desktop,new,West,50,True,102,6,0,False,False,True,116,6,0,8.517373290555836,-14,0
user_006034,45,50k-75k,mobile,new,West,68,True,163,3,1,True,True,True,140,1,0,6.827689424765244,23,2
user_006035,40,50k-75k,desktop,returning,Midwest,68,True,131,2,1,True,True,True,119,1,0,7.303131433156127,12,1
user_006036,73,50k-75k,desktop,returning,West,51,True,103,1,1,True,True,True,88,1,0,5.715650126094792,15,0
user_006037,36,<30k,desktop,returning,Midwest,23,False,0,0,0,True,False,True,126,1,0,7.1592053832574996,-126,-1
user_006038,20,<30k,mobile,returning,South,58,True,52,3,0,False,True,True,20,2,0,10.0,32,1
user_006039,54,<30k,desktop,returning,South,43,False,0,0,0,False,False,False,0,0,0,,0,0
user_006040,76,<30k,desktop,new,Midwest,0,False,0,0,0,False,False,True,108,1,0,6.363732980200187,-108,-1
user_006041,50,<30k,desktop,new,West,52,True,169,3,0,True,True,True,123,3,0,8.388093696715805,46,0
user_006042,61,75k-100k,desktop,new,West,40,True,110,2,0,False,False,True,101,3,0,6.082249437131137,9,-1
user_006043,61,75k-100k,desktop,returning,West,42,True,97,3,0,False,True,True,93,2,0,8.296582808429259,4,1
user_006044,45,50k-75k,mobile,new,South,43,True,157,1,0,False,False,True,147,2,0,5.769002603775463,10,-1
user_006045,62,75k-100k,desktop,returning,South,39,True,82,1,0,False,True,True,68,1,0,7.494911434950373,14,0
user_006046,43,<30k,mobile,new,West,81,True,52,6,0,True,True,True,52,5,0,7.978867797938754,0,1
user_006047,53,75k-100k,mobile,returning,South,59,True,94,2,0,True,True,True,79,2,0,7.252324561572172,15,0
user_006048,46,100k-150k,desktop,returning,West,86,True,71,4,0,True,True,True,42,2,0,9.928565180474159,29,2
user_006049,18,<30k,mobile,returning,East,46,False,0,0,0,True,True,False,0,0,0,,0,0
user_006050,38,50k-75k,desktop,returning,West,71,True,62,2,0,True,True,True,76,1,0,7.63412523133124,-14,1
user_006051,50,50k-75k,desktop,returning,West,49,True,36,1,0,True,True,True,51,1,0,9.947640458071392,-15,0
user_006052,45,>150k,desktop,new,East,71,True,118,6,0,True,True,False,0,0,0,,118,6
user_006053,28,50k-75k,mobile,returning,Midwest,76,True,60,6,0,False,True,True,68,5,1,7.158113905152513,-8,1
user_006054,22,50k-75k,mobile,new,South,53,True,137,5,0,False,True,True,129,5,0,7.566848464633224,8,0
user_006055,29,100k-150k,mobile,returning,Midwest,97,True,33,1,0,False,True,True,31,1,0,8.112370598189345,2,0
user_006056,33,50k-75k,desktop,new,South,56,True,97,6,0,True,True,True,39,2,1,6.491977208001602,58,4
user_006057,72,30k-50k,mobile,returning,South,32,True,97,6,0,False,False,True,87,6,0,6.798537663243311,10,0
user_006058,77,50k-75k,desktop,returning,West,35,False,0,0,0,False,False,True,91,1,0,7.776130432309515,-91,-1
user_006059,58,>150k,desktop,returning,South,47,True,117,3,0,False,True,True,95,1,0,7.30223767351406,22,2
user_006060,58,50k-75k,mobile,returning,West,21,True,148,6,2,False,False,True,115,7,0,5.915353009570584,33,-1
user_006061,71,50k-75k,desktop,returning,East,39,False,0,0,0,False,False,False,0,0,0,,0,0
user_006062,54,50k-75k,mobile,returning,Midwest,37,True,64,2,0,False,True,True,48,2,0,8.196121661802085,16,0
user_006063,55,75k-100k,mobile,returning,West,52,True,97,1,0,False,True,True,91,1,0,7.102212382496879,6,0
user_006064,35,100k-150k,mobile,returning,West,54,True,103,1,1,False,False,True,116,2,0,5.2870498792678,-13,-1
user_006065,61,100k-150k,mobile,returning,Midwest,27,True,144,6,1,True,True,True,81,3,0,5.480024587383154,63,3
user_006066,30,50k-75k,mobile,returning,West,59,True,63,2,0,True,True,False,0,0,0,,63,2
user_006067,19,50k-75k,desktop,returning,Midwest,84,True,30,4,0,True,True,True,50,2,1,7.026279536684752,-20,2
user_006068,24,100k-150k,tablet,returning,West,94,True,33,5,0,False,True,True,45,2,0,10.0,-12,3
user_006069,54,50k-75k,mobile,returning,West,63,True,135,1,0,False,False,True,122,1,0,8.641594463403472,13,0
user_006070,38,30k-50k,desktop,returning,South,52,True,88,3,0,True,True,True,61,1,0,7.277968189211752,27,2
user_006071,66,30k-50k,mobile,new,Midwest,26,True,173,3,0,True,False,True,185,1,0,4.621688615379192,-12,2
user_006072,54,30k-50k,tablet,new,West,65,True,147,2,0,False,False,True,151,1,0,9.161636826956032,-4,1
user_006073,18,75k-100k,desktop,new,West,98,True,67,2,0,False,True,True,41,2,0,8.864125142964156,26,0
user_006074,53,30k-50k,desktop,returning,Midwest,21,True,103,2,0,False,True,True,66,3,0,9.652130901708208,37,-1
user_006075,36,<30k,mobile,returning,Midwest,41,True,68,4,0,False,False,True,31,6,0,9.87262711798923,37,-2
user_006076,40,100k-150k,mobile,returning,East,56,True,67,5,0,False,True,True,20,5,0,5.522856900255258,47,0
user_006077,58,30k-50k,desktop,returning,East,38,True,64,2,0,False,False,True,74,4,0,7.438686990434034,-10,-2
user_006078,66,75k-100k,mobile,returning,West,46,True,115,3,0,False,False,True,103,5,0,8.365302836890113,12,-2
user_006079,41,<30k,desktop,new,West,54,True,118,4,0,True,True,True,75,2,0,8.579337454376844,43,2
user_006080,29,<30k,mobile,returning,South,59,True,108,4,1,True,True,True,72,5,1,6.507036486230497,36,-1
user_006081,41,<30k,desktop,returning,South,33,False,0,0,0,True,True,True,129,1,0,8.862954326246241,-129,-1
user_006082,43,50k-75k,tablet,returning,West,75,True,98,2,0,False,False,True,98,3,0,7.417732320012236,0,-1
user_006083,58,50k-75k,mobile,returning,East,62,True,85,5,0,False,True,True,45,3,0,6.703644440370613,40,2
user_006084,25,<30k,mobile,returning,Midwest,51,False,0,0,0,False,True,True,67,1,0,7.049288434896159,-67,-1
user_006085,36,<30k,mobile,new,East,52,False,0,0,0,False,True,True,129,1,0,6.692493060510414,-129,-1
user_006086,51,100k-150k,desktop,new,Midwest,45,False,0,0,0,False,True,True,113,1,0,7.978304205913439,-113,-1
user_006087,38,<30k,mobile,returning,West,36,False,0,0,0,True,True,True,110,1,0,8.985321755765966,-110,-1
user_006088,18,50k-75k,desktop,new,East,66,True,152,1,0,False,False,True,141,1,0,9.68686136555373,11,0
user_006089,48,75k-100k,mobile,returning,East,39,True,70,5,0,False,False,True,81,6,0,8.085704335798269,-11,-1
user_006090,25,50k-75k,mobile,new,West,73,True,123,2,0,True,True,True,112,1,0,9.578342764585202,11,1
user_006091,58,50k-75k,desktop,returning,Midwest,53,True,71,5,0,True,True,True,49,4,0,7.444770067494388,22,1
user_006092,31,>150k,mobile,new,West,94,True,95,3,1,False,True,True,107,2,0,6.2384032827917215,-12,1
user_006093,35,30k-50k,desktop,returning,South,66,True,67,2,0,True,False,True,84,3,2,7.518485950490364,-17,-1
user_006094,43,100k-150k,desktop,returning,Midwest,31,False,0,0,0,True,False,True,90,1,0,6.7318899256308935,-90,-1
user_006095,43,<30k,desktop,new,West,65,True,79,1,0,True,False,True,52,1,0,9.663318576896861,27,0
user_006096,53,75k-100k,mobile,returning,East,45,True,97,2,1,False,True,True,92,1,0,7.608355785165447,5,1
user_006097,33,50k-75k,desktop,returning,West,58,True,82,2,0,False,False,True,94,3,0,8.095722036161739,-12,-1
user_006098,38,75k-100k,mobile,returning,East,60,True,89,5,0,False,True,True,55,2,0,9.482743462180617,34,3
user_006099,53,30k-50k,desktop,new,East,67,True,101,1,0,False,True,True,62,4,0,7.481612539185939,39,-3
user_006100,40,50k-75k,mobile,returning,West,79,False,0,0,0,False,True,True,123,1,0,9.147143071454362,-123,-1
user_006101,52,30k-50k,mobile,new,West,54,True,156,2,0,True,True,True,102,1,0,8.765857475329495,54,1
user_006102,51,<30k,tablet,new,Midwest,23,True,139,6,0,False,True,False,0,0,0,,139,6
user_006103,34,<30k,mobile,returning,East,54,True,52,1,0,True,True,True,37,1,0,8.31856614845929,15,0
user_006104,60,<30k,mobile,returning,West,46,True,87,1,0,False,False,True,85,1,1,8.311893716808155,2,0
user_006105,53,50k-75k,desktop,returning,East,47,False,0,0,0,False,False,False,0,0,0,,0,0
user_006106,69,>150k,desktop,new,East,49,False,0,0,0,True,True,True,115,1,0,7.798395088975382,-115,-1
user_006107,34,75k-100k,desktop,returning,West,89,True,77,1,0,True,True,True,61,1,0,8.224502164138634,16,0
user_006108,48,75k-100k,mobile,new,West,71,True,125,2,0,False,False,True,147,3,1,6.167480615986815,-22,-1
user_006109,41,50k-75k,desktop,returning,Midwest,44,True,110,2,0,True,False,True,108,2,0,5.517860996593329,2,0
user_006110,18,30k-50k,mobile,returning,West,69,True,94,6,0,True,True,True,100,6,0,7.420237776101092,-6,0
user_006111,44,<30k,tablet,returning,West,69,True,62,3,1,True,False,True,25,1,0,6.811935405350343,37,2
user_006112,43,75k-100k,mobile,new,South,59,True,101,4,0,False,True,True,102,2,0,8.224739285204135,-1,2
user_006113,50,100k-150k,desktop,new,East,57,True,80,1,0,False,True,True,72,1,0,7.624962515020356,8,0
user_006114,34,>150k,desktop,returning,Midwest,62,True,76,2,0,True,True,True,43,1,0,10.0,33,1
user_006115,69,50k-75k,desktop,returning,East,32,False,0,0,0,True,True,True,105,1,0,9.1111414366279,-105,-1
user_006116,33,<30k,desktop,new,East,71,True,67,2,0,False,True,False,0,0,0,,67,2
user_006117,62,100k-150k,mobile,new,East,30,True,62,6,1,False,True,True,53,3,0,7.65637310461829,9,3
user_006118,31,50k-75k,mobile,new,South,67,False,0,0,0,False,True,True,82,1,0,10.0,-82,-1
user_006119,41,75k-100k,mobile,new,South,37,True,88,1,0,False,False,True,94,1,0,6.758793831799893,-6,0
user_006120,19,>150k,tablet,new,Midwest,100,True,99,2,0,False,True,True,88,2,0,8.880719872921398,11,0
user_006121,36,100k-150k,desktop,returning,East,23,True,93,4,0,False,False,True,81,5,0,6.472593684937478,12,-1
user_006122,35,30k-50k,mobile,new,West,48,True,153,2,0,False,True,True,119,3,0,9.815908221967085,34,-1
user_006123,46,30k-50k,desktop,returning,East,63,False,0,0,0,True,False,True,115,4,0,7.886711595155277,-115,-4
user_006124,18,75k-100k,desktop,new,East,56,False,0,0,0,False,True,True,125,1,0,8.458815579487075,-125,-1
user_006125,51,<30k,desktop,new,South,56,True,191,2,0,False,False,True,188,5,0,6.528818372610011,3,-3
user_006126,38,30k-50k,desktop,new,East,66,True,127,1,0,True,False,True,128,2,0,8.721866272381392,-1,-1
user_006127,19,50k-75k,desktop,new,Midwest,91,True,104,1,0,False,True,True,86,1,0,8.54457056544518,18,0
user_006128,71,100k-150k,desktop,returning,East,50,True,98,5,0,True,False,True,92,4,0,7.281791108120274,6,1
user_006129,56,75k-100k,mobile,new,South,10,True,199,5,0,False,True,True,153,7,0,8.43901931870503,46,-2
user_006130,66,100k-150k,mobile,returning,West,24,True,117,1,0,False,False,True,106,1,0,8.730355203767736,11,0
user_006131,60,75k-100k,mobile,returning,East,24,True,213,2,0,True,True,True,175,1,0,5.872920878168191,38,1
user_006132,22,<30k,desktop,returning,South,71,True,90,4,0,False,False,True,95,6,0,9.738962786744288,-5,-2
user_006133,49,50k-75k,tablet,returning,East,59,True,128,2,0,True,True,True,117,1,0,8.262982987246952,11,1
user_006134,34,100k-150k,desktop,new,South,51,True,113,2,0,False,True,True,119,1,0,9.587920209586148,-6,1
user_006135,39,75k-100k,desktop,returning,East,48,True,128,6,0,True,False,True,110,1,0,9.496731105610444,18,5
user_006136,55,50k-75k,desktop,new,East,39,True,103,5,1,False,False,True,88,8,0,5.530892145953802,15,-3
user_006137,44,<30k,desktop,returning,West,67,True,139,1,0,False,True,True,124,1,0,6.223736671468756,15,0
user_006138,52,50k-75k,desktop,returning,Midwest,66,True,138,4,0,False,True,True,111,5,0,8.786351850046085,27,-1
user_006139,32,50k-75k,mobile,returning,South,60,True,32,2,0,False,False,True,20,1,0,7.660192707291593,12,1
user_006140,39,30k-50k,desktop,new,South,48,True,148,2,0,False,False,True,161,2,0,7.312983837735348,-13,0
user_006141,43,50k-75k,desktop,returning,West,43,True,88,1,0,True,False,True,112,2,0,5.224267344871254,-24,-1
user_006142,48,>150k,tablet,new,East,71,True,47,4,0,True,True,True,31,7,0,8.2997076627568,16,-3
user_006143,52,>150k,desktop,new,South,61,True,130,1,0,False,True,True,120,1,0,7.307851008531364,10,0
user_006144,47,>150k,mobile,new,East,67,True,79,2,0,False,True,True,29,1,0,10.0,50,1
user_006145,55,>150k,desktop,new,West,58,True,93,1,1,False,True,True,52,1,0,6.781029523920961,41,0
user_006146,46,100k-150k,mobile,returning,East,35,True,94,4,1,True,False,True,109,4,0,5.283811643950602,-15,0
user_006147,25,50k-75k,desktop,returning,East,81,True,62,3,0,False,True,True,42,4,0,8.44248290427964,20,-1
user_006148,44,30k-50k,mobile,new,South,31,True,128,7,0,False,False,False,0,0,0,,128,7
user_006149,32,75k-100k,desktop,new,East,57,True,139,3,0,True,True,True,103,5,0,8.298124735494481,36,-2
user_006150,60,30k-50k,desktop,new,East,38,True,124,2,0,False,False,False,0,0,0,,124,2
user_006151,56,30k-50k,desktop,returning,West,56,True,108,2,0,False,False,True,107,2,0,6.091808792746804,1,0
user_006152,29,>150k,desktop,new,East,82,True,120,2,0,True,True,True,81,1,0,8.510571308141381,39,1
user_006153,33,75k-100k,desktop,returning,Midwest,65,True,109,1,0,False,True,True,111,1,0,8.49449925050202,-2,0
user_006154,52,<30k,desktop,returning,East,57,True,81,1,0,False,False,True,76,2,0,5.765474312847927,5,-1
user_006155,19,>150k,mobile,returning,East,89,True,60,5,1,True,True,True,40,3,1,9.35730764420787,20,2
user_006156,55,50k-75k,desktop,new,Midwest,50,True,123,1,0,False,False,True,167,1,0,6.810018493060416,-44,0
user_006157,38,50k-75k,mobile,returning,West,62,True,73,1,0,True,False,True,57,1,0,5.769351706139248,16,0
user_006158,45,50k-75k,mobile,new,South,46,True,134,6,0,False,True,True,88,6,0,9.610162920983974,46,0
user_006159,33,30k-50k,desktop,returning,South,66,True,88,5,0,True,True,True,62,2,0,8.585196318988466,26,3
user_006160,62,<30k,desktop,returning,East,4,True,93,6,1,True,False,True,104,7,1,7.124668529889848,-11,-1
user_006161,58,100k-150k,desktop,returning,West,45,False,0,0,0,False,False,True,102,1,0,8.993641728341153,-102,-1
user_006162,62,100k-150k,mobile,new,Midwest,14,True,173,4,1,True,True,True,156,3,0,8.636886170957379,17,1
user_006163,29,75k-100k,desktop,returning,East,71,True,137,3,0,True,True,True,110,4,0,7.747739431610225,27,-1
user_006164,46,100k-150k,desktop,new,West,64,True,143,1,0,False,True,True,123,1,0,8.323086207394578,20,0
user_006165,40,<30k,desktop,returning,Midwest,48,True,94,3,0,True,False,True,50,2,0,6.501535761021853,44,1
user_006166,38,100k-150k,mobile,new,East,66,True,61,4,1,False,True,True,99,2,0,9.273219232764239,-38,2
user_006167,54,50k-75k,mobile,returning,East,51,True,103,1,0,False,True,True,84,1,0,9.586136355898944,19,0
user_006168,60,75k-100k,mobile,returning,Midwest,19,True,167,4,0,False,True,True,130,1,0,8.945101424998636,37,3
user_006169,68,30k-50k,mobile,new,Midwest,44,True,85,2,0,False,False,True,107,1,0,5.342458539207854,-22,1
user_006170,51,30k-50k,desktop,returning,East,52,False,0,0,0,True,False,True,84,1,0,7.202942477926118,-84,-1
user_006171,27,50k-75k,mobile,new,Midwest,95,True,98,4,0,True,True,True,62,1,0,10.0,36,3
user_006172,61,100k-150k,mobile,new,West,65,False,0,0,0,False,True,True,90,2,0,8.132373399750259,-90,-2
user_006173,41,100k-150k,desktop,returning,Midwest,13,True,106,5,0,True,True,True,81,2,0,7.924162426568163,25,3
user_006174,44,50k-75k,mobile,returning,West,62,True,110,2,1,True,True,True,80,1,0,8.141296383364901,30,1
user_006175,44,100k-150k,desktop,new,West,74,True,99,7,0,False,True,True,60,7,0,7.492840940618604,39,0
user_006176,41,75k-100k,mobile,new,Midwest,75,True,72,1,0,True,True,True,20,1,0,7.439308665180238,52,0
user_006177,35,100k-150k,desktop,returning,West,70,True,102,3,0,False,True,False,0,0,0,,102,3
user_006178,67,30k-50k,tablet,returning,South,31,True,73,2,0,False,True,True,89,1,0,6.420004391886636,-16,1
user_006179,32,50k-75k,mobile,returning,Midwest,55,True,138,3,0,False,True,True,71,2,1,8.844688396287928,67,1
user_006180,18,30k-50k,desktop,new,Midwest,50,True,135,3,0,False,True,False,0,0,0,,135,3
user_006181,59,100k-150k,desktop,returning,South,39,True,97,3,1,False,False,True,116,5,0,6.712228953750102,-19,-2
user_006182,57,50k-75k,mobile,returning,East,21,True,110,2,0,True,True,True,87,1,0,7.8204934129474575,23,1
user_006183,53,100k-150k,desktop,new,Midwest,40,True,133,3,0,True,True,True,102,2,0,6.567301327641476,31,1
user_006184,56,100k-150k,mobile,returning,South,60,True,88,3,0,True,True,True,54,3,0,8.001922409612218,34,0
user_006185,21,75k-100k,tablet,returning,East,86,True,98,4,0,False,True,True,116,7,0,7.170798813784393,-18,-3
user_006186,42,>150k,desktop,returning,South,64,False,0,0,0,True,True,False,0,0,0,,0,0
user_006187,33,50k-75k,desktop,returning,East,93,True,40,2,1,False,True,True,28,2,1,7.572920235204304,12,0
user_006188,75,<30k,mobile,new,West,40,True,83,4,0,False,False,True,75,3,0,7.093162775691871,8,1
user_006189,66,<30k,desktop,returning,West,26,True,165,5,1,False,False,True,201,4,0,4.354500238657308,-36,1
user_006190,78,<30k,mobile,returning,Midwest,10,True,94,4,1,False,False,True,111,5,0,5.238148621922488,-17,-1
user_006191,35,100k-150k,desktop,new,East,67,True,119,1,0,True,False,True,113,2,0,7.197758901551837,6,-1
user_006192,30,100k-150k,mobile,returning,South,100,True,80,6,0,False,True,True,68,8,0,10.0,12,-2
user_006193,32,75k-100k,mobile,returning,West,91,True,126,5,0,True,True,True,79,1,0,10.0,47,4
user_006194,72,50k-75k,desktop,returning,Midwest,3,True,90,4,1,True,True,True,31,4,1,6.695485428702263,59,0
user_006195,39,75k-100k,desktop,returning,South,49,True,108,4,0,True,True,True,82,5,0,8.837199770088457,26,-1
user_006196,77,75k-100k,desktop,returning,South,31,True,113,2,0,False,True,True,91,2,0,10.0,22,0
user_006197,45,<30k,desktop,returning,South,35,True,82,3,0,True,True,True,66,2,0,8.876313876003435,16,1
user_006198,51,<30k,mobile,returning,West,45,False,0,0,0,True,False,True,109,1,0,8.476085626663256,-109,-1
user_006199,39,<30k,mobile,returning,South,58,True,92,1,0,True,False,True,79,1,0,5.985197372104676,13,0
user_006200,36,100k-150k,mobile,returning,East,32,True,76,4,1,False,True,True,104,2,0,6.5073580769259,-28,2
user_006201,31,100k-150k,mobile,returning,East,53,True,68,3,0,True,True,True,21,4,0,7.51813773303811,47,-1
user_006202,52,50k-75k,desktop,returning,East,61,True,115,2,0,False,True,True,68,1,0,7.893958100829765,47,1
user_006203,23,30k-50k,desktop,returning,West,97,True,58,4,0,True,True,True,27,2,0,7.620143376412985,31,2
user_006204,39,30k-50k,mobile,returning,West,45,True,76,3,0,True,True,True,78,2,0,8.000374330638131,-2,1
user_006205,32,75k-100k,mobile,new,West,70,True,115,1,0,True,True,True,70,1,0,8.395302452530304,45,0
user_006206,31,50k-75k,desktop,new,South,65,True,128,2,0,True,False,True,113,5,0,8.316248283180919,15,-3
user_006207,44,30k-50k,tablet,returning,East,30,True,95,4,0,False,False,True,109,3,0,5.152760999759475,-14,1
user_006208,47,50k-75k,mobile,returning,West,45,True,103,2,0,False,False,True,112,1,0,8.182058989588894,-9,1
user_006209,56,100k-150k,mobile,returning,East,43,True,57,4,0,False,True,True,93,2,0,8.451051712085373,-36,2
user_006210,22,50k-75k,desktop,returning,West,100,True,96,3,0,True,True,True,52,6,0,7.227532374420831,44,-3
user_006211,51,<30k,desktop,new,West,52,False,0,0,0,True,False,False,0,0,0,,0,0
user_006212,24,30k-50k,mobile,returning,East,95,False,0,0,0,True,True,True,64,1,0,9.079150054224494,-64,-1
user_006213,51,<30k,mobile,returning,West,59,False,0,0,0,True,True,False,0,0,0,,0,0
user_006214,34,<30k,mobile,new,Midwest,34,True,157,4,0,False,False,True,172,7,0,6.4655996174843375,-15,-3
user_006215,18,30k-50k,desktop,returning,East,73,True,65,2,0,True,True,True,53,3,0,7.870329129907534,12,-1
user_006216,23,30k-50k,mobile,returning,East,64,True,68,3,0,False,False,True,28,1,0,6.066107698530176,40,2
user_006217,34,50k-75k,mobile,returning,Midwest,64,True,34,2,0,True,True,True,20,1,0,8.396704435309395,14,1
user_006218,56,<30k,mobile,returning,West,30,True,158,5,0,False,False,True,162,4,0,7.664250512327834,-4,1
user_006219,40,<30k,desktop,returning,South,23,False,0,0,0,False,False,True,114,1,1,7.864464572181159,-114,-1
user_006220,41,100k-150k,mobile,new,Midwest,48,True,132,2,1,False,True,True,96,2,0,9.346914160883838,36,0
user_006221,62,30k-50k,desktop,returning,Midwest,14,False,0,0,0,True,False,True,137,1,0,6.187095897840343,-137,-1
user_006222,60,>150k,desktop,returning,West,55,True,73,3,0,True,True,True,66,2,0,10.0,7,1
user_006223,27,<30k,desktop,returning,East,62,True,53,1,1,True,True,False,0,0,0,,53,1
user_006224,51,30k-50k,mobile,returning,South,11,False,0,0,0,False,False,True,106,1,0,9.441763498118238,-106,-1
user_006225,54,30k-50k,desktop,returning,East,53,True,71,1,0,True,True,True,71,1,0,9.980701368059004,0,0
user_006226,34,50k-75k,desktop,returning,West,72,False,0,0,0,False,False,False,0,0,0,,0,0
user_006227,58,30k-50k,mobile,returning,South,34,True,66,3,0,False,True,True,74,3,0,9.41466047637984,-8,0
user_006228,38,30k-50k,mobile,new,South,19,True,126,2,0,False,False,True,126,1,1,8.882054040823343,0,1
user_006229,80,100k-150k,desktop,returning,South,28,True,156,5,0,False,False,True,176,6,0,4.086259110756778,-20,-1
user_006230,28,30k-50k,tablet,new,South,48,True,100,1,1,True,True,True,76,1,0,6.554278947245164,24,0
user_006231,33,<30k,desktop,new,West,57,False,0,0,0,True,True,True,108,2,0,8.490503942907011,-108,-2
user_006232,50,50k-75k,mobile,new,East,70,True,132,3,2,True,True,True,96,4,0,8.69207133640219,36,-1
user_006233,78,>150k,mobile,returning,East,87,True,70,2,0,True,True,True,45,3,0,6.226569971476165,25,-1
user_006234,68,30k-50k,mobile,returning,West,54,False,0,0,0,False,False,True,147,1,0,6.651317256842534,-147,-1
user_006235,44,50k-75k,mobile,new,West,37,False,0,0,0,True,True,True,92,1,1,9.436234694494349,-92,-1
user_006236,51,<30k,desktop,returning,East,46,True,46,3,0,False,True,True,36,2,0,8.300783482011806,10,1
user_006237,58,>150k,mobile,returning,East,53,True,148,4,0,True,True,False,0,0,0,,148,4
user_006238,62,100k-150k,desktop,new,East,55,True,116,2,0,False,False,True,93,3,1,6.6747418080869885,23,-1
user_006239,60,75k-100k,mobile,returning,West,48,True,126,5,0,True,False,True,158,3,0,7.584141962230948,-32,2
user_006240,70,50k-75k,desktop,returning,West,33,True,113,3,0,False,False,False,0,0,0,,113,3
user_006241,38,50k-75k,desktop,returning,West,58,True,73,2,0,False,True,True,36,5,0,8.616512217221986,37,-3
user_006242,35,<30k,desktop,returning,West,70,True,94,1,0,False,False,False,0,0,0,,94,1
user_006243,18,100k-150k,mobile,new,South,97,True,147,5,0,True,True,True,133,6,0,7.264041291047041,14,-1
user_006244,59,50k-75k,mobile,new,West,45,False,0,0,0,False,False,True,138,1,0,6.6857975983397,-138,-1
user_006245,54,75k-100k,mobile,returning,East,38,True,125,5,1,True,True,True,117,8,0,4.328033155745204,8,-3
user_006246,46,30k-50k,mobile,new,East,48,True,116,3,1,True,True,True,122,2,0,8.383438039471468,-6,1
user_006247,18,50k-75k,mobile,new,South,59,True,165,4,0,False,True,True,170,4,0,7.393791692648772,-5,0
user_006248,25,75k-100k,mobile,returning,Midwest,62,True,46,4,0,False,True,True,66,2,0,6.678831557517115,-20,2
user_006249,53,30k-50k,mobile,returning,East,42,True,69,3,0,False,True,False,0,0,0,,69,3
user_006250,38,50k-75k,mobile,returning,Midwest,46,True,116,4,0,False,False,True,110,1,0,8.40389074729043,6,3
user_006251,51,100k-150k,mobile,new,West,96,True,89,4,1,True,True,True,90,5,0,9.358311110925618,-1,-1
user_006252,18,75k-100k,desktop,new,East,71,True,104,5,0,False,True,True,44,2,0,8.364594441112628,60,3
user_006253,54,30k-50k,desktop,returning,East,69,True,113,1,0,True,False,True,81,1,0,8.640760808363138,32,0
user_006254,63,<30k,mobile,new,West,34,True,110,2,1,True,True,True,79,1,0,7.085626050901278,31,1
user_006255,42,30k-50k,mobile,returning,East,61,True,88,6,1,False,False,True,63,6,0,8.125044522840522,25,0
user_006256,31,30k-50k,desktop,returning,West,73,True,79,1,0,True,True,True,78,2,0,8.009639448669484,1,-1
user_006257,33,50k-75k,mobile,returning,South,93,True,95,3,1,True,True,True,74,3,0,9.951231909778386,21,0
user_006258,63,<30k,tablet,new,East,34,True,102,3,1,False,False,False,0,0,0,,102,3
user_006259,49,>150k,tablet,returning,East,47,True,68,2,0,False,True,True,38,2,0,7.000180554719694,30,0
user_006260,18,<30k,mobile,new,West,61,True,98,4,0,False,False,False,0,0,0,,98,4
user_006261,19,50k-75k,desktop,returning,South,58,True,100,2,0,False,False,False,0,0,0,,100,2
user_006262,46,<30k,desktop,returning,West,65,True,86,2,0,False,False,True,83,1,0,5.634941676364628,3,1
user_006263,65,<30k,desktop,returning,West,27,True,122,1,0,False,False,True,145,1,0,6.52122269693526,-23,0
user_006264,33,50k-75k,mobile,returning,West,60,True,104,5,0,True,False,True,125,4,0,5.249377361057679,-21,1
user_006265,36,100k-150k,desktop,returning,South,67,True,69,2,1,True,True,True,74,1,0,7.347673834076485,-5,1
user_006266,30,75k-100k,desktop,new,East,81,True,69,2,0,False,True,True,49,4,0,7.491866509767269,20,-2
user_006267,76,30k-50k,desktop,returning,West,28,True,152,2,0,True,False,True,158,1,0,7.785729190726102,-6,1
user_006268,46,75k-100k,tablet,returning,Midwest,33,True,95,2,0,True,False,True,94,1,0,6.272863588981507,1,1
user_006269,18,50k-75k,mobile,new,Midwest,70,False,0,0,0,False,True,True,97,1,0,9.614474359939177,-97,-1
user_006270,24,75k-100k,desktop,returning,West,77,True,39,2,0,True,True,True,20,2,0,8.027684115231722,19,0
user_006271,36,50k-75k,desktop,returning,East,62,True,30,1,0,False,True,True,35,3,0,7.175535961831307,-5,-2
user_006272,26,<30k,desktop,new,West,47,True,135,3,0,True,True,True,118,2,1,8.48786233148377,17,1
user_006273,46,<30k,desktop,returning,East,14,True,146,2,1,True,True,True,120,2,0,6.50082936916018,26,0
user_006274,48,75k-100k,desktop,returning,East,45,True,51,4,1,True,True,True,82,1,0,4.589241672451903,-31,3
user_006275,56,100k-150k,desktop,returning,Midwest,61,True,71,2,1,False,True,True,53,3,0,5.270543256872411,18,-1
user_006276,35,75k-100k,desktop,returning,South,41,True,170,4,0,True,True,True,121,4,0,6.677978250425112,49,0
user_006277,53,75k-100k,mobile,returning,West,62,True,139,4,0,True,True,True,123,6,0,8.315000823646612,16,-2
user_006278,43,75k-100k,mobile,returning,East,6,True,106,3,1,True,True,True,59,1,0,7.132016478266209,47,2
user_006279,67,>150k,mobile,returning,East,57,False,0,0,0,True,True,True,98,1,0,7.168732150761471,-98,-1
user_006280,51,30k-50k,desktop,returning,East,50,False,0,0,0,True,True,True,91,2,0,8.330314925581767,-91,-2
user_006281,45,100k-150k,mobile,returning,South,54,True,113,1,0,False,True,True,102,1,0,7.004118436882216,11,0
user_006282,55,>150k,desktop,returning,West,58,True,98,1,0,True,True,True,92,1,0,8.18856535480505,6,0
user_006283,31,100k-150k,mobile,returning,South,58,False,0,0,0,True,True,True,94,1,0,7.869262386960285,-94,-1
user_006284,80,30k-50k,desktop,returning,South,36,True,125,3,0,False,False,True,123,5,1,7.909723766884926,2,-2
user_006285,39,50k-75k,mobile,new,West,56,True,138,3,0,False,True,True,90,1,0,10.0,48,2
user_006286,37,75k-100k,mobile,new,Midwest,46,True,94,3,0,False,True,True,43,2,0,7.8286906337819895,51,1
user_006287,37,50k-75k,mobile,returning,Midwest,19,True,122,4,0,False,True,True,73,4,0,7.177244553018414,49,0
user_006288,80,75k-100k,desktop,returning,East,63,True,92,4,0,False,False,True,59,1,0,7.64883773408849,33,3
user_006289,22,100k-150k,desktop,new,West,82,True,114,2,0,False,True,True,77,2,0,8.049859493780831,37,0
user_006290,41,>150k,mobile,new,South,54,True,128,3,0,False,True,True,117,3,0,4.83106894026514,11,0
user_006291,49,50k-75k,desktop,new,East,29,True,161,5,0,True,False,True,143,9,0,6.041443869378402,18,-4
user_006292,30,50k-75k,desktop,returning,East,73,True,78,2,0,True,True,True,52,2,0,9.775412898038937,26,0
user_006293,18,30k-50k,desktop,new,Midwest,69,False,0,0,0,False,True,True,112,1,0,10.0,-112,-1
user_006294,25,100k-150k,mobile,returning,Midwest,71,True,52,3,0,False,False,True,20,3,0,6.885681125237412,32,0
user_006295,28,30k-50k,desktop,new,Midwest,51,False,0,0,0,False,False,True,104,1,0,7.859585672627606,-104,-1
user_006296,69,50k-75k,desktop,returning,South,42,True,61,5,1,False,False,True,59,6,0,6.051118335509969,2,-1
user_006297,18,50k-75k,desktop,returning,Midwest,69,False,0,0,0,True,True,True,103,1,1,8.769661344335296,-103,-1
user_006298,55,30k-50k,mobile,returning,East,47,True,37,1,0,False,False,True,51,1,0,8.664062736744334,-14,0
user_006299,53,50k-75k,mobile,returning,East,94,True,107,5,0,True,True,True,76,3,0,8.631629372419251,31,2
user_006300,60,30k-50k,mobile,new,West,40,True,99,1,0,False,False,True,127,2,0,9.377536520698698,-28,-1
user_006301,60,50k-75k,desktop,new,East,35,True,118,5,0,False,False,True,153,8,0,7.54167854565362,-35,-3
user_006302,65,<30k,desktop,new,East,35,True,174,3,1,False,False,False,0,0,0,,174,3
user_006303,30,<30k,mobile,returning,South,26,True,134,4,1,False,False,True,143,2,0,8.739166944450014,-9,2
user_006304,41,50k-75k,mobile,returning,East,78,False,0,0,0,True,True,True,93,1,0,6.539255715237375,-93,-1
user_006305,60,75k-100k,mobile,returning,West,54,True,131,2,0,True,True,True,105,1,0,8.463808286228161,26,1
user_006306,29,50k-75k,mobile,returning,East,65,True,85,2,0,True,True,True,70,2,0,7.820309227453512,15,0
user_006307,55,<30k,mobile,new,South,18,True,204,8,1,True,False,True,238,9,0,5.963297518102737,-34,-1
user_006308,70,50k-75k,desktop,returning,Midwest,47,True,45,1,0,True,False,False,0,0,0,,45,1
user_006309,68,30k-50k,mobile,new,Midwest,26,True,170,4,0,False,False,True,204,2,0,8.553350953823582,-34,2
user_006310,51,30k-50k,mobile,new,Midwest,53,True,160,5,0,False,True,True,115,1,0,10.0,45,4
user_006311,40,100k-150k,tablet,returning,East,42,True,95,3,0,True,True,True,72,3,0,6.19487325549902,23,0
user_006312,68,>150k,mobile,new,South,31,True,84,4,0,False,False,True,64,3,0,6.411061775294749,20,1
user_006313,30,75k-100k,desktop,returning,South,90,True,49,1,0,True,True,True,33,1,0,7.998210542148627,16,0
user_006314,54,75k-100k,desktop,returning,East,19,True,124,3,0,False,False,True,160,1,0,6.864036822756566,-36,2
user_006315,50,<30k,desktop,new,West,30,True,157,6,0,False,False,True,162,5,0,5.387867073098422,-5,1
user_006316,48,30k-50k,mobile,returning,South,61,True,91,2,0,True,True,True,64,1,0,9.608012451768785,27,1
user_006317,47,100k-150k,desktop,returning,West,85,True,78,3,0,True,True,True,62,3,0,9.144907982504892,16,0
user_006318,58,50k-75k,desktop,returning,South,42,True,110,3,0,True,False,True,130,2,0,7.0028703361134745,-20,1
user_006319,38,30k-50k,desktop,returning,South,47,False,0,0,0,True,True,True,74,1,0,7.944902970749712,-74,-1
user_006320,47,<30k,mobile,returning,East,45,True,113,4,0,True,True,True,99,1,0,8.511235666243369,14,3
user_006321,57,30k-50k,mobile,returning,East,63,True,82,2,0,True,True,True,57,2,0,9.379252902011613,25,0
user_006322,61,<30k,mobile,returning,East,46,True,49,2,0,False,False,True,65,2,1,7.826906466473181,-16,0
user_006323,33,>150k,desktop,returning,East,90,True,91,5,2,True,True,True,52,4,0,9.666827489612091,39,1
user_006324,31,>150k,desktop,returning,South,82,True,56,1,0,True,True,True,73,1,0,8.31248409024569,-17,0
user_006325,57,50k-75k,desktop,returning,West,44,True,114,3,1,False,True,True,93,1,0,10.0,21,2
user_006326,37,>150k,mobile,returning,West,86,True,49,4,0,True,True,True,36,4,0,6.766270513652132,13,0
user_006327,56,>150k,desktop,returning,East,33,True,142,2,0,False,False,True,195,1,0,7.885516722984066,-53,1
user_006328,54,100k-150k,desktop,returning,South,50,True,99,2,0,True,True,True,108,1,0,8.800867179362319,-9,1
user_006329,55,30k-50k,tablet,returning,East,31,True,82,2,0,True,True,True,44,1,0,8.83962141617846,38,1
user_006330,18,<30k,tablet,new,East,42,True,78,2,0,True,False,True,89,1,0,7.123804584351288,-11,1
user_006331,18,30k-50k,mobile,new,South,57,False,0,0,0,False,True,False,0,0,0,,0,0
user_006332,39,30k-50k,desktop,new,Midwest,38,False,0,0,0,True,True,True,108,2,0,9.280295245744709,-108,-2
user_006333,35,50k-75k,mobile,returning,South,51,False,0,0,0,False,True,True,125,1,0,9.637922348538673,-125,-1
user_006334,45,<30k,desktop,new,South,23,True,177,10,0,False,True,True,137,7,0,4.34239903836362,40,3
user_006335,51,75k-100k,mobile,new,West,71,True,122,3,2,True,True,True,85,1,0,9.640165730591464,37,2
user_006336,60,30k-50k,desktop,returning,South,25,True,105,2,0,False,False,True,116,4,0,7.787960102785051,-11,-2
user_006337,49,50k-75k,desktop,new,West,65,True,73,1,0,True,True,True,60,1,0,7.129196056373976,13,0
user_006338,21,30k-50k,desktop,returning,West,90,True,49,3,0,False,True,True,50,3,0,6.793195759703421,-1,0
user_006339,50,<30k,desktop,new,Midwest,13,True,140,4,0,False,False,True,117,4,0,6.122320555933528,23,0
user_006340,35,50k-75k,desktop,returning,South,25,False,0,0,0,False,True,True,114,1,1,9.102496801285955,-114,-1
user_006341,32,<30k,mobile,returning,West,48,False,0,0,0,False,False,False,0,0,0,,0,0
user_006342,48,<30k,desktop,returning,South,74,True,67,3,0,True,True,True,62,1,0,7.6020824100419375,5,2
user_006343,24,30k-50k,desktop,returning,South,43,True,130,1,0,True,True,True,137,1,0,8.934784771369214,-7,0
user_006344,49,100k-150k,desktop,returning,East,82,True,64,3,0,True,True,True,40,2,0,8.746203355835844,24,1
user_006345,80,50k-75k,desktop,returning,Midwest,16,True,166,1,0,False,False,True,186,1,0,4.960882881506809,-20,0
user_006346,38,<30k,desktop,returning,East,52,False,0,0,0,True,False,True,101,1,0,7.163791990275463,-101,-1
user_006347,54,100k-150k,mobile,returning,West,64,True,30,2,0,False,True,True,20,2,0,8.586567289461067,10,0
user_006348,80,<30k,tablet,new,South,30,True,152,3,0,False,True,True,150,3,0,7.085076506528503,2,0
user_006349,71,<30k,mobile,new,East,31,True,149,4,0,False,True,True,107,3,0,10.0,42,1
user_006350,43,100k-150k,desktop,new,East,66,True,111,3,0,False,True,True,95,6,0,7.966536325626888,16,-3
user_006351,38,75k-100k,mobile,new,Midwest,0,True,139,2,3,False,False,False,0,0,0,,139,2
user_006352,40,75k-100k,mobile,new,Midwest,45,False,0,0,0,False,True,True,89,1,0,6.807820172708307,-89,-1
user_006353,23,75k-100k,desktop,new,Midwest,66,True,159,4,0,False,False,True,171,1,0,6.6265216861957015,-12,3
user_006354,34,50k-75k,desktop,returning,Midwest,59,True,65,2,0,True,True,True,55,3,1,6.9687511693339195,10,-1
user_006355,60,100k-150k,desktop,new,West,74,True,78,1,0,False,True,True,82,1,0,6.910645244448545,-4,0
user_006356,48,30k-50k,desktop,new,East,19,False,0,0,0,False,True,True,155,1,0,8.338288535432929,-155,-1
user_006357,34,100k-150k,desktop,new,South,92,True,87,1,1,True,True,True,81,1,0,6.735293665043829,6,0
user_006358,40,30k-50k,desktop,returning,West,71,True,89,1,1,False,True,False,0,0,0,,89,1
user_006359,47,30k-50k,desktop,returning,East,33,True,124,4,0,False,False,True,129,4,0,7.355275573128326,-5,0
user_006360,61,75k-100k,desktop,returning,Midwest,8,True,167,4,0,False,True,True,97,7,0,6.974668229879915,70,-3
user_006361,69,100k-150k,desktop,returning,Midwest,61,True,83,1,0,False,False,True,94,1,0,7.793023998330112,-11,0
user_006362,31,<30k,desktop,new,East,66,True,149,3,0,False,False,False,0,0,0,,149,3
user_006363,47,<30k,mobile,new,East,45,False,0,0,0,True,True,True,98,1,0,5.914534261076331,-98,-1
user_006364,22,30k-50k,mobile,returning,Midwest,63,True,82,2,0,True,True,True,52,2,0,10.0,30,0
user_006365,40,<30k,mobile,returning,South,51,True,43,5,0,True,True,True,48,3,0,7.8308998878688785,-5,2
user_006366,41,75k-100k,tablet,returning,Midwest,54,True,103,1,0,True,False,False,0,0,0,,103,1
user_006367,38,<30k,tablet,returning,South,53,True,30,2,0,True,True,True,28,1,0,7.450846678206426,2,1
user_006368,29,50k-75k,desktop,new,West,81,True,85,4,0,False,True,True,80,3,0,8.181512339603778,5,1
user_006369,18,30k-50k,mobile,returning,South,88,True,30,3,0,False,True,True,32,1,0,6.484315400010017,-2,2
user_006370,26,>150k,mobile,new,East,75,True,77,3,0,False,True,True,64,3,2,6.908249005409939,13,0
user_006371,48,30k-50k,mobile,returning,East,83,True,108,1,0,True,True,True,91,2,0,7.287273096652639,17,-1
user_006372,51,30k-50k,desktop,returning,West,52,True,141,1,0,False,True,True,108,1,0,7.702154137274483,33,0
user_006373,58,75k-100k,desktop,new,East,39,True,110,5,1,True,False,True,123,3,0,6.17205235984935,-13,2
user_006374,30,50k-75k,mobile,new,West,86,False,0,0,0,True,True,True,89,1,0,7.353107541459656,-89,-1
user_006375,22,50k-75k,desktop,new,Midwest,95,False,0,0,0,False,True,True,117,4,0,6.858667580256381,-117,-4
user_006376,57,100k-150k,desktop,returning,South,55,True,101,3,0,False,True,True,85,1,0,9.822811482354465,16,2
user_006377,48,75k-100k,mobile,new,Midwest,41,False,0,0,0,False,False,True,108,1,0,6.371447018086564,-108,-1
user_006378,56,50k-75k,desktop,returning,East,55,True,88,4,0,False,False,True,86,3,0,5.216028428876735,2,1
user_006379,37,30k-50k,mobile,returning,South,31,True,98,5,0,False,False,True,119,1,0,6.60960815843051,-21,4
user_006380,53,30k-50k,desktop,new,West,48,True,123,3,0,False,False,True,160,2,0,7.082516492973832,-37,1
user_006381,44,100k-150k,mobile,new,Midwest,66,False,0,0,0,False,True,True,136,1,0,9.183687592909255,-136,-1
user_006382,35,30k-50k,desktop,new,West,66,True,95,3,1,True,False,True,97,4,0,9.715647629911619,-2,-1
user_006383,43,<30k,desktop,returning,Midwest,13,False,0,0,0,False,False,True,99,1,0,8.082830641680886,-99,-1
user_006384,42,75k-100k,desktop,new,East,32,True,110,1,0,False,True,True,90,1,0,7.369217254721696,20,0
user_006385,60,30k-50k,desktop,new,East,31,True,118,11,0,True,False,True,86,14,0,7.163933387912003,32,-3
user_006386,20,75k-100k,mobile,new,Midwest,57,True,89,4,0,False,True,True,57,4,0,8.317844739350884,32,0
user_006387,39,75k-100k,mobile,returning,West,49,True,30,4,0,False,True,True,20,5,0,8.746722932863976,10,-1
user_006388,47,50k-75k,mobile,returning,East,58,True,105,2,1,False,True,True,92,1,0,8.459211857312694,13,1
user_006389,45,100k-150k,mobile,new,East,73,True,69,2,0,True,True,True,55,2,0,9.480761811942273,14,0
user_006390,18,<30k,mobile,new,West,62,False,0,0,0,False,True,False,0,0,0,,0,0
user_006391,68,<30k,mobile,returning,Midwest,10,True,100,3,0,True,True,True,90,3,1,8.124462578770617,10,0
user_006392,54,30k-50k,mobile,returning,East,48,True,115,5,1,True,False,True,112,6,0,6.62515253021161,3,-1
user_006393,26,50k-75k,mobile,returning,West,97,True,87,4,0,True,True,True,69,5,0,8.645338744861117,18,-1
user_006394,39,50k-75k,desktop,returning,South,49,True,63,4,0,True,True,True,61,6,0,7.884460935820386,2,-2
user_006395,20,<30k,tablet,returning,West,77,False,0,0,0,True,True,True,128,1,0,7.359549764417502,-128,-1
user_006396,42,50k-75k,desktop,returning,West,58,True,86,1,0,True,True,True,59,1,0,9.07004845808507,27,0
user_006397,59,<30k,desktop,returning,Midwest,26,False,0,0,0,False,False,True,124,1,0,9.087208486595516,-124,-1
user_006398,51,<30k,mobile,new,South,0,False,0,0,0,True,True,True,93,1,1,8.477980943711577,-93,-1
user_006399,21,30k-50k,desktop,returning,East,86,True,56,2,0,False,True,True,65,1,0,6.8653238842976,-9,1
user_006400,44,75k-100k,desktop,new,East,58,True,128,3,0,False,True,True,90,2,0,7.8191387676087,38,1
user_006401,52,30k-50k,desktop,returning,East,56,True,49,3,1,False,True,True,20,1,0,7.589357053798669,29,2
user_006402,47,50k-75k,desktop,returning,East,54,False,0,0,0,True,True,True,134,1,0,10.0,-134,-1
user_006403,53,75k-100k,desktop,returning,East,40,True,130,5,0,False,True,True,119,8,0,8.749347841614503,11,-3
user_006404,47,100k-150k,mobile,returning,East,70,True,94,5,0,True,True,True,56,5,0,7.005153785972938,38,0
user_006405,46,50k-75k,desktop,returning,South,43,True,54,5,0,False,False,True,60,8,0,8.368288729278731,-6,-3
user_006406,65,100k-150k,mobile,new,East,40,False,0,0,0,False,False,False,0,0,0,,0,0
user_006407,34,<30k,mobile,returning,West,89,True,49,6,0,True,True,False,0,0,0,,49,6
user_006408,47,75k-100k,mobile,new,East,66,True,149,1,0,False,True,True,136,1,0,8.080011325921669,13,0
user_006409,44,<30k,desktop,new,South,12,True,264,3,0,False,True,True,237,5,0,5.4069161841099165,27,-2
user_006410,52,<30k,desktop,returning,East,57,True,68,1,0,False,True,True,20,2,0,10.0,48,-1
user_006411,59,50k-75k,desktop,new,South,10,False,0,0,0,False,False,True,109,1,0,7.195843057724973,-109,-1
user_006412,53,75k-100k,desktop,returning,East,72,True,59,2,1,True,True,True,29,2,0,6.181767218109105,30,0
user_006413,18,<30k,mobile,returning,East,15,False,0,0,0,True,True,True,106,1,0,6.940408666743761,-106,-1
user_006414,19,75k-100k,desktop,new,East,60,False,0,0,0,False,False,False,0,0,0,,0,0
user_006415,58,100k-150k,mobile,new,Midwest,30,True,165,3,0,True,False,True,159,3,0,8.524363004473408,6,0
user_006416,35,100k-150k,mobile,new,West,62,True,155,1,0,False,False,True,167,1,0,6.805346763082924,-12,0
user_006417,48,100k-150k,desktop,new,South,50,False,0,0,0,False,False,False,0,0,0,,0,0
user_006418,23,30k-50k,mobile,returning,East,98,False,0,0,0,True,True,True,109,1,0,7.416630010247146,-109,-1
user_006419,59,<30k,desktop,returning,West,3,True,146,5,0,False,False,True,131,5,0,7.249500928816353,15,0
user_006420,61,75k-100k,desktop,returning,South,0,True,147,3,0,True,False,True,160,9,0,7.475363919500113,-13,-6
user_006421,60,75k-100k,desktop,returning,Midwest,56,True,97,3,0,False,True,True,76,2,0,6.203560685760808,21,1
user_006422,57,30k-50k,desktop,returning,South,45,True,83,3,0,False,False,True,66,3,0,8.021648185287965,17,0
user_006423,59,30k-50k,desktop,new,South,18,True,244,2,0,False,False,True,245,1,0,7.974600784965167,-1,1
user_006424,20,100k-150k,desktop,returning,Midwest,93,True,42,1,0,True,True,True,24,1,0,8.193974564206494,18,0
user_006425,52,30k-50k,mobile,new,South,33,True,135,9,0,False,True,True,130,10,0,7.492655978974781,5,-1
user_006426,63,30k-50k,tablet,returning,East,29,False,0,0,0,False,False,True,128,1,0,9.090479142007997,-128,-1
user_006427,49,30k-50k,desktop,returning,West,56,True,66,1,0,True,True,True,84,1,0,8.526843909998547,-18,0
user_006428,56,<30k,desktop,returning,Midwest,14,True,174,2,0,False,False,False,0,0,0,,174,2
user_006429,33,75k-100k,desktop,returning,Midwest,51,True,70,3,0,True,True,True,33,2,0,8.577041206199217,37,1
user_006430,42,>150k,mobile,returning,Midwest,54,True,85,4,0,False,True,True,74,3,1,6.669932170145784,11,1
user_006431,48,50k-75k,desktop,new,East,95,False,0,0,0,False,True,False,0,0,0,,0,0
user_006432,80,<30k,mobile,returning,West,27,True,106,5,0,False,False,True,112,3,0,5.162043219246668,-6,2
user_006433,37,75k-100k,desktop,returning,West,37,True,100,3,0,True,False,True,102,4,1,6.739286934671282,-2,-1
user_006434,31,100k-150k,mobile,returning,Midwest,73,True,134,3,0,False,True,True,97,2,0,8.260831069307146,37,1
user_006435,57,50k-75k,desktop,returning,West,44,True,77,4,1,False,False,True,32,5,0,4.8301403653675274,45,-1
user_006436,42,75k-100k,tablet,returning,East,74,True,63,3,0,False,True,True,35,1,0,7.189437528635157,28,2
user_006437,45,30k-50k,mobile,returning,West,40,True,64,2,0,False,False,True,105,3,0,6.214045321030434,-41,-1
user_006438,53,>150k,desktop,returning,West,58,True,80,1,0,True,True,True,60,1,0,6.905588272844546,20,0
user_006439,42,100k-150k,mobile,returning,Midwest,52,True,138,6,0,True,True,True,156,6,0,8.040580706596439,-18,0
user_006440,27,75k-100k,desktop,new,West,93,True,114,2,0,True,True,True,68,1,0,8.109282008849977,46,1
user_006441,42,100k-150k,mobile,new,East,79,True,102,3,0,True,True,True,68,2,0,6.355378607433223,34,1
user_006442,50,100k-150k,desktop,returning,South,67,True,53,1,0,True,True,True,79,1,1,9.500886984234292,-26,0
user_006443,57,100k-150k,mobile,returning,West,70,True,169,1,1,False,True,True,131,1,0,6.477341327904464,38,0
user_006444,57,75k-100k,desktop,returning,East,64,True,30,1,0,True,False,True,20,1,0,9.112247054657239,10,0
user_006445,34,30k-50k,mobile,new,Midwest,67,False,0,0,0,True,True,False,0,0,0,,0,0
user_006446,49,75k-100k,mobile,returning,West,84,True,124,4,1,True,True,False,0,0,0,,124,4
user_006447,26,<30k,mobile,returning,South,67,True,142,1,0,True,True,True,98,1,0,10.0,44,0
user_006448,29,<30k,desktop,new,West,80,True,97,2,0,False,True,True,109,2,0,8.642992773303387,-12,0
user_006449,54,50k-75k,mobile,returning,East,46,True,55,5,0,False,False,True,42,6,0,6.560680899038996,13,-1
user_006450,46,30k-50k,mobile,new,South,42,True,146,3,0,False,True,True,129,1,0,6.679325356574886,17,2
user_006451,57,50k-75k,mobile,new,South,46,True,142,4,1,False,True,True,137,2,0,5.851116479519671,5,2
user_006452,32,50k-75k,mobile,returning,Midwest,85,True,83,4,0,True,True,True,53,5,0,9.016041779537167,30,-1
user_006453,24,>150k,mobile,new,South,97,True,97,1,0,False,True,True,76,1,0,6.21266305281597,21,0
user_006454,38,75k-100k,desktop,new,Midwest,40,True,111,2,0,False,False,True,107,2,0,6.544360003285188,4,0
user_006455,18,30k-50k,desktop,new,South,72,False,0,0,0,True,True,True,104,1,0,8.20632524566631,-104,-1
user_006456,30,75k-100k,desktop,returning,West,86,True,82,2,0,True,True,True,84,4,0,8.157454471763016,-2,-2
user_006457,67,>150k,desktop,returning,South,42,False,0,0,0,False,False,True,147,1,0,6.208084426682897,-147,-1
user_006458,24,75k-100k,mobile,returning,South,58,True,55,3,0,False,True,True,59,3,0,6.3943592822775495,-4,0
user_006459,27,30k-50k,mobile,new,Midwest,81,True,69,3,0,True,True,True,24,2,0,7.919694377569783,45,1
user_006460,39,50k-75k,mobile,returning,South,47,True,101,4,0,False,False,True,106,8,0,6.166634074062781,-5,-4
user_006461,43,50k-75k,desktop,returning,South,41,True,94,4,0,False,True,True,91,2,0,9.065338506270901,3,2
user_006462,47,30k-50k,desktop,returning,West,32,True,65,2,0,False,False,True,76,2,1,7.622291429745015,-11,0
user_006463,54,>150k,mobile,new,East,37,True,118,3,1,False,True,True,100,2,0,5.909040007006658,18,1
user_006464,32,50k-75k,desktop,returning,West,75,False,0,0,0,True,True,True,68,1,0,6.249374385763622,-68,-1
user_006465,26,100k-150k,desktop,new,East,89,True,121,1,0,True,False,True,98,1,1,6.381723187328861,23,0
user_006466,73,75k-100k,desktop,returning,Midwest,47,True,92,2,1,True,False,True,73,3,0,8.219302136156816,19,-1
user_006467,54,30k-50k,desktop,returning,South,63,True,176,4,0,True,True,True,166,1,0,7.162566115660976,10,3
user_006468,28,30k-50k,desktop,returning,South,60,True,43,1,0,False,True,True,50,2,0,7.342978356008477,-7,-1
user_006469,48,100k-150k,desktop,returning,West,89,True,30,3,1,False,False,True,58,4,0,6.718567304127804,-28,-1
user_006470,78,50k-75k,desktop,returning,West,49,True,109,1,0,False,False,True,113,2,0,7.502554645087598,-4,-1
user_006471,65,100k-150k,mobile,returning,South,50,True,120,5,0,False,False,True,113,2,0,7.073045247341361,7,3
user_006472,58,50k-75k,desktop,returning,Midwest,41,True,127,3,0,True,False,True,102,4,0,8.821325890685424,25,-1
user_006473,41,50k-75k,desktop,returning,West,90,True,75,2,0,False,True,True,78,1,0,7.543005052037202,-3,1
user_006474,24,75k-100k,desktop,returning,East,46,True,115,1,1,False,True,True,84,2,0,8.931004963155289,31,-1
user_006475,30,75k-100k,mobile,new,South,64,True,122,1,0,False,True,True,103,1,0,7.815059841978438,19,0
user_006476,38,75k-100k,desktop,returning,Midwest,28,False,0,0,0,False,False,True,132,1,0,8.180268395503141,-132,-1
user_006477,45,30k-50k,mobile,returning,East,88,False,0,0,0,False,True,True,103,1,0,8.233964861517473,-103,-1
user_006478,58,30k-50k,mobile,new,West,53,True,104,1,0,False,True,False,0,0,0,,104,1
user_006479,37,75k-100k,desktop,new,Midwest,46,True,138,2,0,True,False,True,121,3,0,5.939260295914012,17,-1
user_006480,46,100k-150k,mobile,returning,East,75,True,132,6,1,True,True,True,59,5,0,8.870742473789587,73,1
user_006481,33,75k-100k,mobile,returning,South,63,True,73,1,0,False,True,False,0,0,0,,73,1
user_006482,26,30k-50k,mobile,new,East,52,True,123,2,1,False,False,True,127,1,1,6.37588470240859,-4,1
user_006483,21,<30k,desktop,returning,Midwest,78,False,0,0,0,True,True,True,107,1,0,7.8219678044400744,-107,-1
user_006484,28,100k-150k,desktop,new,West,100,True,151,3,0,True,True,False,0,0,0,,151,3
user_006485,32,100k-150k,desktop,returning,East,91,False,0,0,0,True,True,True,111,1,0,8.649193093575684,-111,-1
user_006486,74,100k-150k,mobile,returning,West,44,True,106,2,0,False,True,True,62,1,0,6.81231460173424,44,1
user_006487,67,<30k,mobile,new,East,25,False,0,0,0,False,False,True,146,1,0,7.675877549758729,-146,-1
user_006488,47,<30k,mobile,returning,South,51,True,83,3,0,True,True,True,90,3,0,8.905078514351443,-7,0
user_006489,29,100k-150k,desktop,new,West,83,True,81,2,0,False,True,False,0,0,0,,81,2
user_006490,40,75k-100k,desktop,returning,West,80,True,83,2,0,True,True,True,51,3,0,7.726878647579818,32,-1
user_006491,56,50k-75k,tablet,new,East,40,True,136,2,2,False,False,False,0,0,0,,136,2
user_006492,59,<30k,desktop,returning,East,7,True,151,6,0,False,False,False,0,0,0,,151,6
user_006493,40,30k-50k,mobile,returning,Midwest,35,False,0,0,0,True,True,True,141,1,0,9.073142316781693,-141,-1
user_006494,49,75k-100k,desktop,returning,South,44,True,30,3,0,False,True,True,36,1,0,10.0,-6,2
user_006495,36,100k-150k,mobile,new,East,50,True,166,4,0,True,True,True,162,3,0,6.955414975841728,4,1
user_006496,44,50k-75k,mobile,new,West,50,True,115,1,1,False,False,True,127,1,0,4.757000359464224,-12,0
user_006497,48,30k-50k,desktop,new,South,33,True,131,7,0,True,True,True,123,5,0,7.521247985060407,8,2
user_006498,69,30k-50k,desktop,new,South,26,True,175,6,1,False,False,True,172,7,0,7.470549002175365,3,-1
user_006499,71,>150k,mobile,returning,Midwest,54,True,77,2,0,False,False,True,67,1,0,6.38878140169899,10,1
user_006500,24,<30k,mobile,returning,East,47,False,0,0,0,True,False,True,122,2,0,8.828431692898414,-122,-2
user_006501,38,<30k,mobile,new,East,67,False,0,0,0,False,False,True,128,1,0,8.86585101508342,-128,-1
user_006502,40,100k-150k,desktop,returning,West,81,True,30,4,0,True,True,True,51,1,0,7.881596487017471,-21,3
user_006503,48,50k-75k,mobile,returning,Midwest,40,True,102,4,0,False,False,True,122,1,0,7.376872169373305,-20,3
user_006504,48,50k-75k,mobile,returning,East,34,True,117,2,0,True,True,True,89,1,0,8.127980151147748,28,1
user_006505,33,50k-75k,desktop,returning,West,74,True,68,4,0,True,False,True,80,3,0,6.957609469802056,-12,1
user_006506,31,50k-75k,desktop,returning,South,79,True,82,1,0,True,True,True,71,1,0,7.935772748565243,11,0
user_006507,31,100k-150k,desktop,returning,East,69,True,96,1,0,True,True,True,64,2,0,8.198963970271073,32,-1
user_006508,46,>150k,desktop,new,East,78,False,0,0,0,False,True,True,54,1,0,7.0399116220249045,-54,-1
user_006509,31,75k-100k,desktop,new,South,65,True,103,1,0,False,True,True,49,1,0,7.965216901417457,54,0
user_006510,49,50k-75k,desktop,returning,Midwest,51,True,65,3,0,True,False,True,52,5,0,7.469826725517836,13,-2
user_006511,50,75k-100k,desktop,new,East,47,True,119,2,0,False,False,True,132,2,0,9.042949892775676,-13,0
user_006512,44,100k-150k,mobile,returning,Midwest,66,True,114,3,0,False,False,True,136,2,0,8.872638171841121,-22,1
user_006513,39,75k-100k,desktop,new,West,49,True,141,3,0,False,True,True,127,1,0,7.392054724817305,14,2
user_006514,50,30k-50k,desktop,returning,South,42,True,59,1,0,False,False,True,50,1,0,6.4022766454513045,9,0
user_006515,52,75k-100k,desktop,returning,Midwest,34,True,67,4,0,True,True,True,79,6,0,7.288908082048475,-12,-2
user_006516,47,75k-100k,tablet,returning,Midwest,46,True,54,3,1,False,True,True,34,2,0,6.016378175170332,20,1
user_006517,37,>150k,desktop,returning,West,85,False,0,0,0,True,True,True,92,1,0,10.0,-92,-1
user_006518,51,50k-75k,mobile,new,East,58,False,0,0,0,False,True,False,0,0,0,,0,0
user_006519,68,50k-75k,desktop,returning,East,71,True,41,2,0,True,True,False,0,0,0,,41,2
user_006520,43,100k-150k,mobile,returning,East,63,True,62,3,0,True,False,True,59,4,1,8.507611236586866,3,-1
user_006521,63,50k-75k,desktop,returning,East,38,True,123,4,0,False,False,True,122,1,0,7.252540182090265,1,3
user_006522,53,100k-150k,desktop,returning,Midwest,30,True,71,6,0,True,False,True,64,5,0,7.441297895562276,7,1
user_006523,44,100k-150k,desktop,new,East,57,True,142,3,0,False,True,True,96,2,0,8.056954095427978,46,1
user_006524,60,>150k,tablet,new,West,63,True,167,1,0,True,True,True,158,1,0,9.805232962671841,9,0
user_006525,31,30k-50k,desktop,new,Midwest,84,True,100,1,1,True,False,True,131,1,0,6.381186478429992,-31,0
user_006526,66,50k-75k,desktop,returning,West,61,False,0,0,0,True,True,True,119,1,0,8.060743466541803,-119,-1
user_006527,68,50k-75k,desktop,returning,Midwest,40,False,0,0,0,False,True,True,105,1,0,6.095823139436455,-105,-1
user_006528,25,<30k,desktop,new,Midwest,62,True,93,5,0,False,False,True,97,5,0,4.985620459820767,-4,0
user_006529,54,<30k,mobile,new,South,30,False,0,0,0,False,False,False,0,0,0,,0,0
user_006530,29,30k-50k,tablet,new,Midwest,61,True,122,2,1,False,False,True,129,1,0,6.592126259793592,-7,1
user_006531,41,30k-50k,desktop,new,Midwest,23,True,155,7,0,False,False,True,138,8,1,5.381661520410472,17,-1
user_006532,37,50k-75k,mobile,new,East,56,True,79,1,0,True,True,True,79,1,0,4.846188747783213,0,0
user_006533,36,30k-50k,mobile,new,East,40,True,106,3,0,True,True,True,54,2,0,10.0,52,1
user_006534,28,30k-50k,mobile,new,East,81,True,97,2,1,True,True,True,54,1,0,9.519452619418946,43,1
user_006535,45,30k-50k,mobile,returning,South,34,True,78,3,0,False,False,True,21,2,0,6.29519665394909,57,1
user_006536,42,75k-100k,desktop,returning,South,37,True,76,2,0,False,True,True,87,1,0,9.960551132237692,-11,1
user_006537,59,75k-100k,tablet,returning,West,33,True,62,4,0,True,False,True,45,6,0,7.813568628811708,17,-2
user_006538,78,50k-75k,desktop,returning,West,36,False,0,0,0,True,True,True,114,1,0,7.516762273592611,-114,-1
user_006539,41,75k-100k,mobile,new,West,69,True,140,1,0,False,True,True,87,1,0,9.269019998650183,53,0
user_006540,80,<30k,desktop,new,West,0,True,125,1,0,True,False,True,147,1,0,6.894402865734517,-22,0
user_006541,24,50k-75k,desktop,returning,East,85,True,64,1,0,True,True,True,33,1,0,9.507623642159421,31,0
user_006542,45,50k-75k,mobile,new,West,47,True,89,5,0,False,False,True,82,6,0,7.698344774832733,7,-1
user_006543,47,50k-75k,mobile,returning,Midwest,59,False,0,0,0,False,True,True,108,1,0,6.684383363325396,-108,-1
user_006544,33,30k-50k,tablet,returning,East,59,True,65,2,0,False,False,True,51,2,0,7.697914854692407,14,0
user_006545,53,100k-150k,mobile,returning,Midwest,46,True,74,3,1,True,True,True,76,1,0,5.8819195450263635,-2,2
user_006546,80,75k-100k,mobile,returning,South,36,False,0,0,0,True,True,True,101,1,0,6.102251819276655,-101,-1
user_006547,63,50k-75k,mobile,returning,East,20,True,76,3,0,False,True,True,43,3,0,8.758583274851347,33,0
user_006548,37,75k-100k,mobile,returning,West,96,True,66,1,0,True,True,True,55,1,0,7.090720185393469,11,0
user_006549,54,30k-50k,desktop,returning,South,43,True,114,1,0,True,True,True,128,1,0,6.555469227277847,-14,0
user_006550,64,30k-50k,desktop,returning,West,0,True,158,3,1,True,False,True,154,4,0,7.261897077428099,4,-1
user_006551,27,30k-50k,mobile,returning,West,38,True,30,3,0,False,False,True,60,3,0,7.326734199218679,-30,0
user_006552,67,75k-100k,desktop,returning,East,6,True,154,5,0,False,False,True,163,5,0,8.212494794272757,-9,0
user_006553,48,30k-50k,mobile,returning,East,61,True,118,2,0,True,True,True,92,1,0,8.328300815271405,26,1
user_006554,49,30k-50k,desktop,returning,Midwest,52,True,96,2,0,False,False,True,128,1,0,7.777303995851431,-32,1
user_006555,65,<30k,mobile,returning,West,41,False,0,0,0,False,True,True,108,1,0,10.0,-108,-1
user_006556,59,50k-75k,mobile,returning,West,61,True,97,3,0,True,True,True,75,3,0,10.0,22,0
user_006557,51,50k-75k,mobile,returning,East,71,True,37,3,0,True,True,True,20,4,0,7.42414395214436,17,-1
user_006558,25,50k-75k,tablet,returning,East,83,True,89,1,0,False,True,True,47,1,0,8.009248667114719,42,0
user_006559,50,30k-50k,mobile,new,Midwest,37,False,0,0,0,False,True,True,76,1,0,5.797430119800249,-76,-1
user_006560,34,50k-75k,mobile,new,East,42,True,91,2,0,False,False,True,79,3,0,8.151890148183798,12,-1
user_006561,37,75k-100k,desktop,returning,Midwest,53,True,30,3,0,True,True,True,20,1,0,9.822311963329536,10,2
user_006562,39,>150k,desktop,returning,Midwest,38,True,84,4,0,True,False,True,79,5,0,7.314458300250782,5,-1
user_006563,49,<30k,mobile,returning,West,62,False,0,0,0,True,True,True,58,1,0,6.478087858392193,-58,-1
user_006564,30,50k-75k,mobile,new,South,83,True,109,3,0,False,True,True,106,3,0,9.61373118926295,3,0
user_006565,44,<30k,mobile,new,South,62,False,0,0,0,False,False,False,0,0,0,,0,0
user_006566,42,100k-150k,mobile,returning,Midwest,50,True,52,4,2,False,True,True,55,4,1,8.838377657849401,-3,0
user_006567,32,50k-75k,mobile,returning,Midwest,60,True,135,1,0,False,True,True,107,1,0,8.080005723309524,28,0
user_006568,38,<30k,desktop,new,South,50,False,0,0,0,True,True,True,103,1,0,10.0,-103,-1
user_006569,36,100k-150k,desktop,new,Midwest,63,True,107,1,0,True,True,True,126,1,0,8.380186274251194,-19,0
user_006570,27,30k-50k,mobile,new,East,77,False,0,0,0,False,True,True,110,1,0,6.8447791611246975,-110,-1
user_006571,31,<30k,mobile,returning,East,23,True,79,5,0,True,True,True,87,1,0,7.487537909535302,-8,4
user_006572,45,75k-100k,desktop,new,West,39,True,131,5,0,False,True,True,129,5,0,7.650155446379687,2,0
user_006573,32,<30k,mobile,returning,East,83,True,54,2,0,True,True,True,62,1,0,8.228342317748362,-8,1
user_006574,54,>150k,tablet,returning,South,48,True,101,2,1,True,True,True,74,5,0,6.674341508681115,27,-3
user_006575,56,30k-50k,desktop,returning,East,52,False,0,0,0,False,False,True,134,1,1,6.427823638004904,-134,-1
user_006576,21,30k-50k,desktop,new,South,48,True,71,5,0,False,False,True,66,4,0,8.530969680085734,5,1
user_006577,28,50k-75k,mobile,returning,Midwest,54,True,130,2,0,False,True,True,107,1,0,6.77240566654405,23,1
user_006578,68,75k-100k,mobile,returning,Midwest,61,True,97,3,0,True,True,False,0,0,0,,97,3
user_006579,39,30k-50k,mobile,returning,West,73,False,0,0,0,True,True,True,83,1,0,9.492389095057998,-83,-1
user_006580,77,50k-75k,mobile,returning,Midwest,10,True,128,6,2,False,False,True,141,7,1,5.976536071280829,-13,-1
user_006581,37,50k-75k,desktop,returning,East,46,True,124,2,0,True,True,True,106,2,0,9.5238305494266,18,0
user_006582,52,<30k,mobile,new,South,36,False,0,0,0,False,False,True,137,2,0,8.838564743014011,-137,-2
user_006583,80,30k-50k,mobile,returning,Midwest,44,True,98,1,0,True,True,True,57,1,0,8.880533804683166,41,0
user_006584,43,50k-75k,desktop,returning,South,54,True,129,2,0,True,True,True,82,2,0,7.326644754021929,47,0
user_006585,37,<30k,mobile,new,West,47,True,154,5,0,True,False,True,137,4,0,7.347883272684696,17,1
user_006586,52,75k-100k,mobile,returning,West,68,True,47,3,0,False,False,True,35,3,0,8.372974108122628,12,0
user_006587,18,50k-75k,desktop,new,South,72,False,0,0,0,False,True,True,82,1,0,7.17634714001809,-82,-1
user_006588,44,<30k,mobile,returning,Midwest,10,True,172,7,0,False,False,True,175,12,0,6.7764955157752045,-3,-5
user_006589,52,<30k,mobile,returning,East,37,True,52,2,0,False,False,True,27,2,1,8.015861274375876,25,0
user_006590,40,50k-75k,mobile,new,Midwest,45,True,117,2,0,False,True,True,118,1,0,6.5288322536338255,-1,1
user_006591,32,75k-100k,desktop,returning,South,55,True,50,1,0,True,True,True,20,2,0,6.642165654218923,30,-1
user_006592,34,75k-100k,mobile,new,West,74,True,121,5,0,False,True,True,115,3,0,7.941230368600862,6,2
user_006593,47,75k-100k,desktop,new,South,69,True,131,5,0,True,True,True,107,3,0,9.97120526434437,24,2
user_006594,31,30k-50k,desktop,returning,West,65,True,69,6,0,True,True,True,55,1,0,8.358878202251118,14,5
user_006595,45,75k-100k,desktop,new,West,61,True,64,3,0,False,True,True,46,4,0,9.28170272897933,18,-1
user_006596,23,100k-150k,desktop,returning,West,100,True,81,3,0,True,True,True,63,3,0,10.0,18,0
user_006597,51,50k-75k,mobile,returning,West,41,True,55,1,1,False,True,False,0,0,0,,55,1
user_006598,55,100k-150k,desktop,returning,West,71,True,63,4,0,True,True,True,54,1,0,8.536181617344834,9,3
user_006599,62,50k-75k,desktop,new,West,49,True,62,1,1,False,False,True,33,1,0,5.101178222888632,29,0
user_006600,45,>150k,desktop,returning,Midwest,69,True,110,4,0,True,True,True,96,2,1,7.406011136921944,14,2
user_006601,25,>150k,desktop,new,West,82,True,124,1,0,False,True,True,110,1,0,9.721207722226296,14,0
user_006602,44,50k-75k,desktop,returning,West,65,True,103,3,0,False,False,True,106,4,0,8.887520923291744,-3,-1
user_006603,62,100k-150k,mobile,returning,West,78,True,73,2,0,False,True,True,31,2,0,9.40660156860516,42,0
user_006604,27,100k-150k,mobile,new,South,69,True,99,1,1,False,True,True,95,1,0,6.516693940938565,4,0
user_006605,39,50k-75k,mobile,new,East,24,True,144,3,0,False,False,True,188,3,0,6.950915735813025,-44,0
user_006606,59,50k-75k,desktop,returning,West,37,True,114,3,0,False,False,True,153,4,0,4.3371227775312,-39,-1
user_006607,38,75k-100k,mobile,returning,East,43,True,94,4,0,False,True,True,73,2,0,7.590103115673644,21,2
user_006608,40,75k-100k,desktop,returning,East,30,True,152,5,0,False,False,True,160,2,0,8.720310673039249,-8,3
user_006609,29,100k-150k,desktop,returning,South,75,True,44,5,0,False,True,True,36,3,0,8.762428231121083,8,2
user_006610,68,50k-75k,desktop,new,South,36,True,115,4,1,False,False,True,138,2,0,7.644018666818736,-23,2
user_006611,50,<30k,mobile,returning,South,46,False,0,0,0,True,False,False,0,0,0,,0,0
user_006612,50,30k-50k,mobile,returning,West,89,False,0,0,0,False,True,True,98,1,0,6.451673159488849,-98,-1
user_006613,41,50k-75k,mobile,returning,South,60,True,76,4,0,False,True,True,52,2,0,7.21150632266277,24,2
user_006614,46,<30k,tablet,new,East,14,True,132,2,0,False,False,True,177,1,0,7.859666741597984,-45,1
user_006615,48,30k-50k,desktop,returning,East,41,True,83,3,1,False,True,True,69,1,0,7.572855027775345,14,2
user_006616,60,50k-75k,tablet,new,West,56,True,128,1,0,False,True,True,85,1,0,7.194012550969527,43,0
user_006617,53,50k-75k,mobile,new,East,43,True,109,3,0,False,True,False,0,0,0,,109,3
user_006618,50,<30k,mobile,returning,West,60,False,0,0,0,False,True,True,87,1,0,8.316376519459249,-87,-1
user_006619,23,<30k,desktop,returning,Midwest,47,True,77,1,0,True,True,True,87,1,0,9.8790851250451,-10,0
user_006620,22,30k-50k,desktop,returning,West,68,False,0,0,0,True,True,True,108,1,0,8.533963792712052,-108,-1
user_006621,48,30k-50k,mobile,returning,South,43,False,0,0,0,True,True,True,89,1,0,9.372443629712377,-89,-1
user_006622,28,30k-50k,desktop,new,South,56,True,88,3,0,False,False,True,79,4,0,6.6727109922359,9,-1
user_006623,20,100k-150k,mobile,returning,West,100,True,52,3,0,False,True,True,43,4,0,8.280576581598847,9,-1
user_006624,66,<30k,desktop,returning,East,45,False,0,0,0,True,False,True,121,1,0,7.910849527997731,-121,-1
user_006625,19,>150k,desktop,new,East,82,True,90,2,1,False,True,True,76,1,0,7.065085975519096,14,1
user_006626,20,50k-75k,desktop,returning,Midwest,92,False,0,0,0,True,True,True,76,2,0,8.393963791597491,-76,-2
user_006627,58,75k-100k,desktop,returning,West,59,True,130,4,0,False,False,True,115,5,0,8.258587206220593,15,-1
user_006628,38,<30k,mobile,returning,Midwest,41,True,102,4,0,False,False,True,134,2,0,6.968019428018821,-32,2
user_006629,51,<30k,mobile,returning,East,50,True,77,4,0,False,False,True,74,3,1,9.130807794108572,3,1
user_006630,19,>150k,mobile,new,West,99,True,118,1,0,False,True,True,92,1,0,7.548137155268448,26,0
user_006631,61,75k-100k,mobile,new,East,28,True,152,6,1,False,False,True,198,5,0,5.695009424606814,-46,1
user_006632,31,100k-150k,mobile,returning,Midwest,80,True,73,3,0,True,True,True,44,1,0,7.657188798713165,29,2
user_006633,77,75k-100k,mobile,new,West,51,True,140,5,0,True,False,True,149,12,0,8.49245246990847,-9,-7
user_006634,51,100k-150k,desktop,returning,South,32,True,123,2,0,False,False,True,136,3,1,5.654636909083646,-13,-1
user_006635,47,50k-75k,desktop,returning,Midwest,40,True,85,2,0,True,True,True,65,1,0,8.950010042733258,20,1
user_006636,45,<30k,mobile,returning,Midwest,26,True,105,7,0,False,True,True,73,3,0,7.664202897037842,32,4
user_006637,35,50k-75k,mobile,returning,West,75,True,39,1,0,False,True,True,20,1,0,8.244389624845265,19,0
user_006638,23,50k-75k,desktop,returning,South,90,False,0,0,0,True,True,False,0,0,0,,0,0
user_006639,35,100k-150k,mobile,returning,East,77,True,88,2,0,True,True,True,71,1,0,8.077342985632221,17,1
user_006640,46,100k-150k,desktop,returning,East,86,True,129,1,1,False,True,True,112,1,0,6.984601597949456,17,0
user_006641,40,50k-75k,mobile,returning,West,56,True,75,3,1,True,True,True,50,2,0,5.7182179490762,25,1
user_006642,44,<30k,desktop,new,West,19,True,142,7,0,True,False,False,0,0,0,,142,7
user_006643,39,50k-75k,mobile,returning,East,58,True,104,1,0,False,False,True,120,1,0,6.184858426043505,-16,0
user_006644,40,75k-100k,mobile,new,Midwest,67,True,30,3,0,False,True,True,20,5,0,10.0,10,-2
user_006645,66,50k-75k,mobile,returning,South,21,True,142,5,0,True,False,True,139,5,0,7.72894074409692,3,0
user_006646,51,30k-50k,desktop,returning,East,57,False,0,0,0,False,True,True,103,1,0,10.0,-103,-1
user_006647,43,30k-50k,mobile,returning,South,48,True,30,6,0,True,True,True,20,3,0,7.063904885262372,10,3
user_006648,53,75k-100k,desktop,new,East,36,True,117,2,0,True,False,True,127,1,1,6.933565153590043,-10,1
user_006649,58,100k-150k,desktop,returning,East,55,True,94,1,0,False,False,True,104,1,0,7.7575671973564,-10,0
user_006650,60,75k-100k,mobile,returning,South,25,True,105,5,0,False,False,True,102,5,0,6.062740001389328,3,0
user_006651,39,50k-75k,mobile,returning,East,33,True,104,3,0,True,False,True,92,3,0,5.474510824355169,12,0
user_006652,56,50k-75k,desktop,new,South,40,True,106,2,0,False,False,True,93,1,0,6.849334521442667,13,1
user_006653,44,<30k,desktop,returning,East,22,False,0,0,0,True,False,True,117,1,0,6.015771423050968,-117,-1
user_006654,41,100k-150k,desktop,returning,Midwest,52,True,30,4,0,False,True,True,20,4,0,5.587550109055488,10,0
user_006655,23,30k-50k,desktop,new,East,60,True,130,2,0,False,False,True,102,6,0,8.277467941614736,28,-4
user_006656,50,50k-75k,desktop,returning,East,57,True,95,3,0,True,False,True,100,2,0,3.5751205862236968,-5,1
user_006657,25,30k-50k,mobile,returning,South,55,True,50,3,1,False,False,True,68,4,0,7.554454123918052,-18,-1
user_006658,44,100k-150k,mobile,returning,West,69,True,96,3,0,True,True,True,69,4,0,7.829559880779089,27,-1
user_006659,18,75k-100k,mobile,returning,West,85,True,120,4,0,False,True,True,105,2,0,9.464275472779848,15,2
user_006660,42,75k-100k,desktop,new,West,73,True,74,2,0,False,True,True,68,1,0,8.764192965804094,6,1
user_006661,42,50k-75k,mobile,returning,South,60,True,113,1,0,False,False,True,130,3,0,8.07003967210028,-17,-2
user_006662,71,50k-75k,mobile,new,South,0,True,166,4,1,False,False,True,132,4,0,3.664213756717023,34,0
user_006663,49,30k-50k,desktop,returning,Midwest,66,True,32,3,0,True,True,True,44,2,0,6.251324113448391,-12,1
user_006664,53,30k-50k,mobile,new,South,62,False,0,0,0,False,False,True,132,1,0,7.0113361546350275,-132,-1
user_006665,39,<30k,tablet,new,Midwest,39,True,58,3,0,True,False,False,0,0,0,,58,3
user_006666,42,75k-100k,mobile,new,Midwest,27,False,0,0,0,True,True,True,133,1,0,7.002887826323968,-133,-1
user_006667,31,30k-50k,mobile,new,South,91,True,138,3,0,True,True,True,111,2,0,10.0,27,1
user_006668,49,100k-150k,mobile,new,West,70,True,89,1,0,True,True,True,38,1,0,9.066125611186513,51,0
user_006669,45,75k-100k,mobile,returning,South,57,True,38,6,0,False,False,True,65,5,0,8.721827539706423,-27,1
user_006670,58,30k-50k,mobile,returning,East,44,True,95,1,0,True,False,True,78,1,0,7.903601668761162,17,0
user_006671,40,30k-50k,mobile,returning,West,58,True,117,3,0,False,True,True,84,4,0,7.552506483962434,33,-1
user_006672,19,30k-50k,mobile,new,West,89,True,113,6,0,True,True,True,72,6,1,8.674198561620964,41,0
user_006673,39,<30k,desktop,returning,West,58,True,88,2,0,True,False,True,87,4,0,7.68444132853675,1,-2
user_006674,35,30k-50k,desktop,new,South,59,True,138,2,0,False,True,True,145,2,0,10.0,-7,0
user_006675,38,<30k,mobile,new,South,33,False,0,0,0,False,True,True,96,1,0,7.838263764030206,-96,-1
user_006676,32,50k-75k,mobile,new,West,78,True,138,2,0,False,False,True,162,2,0,8.699409398261286,-24,0
user_006677,21,50k-75k,mobile,new,East,76,True,80,4,0,True,True,True,67,6,0,9.876572759225276,13,-2
user_006678,47,75k-100k,mobile,returning,Midwest,61,True,45,4,0,True,True,True,70,1,0,9.11555556863707,-25,3
user_006679,47,30k-50k,desktop,returning,South,32,True,80,2,0,True,True,True,71,2,0,6.274575258694616,9,0
user_006680,28,50k-75k,desktop,returning,East,89,True,101,5,0,True,True,True,89,2,0,8.387165357662148,12,3
user_006681,42,30k-50k,mobile,new,East,30,True,91,1,0,False,False,True,111,1,0,7.499554405848486,-20,0
user_006682,53,50k-75k,desktop,returning,East,43,True,108,1,0,False,True,True,91,1,0,6.9352662460201016,17,0
user_006683,37,<30k,tablet,returning,West,35,True,112,5,1,False,True,True,83,2,0,5.535273034695198,29,3
user_006684,19,50k-75k,mobile,returning,South,74,True,48,2,0,True,False,True,41,2,0,8.295654080588413,7,0
user_006685,30,<30k,mobile,returning,Midwest,54,True,47,4,0,True,True,True,34,2,0,6.24773558364809,13,2
user_006686,32,30k-50k,desktop,returning,South,53,False,0,0,0,False,True,True,94,3,0,6.9307242300506795,-94,-3
user_006687,27,30k-50k,tablet,new,Midwest,70,True,158,1,0,False,False,True,155,1,0,10.0,3,0
user_006688,37,30k-50k,desktop,returning,South,32,True,150,6,0,True,True,True,133,7,0,9.06555969661496,17,-1
user_006689,75,50k-75k,desktop,new,East,48,True,152,1,0,False,False,True,171,1,0,7.788920074578585,-19,0
user_006690,62,30k-50k,desktop,new,West,57,True,169,4,0,True,True,True,143,2,0,8.93085350123545,26,2
user_006691,48,30k-50k,desktop,returning,East,44,False,0,0,0,True,True,True,41,3,0,7.134574340258081,-41,-3
user_006692,66,30k-50k,mobile,returning,West,64,True,86,4,1,True,True,True,80,3,0,6.786475295668235,6,1
user_006693,33,30k-50k,tablet,returning,West,99,True,74,1,0,True,True,True,75,1,0,7.69873060823891,-1,0
user_006694,38,75k-100k,desktop,new,Midwest,57,True,68,3,0,False,True,True,51,1,0,10.0,17,2
user_006695,26,<30k,mobile,new,West,54,False,0,0,0,False,False,True,133,4,0,7.061803790701863,-133,-4
user_006696,57,<30k,desktop,returning,South,8,False,0,0,0,False,False,False,0,0,0,,0,0
user_006697,37,100k-150k,desktop,returning,South,56,False,0,0,0,False,False,True,86,1,0,8.332907849767516,-86,-1
user_006698,30,50k-75k,mobile,returning,East,66,True,56,1,0,True,True,True,88,1,0,9.331655362320252,-32,0
user_006699,37,30k-50k,desktop,returning,South,52,True,65,1,0,True,True,True,78,2,1,5.563923420121968,-13,-1
user_006700,18,50k-75k,mobile,new,Midwest,65,True,121,6,0,False,False,False,0,0,0,,121,6
user_006701,36,75k-100k,mobile,returning,South,69,True,37,2,0,True,True,True,20,1,0,9.071116712773257,17,1
user_006702,64,75k-100k,desktop,new,Midwest,26,True,204,4,0,True,False,True,220,5,0,5.315870660922971,-16,-1
user_006703,18,30k-50k,desktop,returning,East,55,True,85,2,0,True,True,True,37,1,0,8.396219060726004,48,1
user_006704,28,<30k,mobile,new,East,63,False,0,0,0,True,True,False,0,0,0,,0,0
user_006705,40,30k-50k,mobile,returning,West,35,True,30,3,0,True,True,True,20,2,0,8.596218978598701,10,1
user_006706,80,30k-50k,mobile,new,South,44,False,0,0,0,False,True,True,95,1,0,8.80644172395329,-95,-1
user_006707,32,100k-150k,mobile,returning,East,86,True,86,4,0,True,True,True,86,9,0,5.334002055547974,0,-5
user_006708,34,75k-100k,tablet,new,South,55,True,109,2,0,True,True,True,104,1,0,8.727613285592637,5,1
user_006709,20,75k-100k,mobile,returning,West,100,True,86,5,0,False,True,True,53,5,0,9.550891291847416,33,0
user_006710,47,100k-150k,desktop,new,East,69,True,125,2,0,True,True,True,89,1,0,8.69293738156788,36,1
user_006711,38,50k-75k,desktop,returning,Midwest,50,True,40,4,0,False,True,True,34,4,0,8.37736377017554,6,0
user_006712,18,>150k,mobile,returning,West,100,True,30,2,0,False,True,True,33,2,1,8.080773968628373,-3,0
user_006713,29,30k-50k,tablet,returning,East,68,True,59,1,0,False,False,True,54,1,1,5.957101572857203,5,0
user_006714,51,50k-75k,mobile,returning,South,26,True,129,4,1,False,False,True,129,4,1,5.37899639519111,0,0
user_006715,18,<30k,mobile,returning,West,76,True,30,2,0,False,False,True,22,1,0,8.062674554249824,8,1
user_006716,57,>150k,desktop,new,West,66,True,121,2,1,False,True,True,123,2,0,8.85674974690197,-2,0
user_006717,54,30k-50k,mobile,returning,Midwest,21,True,123,9,0,False,False,True,117,6,0,5.5001864523205,6,3
user_006718,18,75k-100k,desktop,new,South,71,True,123,4,0,False,True,True,112,1,0,7.806997481861917,11,3
user_006719,50,100k-150k,desktop,new,West,60,True,160,1,1,False,False,True,162,1,0,6.649317936961832,-2,0
user_006720,62,75k-100k,desktop,returning,West,30,True,69,2,0,True,True,True,49,1,0,7.972823897182991,20,1
user_006721,42,50k-75k,mobile,new,Midwest,65,True,62,5,0,False,True,True,97,6,0,4.996124625810556,-35,-1
user_006722,46,<30k,desktop,new,East,38,True,144,1,0,True,False,False,0,0,0,,144,1
user_006723,51,75k-100k,desktop,returning,East,38,True,119,3,0,True,True,True,94,3,0,8.47854008366294,25,0
user_006724,29,50k-75k,desktop,new,West,100,False,0,0,0,True,True,True,100,1,0,9.570519253690483,-100,-1
user_006725,58,30k-50k,mobile,returning,West,5,True,95,6,0,True,False,True,101,6,0,5.820140496285019,-6,0
user_006726,38,30k-50k,desktop,new,South,70,True,102,1,0,False,True,True,68,1,0,9.88036673030769,34,0
user_006727,69,100k-150k,desktop,returning,East,12,True,140,6,0,True,False,True,139,2,0,8.93479435863834,1,4
user_006728,52,<30k,desktop,returning,Midwest,24,True,126,3,0,False,False,True,134,5,0,6.816680756398163,-8,-2
user_006729,31,50k-75k,desktop,returning,South,87,True,90,1,0,True,True,False,0,0,0,,90,1
user_006730,45,75k-100k,desktop,new,East,27,True,219,6,0,True,False,True,189,6,0,6.880865217129352,30,0
user_006731,80,75k-100k,mobile,returning,West,54,True,122,2,0,True,False,True,139,1,0,6.257411785123784,-17,1
user_006732,46,75k-100k,desktop,returning,West,89,True,30,8,0,True,True,True,33,7,2,6.418313303383672,-3,1
user_006733,23,30k-50k,mobile,new,East,29,False,0,0,0,True,False,False,0,0,0,,0,0
user_006734,36,50k-75k,mobile,returning,East,48,True,114,3,0,True,False,False,0,0,0,,114,3
user_006735,52,50k-75k,desktop,returning,South,50,True,78,4,0,True,True,True,105,2,0,9.732836941230483,-27,2
user_006736,67,<30k,mobile,new,Midwest,15,False,0,0,0,False,False,False,0,0,0,,0,0
user_006737,36,50k-75k,mobile,new,West,50,True,118,2,0,False,True,True,101,1,0,10.0,17,1
user_006738,56,<30k,desktop,returning,West,31,False,0,0,0,False,False,True,148,1,0,7.961164528934017,-148,-1
user_006739,35,50k-75k,tablet,returning,South,31,True,65,2,0,True,True,True,35,1,0,9.813476325179519,30,1
user_006740,41,75k-100k,tablet,returning,Midwest,34,True,104,4,0,False,False,True,102,2,0,7.0554099014248495,2,2
user_006741,41,<30k,mobile,new,East,43,False,0,0,0,False,False,True,105,1,0,8.38750108392962,-105,-1
user_006742,30,30k-50k,mobile,new,East,67,True,89,4,0,False,True,True,96,4,0,7.931586841213859,-7,0
user_006743,50,50k-75k,mobile,new,East,40,True,82,1,0,False,True,True,67,1,0,8.323652391555495,15,0
user_006744,39,75k-100k,mobile,returning,East,32,True,51,4,0,True,True,True,59,3,0,8.896965407433074,-8,1
user_006745,45,50k-75k,mobile,returning,Midwest,63,True,104,5,1,True,True,True,37,4,0,5.475123813792696,67,1
user_006746,20,50k-75k,mobile,returning,South,49,True,72,3,1,True,True,True,65,6,0,6.412046364558881,7,-3
user_006747,73,75k-100k,mobile,returning,East,25,True,111,1,1,False,False,True,106,1,0,8.402804520819965,5,0
user_006748,80,75k-100k,mobile,returning,South,46,True,123,6,0,True,False,True,138,10,1,7.199251755019093,-15,-4
user_006749,55,50k-75k,desktop,returning,West,48,True,75,4,2,False,True,True,59,1,0,6.335426867656573,16,3
user_006750,74,30k-50k,tablet,returning,South,16,True,102,3,2,False,False,True,104,1,0,6.618642730357239,-2,2
user_006751,45,100k-150k,mobile,returning,West,91,True,81,5,0,False,False,True,63,3,0,5.045136852910982,18,2
user_006752,33,50k-75k,mobile,new,East,30,True,152,3,0,False,True,True,106,1,0,7.548797949430976,46,2
user_006753,23,75k-100k,mobile,returning,South,77,True,118,1,0,True,True,True,132,1,0,8.627153249106332,-14,0
user_006754,69,75k-100k,desktop,new,East,16,True,160,3,1,False,False,True,164,3,0,5.92412375593415,-4,0
user_006755,44,30k-50k,desktop,returning,East,57,False,0,0,0,False,True,True,71,1,0,8.035062649146163,-71,-1
user_006756,52,<30k,mobile,new,East,50,True,95,5,0,False,False,False,0,0,0,,95,5
user_006757,72,100k-150k,desktop,returning,East,69,True,30,1,0,True,True,True,20,1,0,8.940339462165275,10,0
user_006758,22,50k-75k,desktop,returning,South,79,True,61,1,0,True,True,True,37,1,0,8.821504597017912,24,0
user_006759,40,75k-100k,mobile,returning,East,33,True,82,6,0,True,False,True,68,10,0,8.145586374132346,14,-4
user_006760,46,30k-50k,mobile,returning,East,17,True,153,4,1,False,True,True,121,3,0,6.222379410154555,32,1
user_006761,47,75k-100k,mobile,returning,East,64,True,45,4,0,True,True,True,42,5,0,8.292644867295971,3,-1
user_006762,38,<30k,mobile,returning,West,78,True,76,8,0,False,True,True,41,7,0,8.406987924004307,35,1
user_006763,57,<30k,desktop,new,East,38,False,0,0,0,True,False,False,0,0,0,,0,0
user_006764,58,<30k,desktop,returning,East,18,True,164,3,0,True,False,True,175,5,0,7.453874078000409,-11,-2
user_006765,35,<30k,desktop,returning,Midwest,24,True,129,3,0,False,False,True,122,2,0,8.088479818130041,7,1
user_006766,48,50k-75k,tablet,returning,West,46,True,66,1,0,False,False,False,0,0,0,,66,1
user_006767,31,50k-75k,desktop,returning,East,75,True,74,4,1,True,False,True,100,6,1,8.151919709799895,-26,-2
user_006768,48,75k-100k,desktop,returning,West,58,True,100,2,0,False,True,True,88,3,0,8.163093906887235,12,-1
user_006769,35,50k-75k,desktop,returning,South,40,True,68,4,0,True,False,True,57,5,0,8.204042967299838,11,-1
user_006770,37,100k-150k,desktop,returning,Midwest,62,True,87,2,0,False,False,True,105,3,1,7.640980305365453,-18,-1
user_006771,28,<30k,mobile,returning,Midwest,49,True,95,7,0,False,False,True,99,5,0,7.536832486512541,-4,2
user_006772,44,<30k,mobile,new,East,22,False,0,0,0,True,True,True,86,1,0,8.076358381674327,-86,-1
user_006773,67,100k-150k,desktop,returning,South,32,True,47,4,0,True,False,True,48,5,0,8.44214139536414,-1,-1
user_006774,53,75k-100k,mobile,returning,East,78,True,78,2,0,True,True,True,52,2,0,8.577316218789775,26,0
user_006775,53,30k-50k,desktop,returning,South,54,True,114,3,0,False,True,True,119,2,0,9.012754613159332,-5,1
user_006776,46,30k-50k,mobile,returning,East,43,True,114,2,0,True,True,True,74,1,0,6.446721868629969,40,1
user_006777,45,50k-75k,desktop,new,East,73,False,0,0,0,False,True,False,0,0,0,,0,0
user_006778,50,75k-100k,desktop,returning,West,35,True,79,4,0,False,True,True,74,4,0,7.853121487550185,5,0
user_006779,18,100k-150k,desktop,returning,West,89,True,124,4,0,True,True,True,126,3,0,8.90908714084169,-2,1
user_006780,43,75k-100k,mobile,new,West,51,True,136,3,0,False,True,True,123,4,0,10.0,13,-1
user_006781,62,30k-50k,desktop,returning,West,44,True,97,1,0,False,False,True,70,1,0,8.038681898488463,27,0
user_006782,52,50k-75k,desktop,returning,East,41,True,78,3,1,False,False,True,132,4,1,6.542121328017265,-54,-1
user_006783,54,30k-50k,desktop,returning,Midwest,46,True,119,2,0,True,True,True,99,2,0,7.389285517340413,20,0
user_006784,44,<30k,mobile,new,Midwest,19,False,0,0,0,False,False,True,115,1,0,8.161248594803952,-115,-1
user_006785,38,75k-100k,mobile,returning,West,48,True,101,1,0,False,True,True,76,1,0,7.208128696078642,25,0
user_006786,51,75k-100k,desktop,new,West,74,False,0,0,0,False,False,True,115,3,0,7.04662080874188,-115,-3
user_006787,41,30k-50k,desktop,returning,West,53,True,103,5,0,False,True,True,80,1,0,7.66670361381904,23,4
user_006788,30,75k-100k,mobile,returning,South,67,False,0,0,0,True,True,True,96,2,0,7.972079179576269,-96,-2
user_006789,43,>150k,desktop,returning,South,76,True,69,1,0,False,True,True,74,1,0,8.646384115813277,-5,0
user_006790,61,50k-75k,mobile,returning,South,17,True,152,4,0,False,False,True,145,2,0,8.541566412032566,7,2
user_006791,37,75k-100k,mobile,returning,East,56,True,90,1,0,False,True,True,84,1,0,7.328830417538908,6,0
user_006792,26,75k-100k,mobile,new,West,90,True,30,2,0,False,True,True,20,1,0,8.063320708233949,10,1
user_006793,32,75k-100k,mobile,returning,East,63,True,113,2,0,False,True,True,95,2,0,6.493277197131706,18,0
user_006794,29,30k-50k,desktop,returning,West,87,True,65,2,0,False,True,True,92,1,0,8.585723748238351,-27,1
user_006795,56,30k-50k,desktop,new,Midwest,31,True,60,3,0,True,False,True,34,1,0,7.616318319062073,26,2
user_006796,63,30k-50k,mobile,new,Midwest,48,True,123,4,0,False,False,True,99,3,0,8.065780764141603,24,1
user_006797,38,50k-75k,desktop,new,South,40,True,94,3,0,False,False,True,91,7,0,5.9005285127537626,3,-4
user_006798,51,100k-150k,desktop,returning,West,93,True,36,4,0,True,True,True,25,4,0,10.0,11,0
user_006799,38,75k-100k,tablet,new,East,73,True,91,3,1,False,False,True,111,1,1,5.637141928874733,-20,2
user_006800,39,<30k,mobile,returning,East,26,True,115,6,0,False,True,True,105,4,0,8.527808861046324,10,2
user_006801,50,30k-50k,mobile,new,South,68,True,74,2,0,True,True,True,51,1,0,8.202986270069243,23,1
user_006802,25,30k-50k,desktop,returning,West,75,True,31,1,0,True,True,True,20,1,0,7.846845602475482,11,0
user_006803,42,50k-75k,desktop,returning,Midwest,53,True,141,2,0,True,False,True,131,1,0,5.973660759925406,10,1
user_006804,26,50k-75k,desktop,returning,East,75,True,66,2,0,False,True,True,72,1,1,10.0,-6,1
user_006805,18,50k-75k,desktop,returning,East,49,True,83,5,0,True,False,True,144,6,0,7.7964462667743595,-61,-1
user_006806,19,30k-50k,desktop,returning,South,45,True,99,1,1,False,False,True,109,2,2,5.551745841296051,-10,-1
user_006807,57,75k-100k,desktop,returning,West,48,True,38,2,0,False,False,True,20,2,1,8.529791351323901,18,0
user_006808,50,<30k,mobile,returning,Midwest,39,True,79,2,0,False,False,True,88,1,0,6.230820152221026,-9,1
user_006809,40,>150k,mobile,returning,West,69,True,110,6,1,True,False,True,105,3,0,6.401909351232628,5,3
user_006810,26,<30k,desktop,new,Midwest,62,True,64,1,1,True,True,True,90,1,0,6.800431336414891,-26,0
user_006811,37,>150k,mobile,returning,South,54,True,125,2,0,False,True,True,81,1,0,9.519754322180079,44,1
user_006812,50,50k-75k,mobile,returning,Midwest,22,True,145,8,0,False,False,True,134,7,0,4.675537590557846,11,1
user_006813,69,<30k,desktop,returning,West,57,True,88,7,0,True,True,True,63,4,0,10.0,25,3
user_006814,40,50k-75k,tablet,new,East,63,True,119,2,0,True,True,True,124,2,0,8.5765399817686,-5,0
user_006815,18,50k-75k,desktop,returning,West,72,True,84,3,0,False,False,True,108,3,0,7.379040113004915,-24,0
user_006816,32,75k-100k,desktop,returning,Midwest,52,True,119,2,0,True,True,True,112,2,0,9.582953060262364,7,0
user_006817,50,50k-75k,mobile,returning,Midwest,41,True,89,3,0,False,False,True,69,8,0,6.068938907498417,20,-5
user_006818,58,50k-75k,mobile,new,East,28,True,170,10,0,True,True,True,103,5,0,6.486282974501065,67,5
user_006819,39,50k-75k,desktop,new,Midwest,54,True,84,1,0,False,True,True,40,1,0,5.919655735409201,44,0
user_006820,65,<30k,desktop,returning,Midwest,37,True,82,1,1,True,False,True,77,1,0,6.2764744164392035,5,0
user_006821,52,<30k,mobile,new,East,55,True,154,4,0,False,False,True,164,2,0,6.98116264570048,-10,2
user_006822,37,>150k,mobile,returning,South,53,True,98,5,0,True,True,True,26,4,0,7.402442063933907,72,1
user_006823,52,50k-75k,mobile,returning,East,38,True,89,5,0,True,True,True,54,2,0,8.711678495706336,35,3
user_006824,25,30k-50k,mobile,returning,East,52,True,129,8,0,False,True,True,109,6,0,8.77370694626926,20,2
user_006825,41,30k-50k,mobile,returning,East,59,True,75,1,0,True,True,True,44,1,0,8.433719118764543,31,0
user_006826,46,<30k,mobile,returning,Midwest,38,False,0,0,0,False,True,True,132,1,0,7.345977293520334,-132,-1
user_006827,50,30k-50k,mobile,returning,Midwest,27,True,150,3,0,True,True,True,112,5,0,7.580709061720326,38,-2
user_006828,43,100k-150k,desktop,returning,South,57,True,81,1,1,True,True,True,58,1,0,7.6085971782918795,23,0
user_006829,64,<30k,mobile,returning,West,51,True,102,2,0,False,False,False,0,0,0,,102,2
user_006830,44,75k-100k,desktop,returning,East,39,True,117,6,0,True,False,True,79,9,0,6.077052301315294,38,-3
user_006831,40,30k-50k,mobile,returning,South,58,True,132,1,0,True,True,True,97,4,1,6.551898536558293,35,-3
user_006832,22,30k-50k,desktop,returning,East,67,True,132,5,0,True,True,True,130,5,0,7.200638269769441,2,0
user_006833,29,50k-75k,tablet,new,Midwest,75,True,88,4,0,True,True,True,81,4,0,9.722493539385242,7,0
user_006834,37,50k-75k,mobile,returning,Midwest,52,True,87,4,1,False,True,True,36,1,0,8.084899828310265,51,3
user_006835,45,<30k,desktop,returning,West,36,False,0,0,0,False,True,True,87,1,0,6.834095995421497,-87,-1
user_006836,26,30k-50k,desktop,returning,East,69,True,53,3,1,True,True,True,48,3,0,6.007323326397043,5,0
user_006837,55,100k-150k,desktop,returning,East,58,True,122,1,0,True,True,True,91,1,0,8.705411680976653,31,0
user_006838,55,75k-100k,desktop,new,East,54,True,74,2,0,False,False,True,56,1,0,5.772364337790696,18,1
user_006839,18,50k-75k,mobile,returning,West,59,True,39,1,0,False,True,True,32,1,0,7.009798355892934,7,0
user_006840,60,<30k,mobile,returning,East,14,False,0,0,0,False,False,True,116,4,0,5.6899441419063725,-116,-4
user_006841,56,>150k,desktop,returning,South,63,True,82,2,0,True,True,True,68,3,0,8.788419748497759,14,-1
user_006842,26,75k-100k,desktop,returning,South,62,True,113,2,0,True,True,True,96,1,0,8.88213150378019,17,1
user_006843,60,75k-100k,mobile,new,East,38,False,0,0,0,False,True,True,120,1,0,4.699840653967452,-120,-1
user_006844,25,50k-75k,desktop,returning,East,89,True,110,4,0,False,True,True,115,2,0,7.779653907973938,-5,2
user_006845,18,75k-100k,mobile,returning,West,80,True,65,1,1,True,True,True,51,1,0,7.460756637236392,14,0
user_006846,53,75k-100k,mobile,new,East,40,True,142,3,0,True,False,True,153,5,0,7.016930208267751,-11,-2
user_006847,26,30k-50k,desktop,returning,West,85,True,49,4,0,True,True,True,28,2,0,9.748783762021866,21,2
user_006848,38,75k-100k,desktop,new,Midwest,41,True,101,1,0,False,True,True,111,1,0,9.333868809725166,-10,0
user_006849,35,50k-75k,desktop,returning,East,17,True,105,1,1,False,False,True,133,1,0,7.134753488227289,-28,0
user_006850,51,30k-50k,desktop,new,South,28,True,225,5,0,False,False,True,239,8,1,7.774909669754582,-14,-3
user_006851,29,50k-75k,desktop,returning,West,88,True,87,3,0,True,True,True,90,3,0,8.727728469279842,-3,0
user_006852,43,<30k,desktop,new,West,33,True,85,2,0,False,False,True,73,4,0,10.0,12,-2
user_006853,57,100k-150k,mobile,returning,East,22,True,115,5,2,True,True,True,119,4,0,7.351998515524267,-4,1
user_006854,56,50k-75k,mobile,returning,West,54,False,0,0,0,True,True,True,77,1,0,9.993421755022231,-77,-1
user_006855,48,75k-100k,mobile,returning,West,83,True,30,2,0,True,True,True,43,1,0,9.240115381026989,-13,1
user_006856,18,>150k,desktop,new,East,85,True,126,1,0,True,False,True,114,2,0,7.3146871066234995,12,-1
user_006857,23,>150k,desktop,returning,West,100,True,95,1,0,True,True,True,40,2,0,8.955779814118783,55,-1
user_006858,52,100k-150k,desktop,returning,East,47,True,53,5,0,False,False,True,73,8,0,7.832272320838403,-20,-3
user_006859,24,50k-75k,desktop,new,West,68,True,180,1,0,False,True,True,170,2,0,9.303280046155985,10,-1
user_006860,53,75k-100k,mobile,returning,South,63,True,99,2,0,True,False,True,89,2,0,7.132635296225599,10,0
user_006861,51,100k-150k,mobile,returning,West,28,True,106,2,0,True,True,True,52,2,0,7.019546875262364,54,0
user_006862,53,75k-100k,mobile,new,East,39,True,143,5,0,True,True,True,132,4,0,8.27882250290563,11,1
user_006863,60,75k-100k,mobile,new,West,36,True,123,4,0,False,True,True,99,1,0,7.269867095421114,24,3
user_006864,45,100k-150k,mobile,returning,East,72,True,125,1,0,True,True,True,94,2,0,9.651981303666513,31,-1
user_006865,52,30k-50k,tablet,new,South,30,True,94,4,0,False,True,True,69,6,0,10.0,25,-2
user_006866,46,50k-75k,tablet,new,East,50,True,88,5,0,True,True,True,96,5,0,10.0,-8,0
user_006867,49,30k-50k,mobile,returning,East,77,True,101,7,0,False,True,True,81,6,0,8.267078866107127,20,1
user_006868,34,30k-50k,desktop,returning,East,86,True,105,2,0,False,False,False,0,0,0,,105,2
user_006869,58,100k-150k,desktop,returning,Midwest,43,True,133,2,0,True,True,True,88,1,0,6.895964960509541,45,1
user_006870,18,50k-75k,mobile,returning,Midwest,53,False,0,0,0,True,True,True,79,1,0,7.167751859997831,-79,-1
user_006871,44,50k-75k,desktop,returning,South,21,True,140,3,1,False,False,True,159,4,0,6.335853785556469,-19,-1
user_006872,20,30k-50k,mobile,new,West,61,True,127,1,0,True,True,False,0,0,0,,127,1
user_006873,31,30k-50k,mobile,returning,East,91,True,40,1,1,True,True,True,25,3,0,8.291344196664506,15,-2
user_006874,40,100k-150k,mobile,new,Midwest,52,False,0,0,0,False,True,True,77,1,0,6.30405403236427,-77,-1
user_006875,33,100k-150k,desktop,new,South,81,True,69,1,0,False,True,True,43,1,1,8.080885723114292,26,0
user_006876,51,75k-100k,desktop,returning,South,30,True,106,2,0,True,False,True,105,2,0,6.2160493285789205,1,0
user_006877,18,50k-75k,mobile,returning,Midwest,74,False,0,0,0,False,True,True,71,1,0,6.6401250458640355,-71,-1
user_006878,60,50k-75k,mobile,new,Midwest,56,True,89,4,0,False,True,True,95,5,0,8.514151320371525,-6,-1
user_006879,28,>150k,mobile,returning,Midwest,67,True,56,3,0,True,True,True,50,2,0,6.526462227845221,6,1
user_006880,36,100k-150k,desktop,new,West,67,True,147,8,0,True,True,True,165,2,0,7.848304169798374,-18,6
user_006881,18,30k-50k,mobile,returning,East,81,True,75,3,0,True,True,True,22,1,0,8.241639898437548,53,2
user_006882,39,100k-150k,tablet,returning,West,71,True,98,2,1,True,True,True,56,1,0,7.09931944990091,42,1
user_006883,37,30k-50k,desktop,returning,West,65,True,123,1,0,True,True,True,79,2,0,6.5657265917989465,44,-1
user_006884,46,30k-50k,desktop,new,Midwest,26,True,219,1,0,True,False,False,0,0,0,,219,1
user_006885,28,50k-75k,tablet,returning,West,59,True,128,4,0,False,False,True,122,3,0,5.2342554305759394,6,1
user_006886,64,30k-50k,desktop,new,South,15,False,0,0,0,False,False,True,115,2,0,7.131541413381493,-115,-2
user_006887,55,50k-75k,desktop,new,Midwest,56,True,109,1,0,True,True,True,76,1,0,10.0,33,0
user_006888,28,>150k,mobile,new,East,68,True,117,4,0,True,True,True,89,5,0,8.391770747608973,28,-1
user_006889,38,30k-50k,desktop,returning,West,51,True,98,3,2,False,True,True,66,1,0,8.705618631113785,32,2
user_006890,44,50k-75k,desktop,new,Midwest,30,True,120,4,0,False,False,True,103,5,0,6.517914201287884,17,-1
user_006891,59,30k-50k,desktop,new,South,58,True,96,3,0,False,False,False,0,0,0,,96,3
user_006892,46,100k-150k,desktop,new,Midwest,67,True,101,1,0,True,True,True,93,2,0,8.152752433497774,8,-1
user_006893,46,75k-100k,desktop,returning,South,26,True,150,3,0,True,False,True,130,4,0,7.094959430786856,20,-1
user_006894,35,30k-50k,desktop,new,West,44,True,121,2,0,True,False,True,107,1,0,7.236229958040885,14,1
user_006895,40,<30k,desktop,new,East,57,False,0,0,0,False,True,True,79,1,0,9.509293588348886,-79,-1
user_006896,40,<30k,mobile,returning,South,43,True,104,1,0,True,True,True,84,1,0,8.099759713742802,20,0
user_006897,56,30k-50k,mobile,returning,East,34,True,86,1,1,True,True,True,114,1,0,8.583226207685533,-28,0
user_006898,70,75k-100k,mobile,new,South,36,True,148,1,0,False,False,True,153,2,0,6.1742631754119985,-5,-1
user_006899,26,30k-50k,desktop,returning,South,51,True,61,2,0,False,False,True,28,1,0,6.912527038492135,33,1
user_006900,53,30k-50k,desktop,new,West,49,True,102,3,1,False,False,True,74,2,0,5.5884144538325895,28,1
user_006901,23,100k-150k,desktop,returning,South,46,True,87,1,0,False,False,True,99,1,1,6.850330250496739,-12,0
user_006902,27,<30k,mobile,new,West,69,True,73,6,0,True,True,False,0,0,0,,73,6
user_006903,61,<30k,desktop,returning,South,30,True,95,2,0,True,False,True,123,3,0,7.287172300151004,-28,-1
user_006904,54,100k-150k,desktop,new,West,67,True,151,5,0,True,True,True,125,5,0,7.268914899508027,26,0
user_006905,46,75k-100k,desktop,new,East,76,True,98,2,0,True,True,True,125,1,0,8.624203013584847,-27,1
user_006906,18,50k-75k,mobile,returning,South,61,True,102,5,0,True,False,True,105,3,0,6.293320428883669,-3,2
user_006907,48,50k-75k,desktop,new,South,44,True,111,1,0,False,True,True,79,1,1,7.110414637304201,32,0
user_006908,51,<30k,mobile,returning,Midwest,36,False,0,0,0,False,False,True,114,1,0,7.345004173430035,-114,-1
user_006909,64,50k-75k,mobile,returning,East,21,True,98,4,1,True,False,True,99,8,0,6.077293422738677,-1,-4
user_006910,37,75k-100k,mobile,new,East,42,True,84,1,1,False,False,True,80,1,0,6.051687837466844,4,0
user_006911,46,75k-100k,desktop,returning,East,65,True,101,1,0,True,True,True,61,1,0,9.130463788403592,40,0
user_006912,58,50k-75k,desktop,new,South,31,False,0,0,0,False,False,True,139,4,0,5.491872363618938,-139,-4
user_006913,53,30k-50k,desktop,returning,Midwest,43,True,121,2,0,True,True,True,105,4,0,8.614892022804158,16,-2
user_006914,59,50k-75k,desktop,returning,East,23,True,156,1,0,False,False,True,141,1,0,7.09108657589463,15,0
user_006915,55,<30k,desktop,returning,East,29,False,0,0,0,True,False,True,104,1,0,7.680223801358976,-104,-1
user_006916,55,100k-150k,desktop,returning,West,94,True,76,3,0,True,True,True,62,2,0,9.522078132751636,14,1
user_006917,53,30k-50k,desktop,returning,West,66,True,140,2,0,False,True,True,123,3,0,7.954141142294601,17,-1
user_006918,45,>150k,mobile,returning,South,46,True,82,2,0,False,False,True,72,2,0,7.013309471059543,10,0
user_006919,57,50k-75k,desktop,new,South,10,True,180,2,0,False,False,True,187,1,0,6.996709730169509,-7,1
user_006920,75,50k-75k,mobile,new,South,48,True,156,2,1,True,False,True,162,2,0,7.461691136716026,-6,0
user_006921,35,75k-100k,mobile,returning,West,66,True,67,3,0,False,True,True,26,3,0,9.40170302386092,41,0
user_006922,43,100k-150k,desktop,returning,East,49,True,115,3,0,True,True,True,113,2,0,10.0,2,1
user_006923,31,30k-50k,tablet,returning,West,100,True,71,4,0,False,True,True,78,1,0,8.165288640579018,-7,3
user_006924,52,30k-50k,mobile,new,Midwest,50,False,0,0,0,False,False,True,104,3,1,7.353459192237979,-104,-3
user_006925,80,75k-100k,mobile,returning,Midwest,14,True,73,8,1,False,False,True,86,6,0,4.390514286197897,-13,2
user_006926,18,<30k,mobile,returning,West,79,True,101,1,0,False,True,True,140,1,0,8.753892707284287,-39,0
user_006927,46,100k-150k,desktop,returning,South,65,True,131,5,1,False,False,False,0,0,0,,131,5
user_006928,24,100k-150k,mobile,returning,South,82,False,0,0,0,True,True,True,78,1,0,7.1601259148090435,-78,-1
user_006929,33,50k-75k,desktop,returning,East,83,True,45,2,0,True,True,True,33,3,0,8.396782842118219,12,-1
user_006930,41,100k-150k,mobile,new,South,74,True,139,4,0,False,False,True,122,6,0,6.721075663020501,17,-2
user_006931,18,<30k,mobile,returning,South,48,True,100,3,0,False,False,False,0,0,0,,100,3
user_006932,32,30k-50k,desktop,new,East,80,True,91,3,0,False,False,True,107,4,0,8.071300915434858,-16,-1
user_006933,28,30k-50k,mobile,returning,South,67,True,74,3,0,False,True,True,127,1,0,9.213080386971498,-53,2
user_006934,56,50k-75k,mobile,new,Midwest,43,True,108,5,0,False,True,True,74,5,0,7.162126303420332,34,0
user_006935,43,100k-150k,desktop,returning,East,50,True,47,7,0,True,True,True,33,4,0,7.555869999308548,14,3
user_006936,56,100k-150k,desktop,new,Midwest,44,False,0,0,0,False,False,True,124,1,0,8.035741568205957,-124,-1
user_006937,60,30k-50k,desktop,returning,South,32,True,49,7,0,False,False,True,20,9,0,7.180691379588713,29,-2
user_006938,23,<30k,mobile,new,Midwest,51,True,111,5,0,True,True,True,50,4,0,8.434673651203395,61,1
user_006939,47,50k-75k,desktop,returning,West,70,True,135,4,0,True,True,True,107,1,0,7.9442659783481115,28,3
user_006940,57,30k-50k,desktop,new,East,29,True,175,2,0,False,False,True,152,1,1,7.335120533040052,23,1
user_006941,26,>150k,mobile,new,West,99,True,91,3,0,False,True,True,39,1,0,10.0,52,2
user_006942,57,100k-150k,mobile,returning,East,69,True,140,1,1,True,True,True,95,2,0,6.951072728152712,45,-1
user_006943,26,75k-100k,mobile,new,Midwest,61,True,166,2,0,True,True,True,160,1,0,7.220797040742615,6,1
user_006944,50,75k-100k,desktop,returning,East,43,True,153,4,0,True,True,True,103,6,0,8.796889651817102,50,-2
user_006945,42,30k-50k,mobile,returning,West,62,False,0,0,0,False,True,True,105,1,0,8.74715232236608,-105,-1
user_006946,41,50k-75k,mobile,returning,East,71,True,30,2,0,True,False,True,28,1,0,5.968531132966459,2,1
user_006947,56,<30k,mobile,returning,East,28,True,133,4,0,False,False,True,146,4,0,8.126415022073878,-13,0
user_006948,54,<30k,desktop,new,East,32,True,135,2,0,True,False,False,0,0,0,,135,2
user_006949,42,50k-75k,mobile,new,West,73,True,107,3,0,True,True,True,114,3,0,8.386519923160655,-7,0
user_006950,51,100k-150k,desktop,returning,East,39,True,112,3,0,True,False,True,120,3,0,9.64036720460622,-8,0
user_006951,31,50k-75k,desktop,new,South,71,True,101,1,0,False,False,True,115,1,0,9.482572505584342,-14,0
user_006952,44,<30k,mobile,new,East,13,True,130,3,0,False,False,False,0,0,0,,130,3
user_006953,36,50k-75k,desktop,returning,West,62,True,148,6,0,True,True,True,90,3,0,8.238785856635607,58,3
user_006954,60,>150k,desktop,new,South,41,True,79,1,0,False,False,True,110,1,0,10.0,-31,0
user_006955,28,50k-75k,desktop,new,Midwest,54,True,127,2,0,False,True,True,82,2,0,7.670380886094582,45,0
user_006956,35,<30k,mobile,new,Midwest,20,True,145,3,0,False,True,True,121,2,0,5.868522383780604,24,1
user_006957,70,100k-150k,desktop,returning,South,80,True,57,1,1,True,False,True,39,3,0,7.248171630625077,18,-2
user_006958,48,75k-100k,desktop,returning,East,45,True,112,3,0,False,True,True,89,4,0,9.464592770977262,23,-1
user_006959,65,<30k,desktop,returning,East,33,True,134,7,0,True,False,True,124,8,0,5.919213756237416,10,-1
user_006960,47,100k-150k,mobile,returning,South,62,True,62,5,0,True,True,True,82,4,0,7.978224502282491,-20,1
user_006961,46,75k-100k,mobile,returning,Midwest,54,True,88,6,0,False,True,True,102,2,0,8.6440997276899,-14,4
user_006962,32,75k-100k,desktop,new,West,91,True,83,2,0,True,True,True,76,1,0,7.606045845291849,7,1
user_006963,41,30k-50k,desktop,returning,Midwest,49,True,106,1,0,False,True,True,75,2,0,9.322741793570039,31,-1
user_006964,36,30k-50k,desktop,returning,East,62,True,78,4,0,True,True,True,54,3,0,8.337783418587449,24,1
user_006965,31,<30k,desktop,new,East,56,False,0,0,0,False,False,False,0,0,0,,0,0
user_006966,41,<30k,desktop,new,Midwest,38,False,0,0,0,False,False,False,0,0,0,,0,0
user_006967,42,30k-50k,desktop,new,East,52,True,173,1,0,False,False,True,164,2,0,7.2954314433665,9,-1
user_006968,53,75k-100k,desktop,new,West,60,True,171,1,0,True,True,True,105,1,0,10.0,66,0
user_006969,43,30k-50k,mobile,new,East,42,True,90,8,0,False,True,True,70,7,0,6.954618356638013,20,1
user_006970,42,50k-75k,tablet,returning,South,43,True,79,2,0,False,False,True,77,1,0,8.836633228718494,2,1
user_006971,27,75k-100k,desktop,returning,West,79,True,33,6,0,True,True,True,20,10,1,6.938421844572364,13,-4
user_006972,47,50k-75k,mobile,returning,West,52,True,115,5,0,True,False,True,82,5,0,6.242397820188203,33,0
user_006973,57,100k-150k,mobile,returning,East,48,True,96,5,0,True,False,True,33,5,0,6.308881576181005,63,0
user_006974,50,50k-75k,mobile,returning,West,71,True,88,5,0,False,False,True,100,3,0,7.77795946334509,-12,2
user_006975,59,75k-100k,desktop,returning,East,21,True,128,3,0,False,False,True,149,3,0,8.488657697725378,-21,0
user_006976,38,75k-100k,desktop,returning,South,49,True,73,1,0,True,True,True,27,1,0,7.909719962806837,46,0
user_006977,39,50k-75k,mobile,returning,West,63,True,110,1,0,True,True,True,72,1,0,7.734235919422072,38,0
user_006978,47,30k-50k,desktop,new,Midwest,55,True,84,1,0,False,True,True,68,1,0,7.082056771641784,16,0
user_006979,28,75k-100k,desktop,new,Midwest,52,True,112,5,0,False,False,True,129,5,2,8.181414043106805,-17,0
user_006980,18,30k-50k,desktop,returning,South,48,True,108,1,0,False,True,True,58,1,0,7.4624402596186545,50,0
user_006981,18,75k-100k,desktop,new,East,92,True,145,3,0,False,True,True,84,4,0,8.439115623213757,61,-1
user_006982,42,75k-100k,desktop,new,West,64,True,87,1,0,False,True,True,74,1,1,7.925696781349254,13,0
user_006983,52,<30k,desktop,returning,Midwest,35,True,97,3,0,False,True,True,95,1,0,8.57788203537423,2,2
user_006984,65,<30k,desktop,returning,West,28,False,0,0,0,True,True,True,124,2,0,5.4001095413398845,-124,-2
user_006985,54,50k-75k,desktop,returning,South,59,True,100,7,0,False,True,True,72,8,0,7.93347858658424,28,-1
user_006986,51,75k-100k,desktop,returning,Midwest,38,True,133,5,1,False,True,True,156,5,0,6.085282231471163,-23,0
user_006987,61,30k-50k,desktop,new,Midwest,59,False,0,0,0,False,False,False,0,0,0,,0,0
user_006988,43,50k-75k,mobile,new,East,59,True,124,1,0,False,True,True,114,1,0,7.860019739509231,10,0
user_006989,22,50k-75k,desktop,returning,East,48,True,107,4,0,True,False,True,99,1,0,8.530292107756802,8,3
user_006990,32,75k-100k,mobile,returning,South,59,True,97,2,0,False,False,True,98,3,0,5.187006641395534,-1,-1
user_006991,55,75k-100k,mobile,returning,Midwest,42,True,119,4,0,False,False,True,113,5,0,8.533707588789767,6,-1
user_006992,38,50k-75k,mobile,returning,West,54,True,81,3,0,False,True,True,68,5,0,8.717121058981188,13,-2
user_006993,24,50k-75k,mobile,returning,East,83,True,41,4,0,True,True,True,38,3,0,8.000253018555652,3,1
user_006994,27,100k-150k,mobile,returning,South,75,False,0,0,0,False,True,True,105,1,1,8.20113932798584,-105,-1
user_006995,29,<30k,tablet,returning,South,74,False,0,0,0,True,True,True,93,1,0,7.552250107848378,-93,-1
user_006996,31,<30k,desktop,returning,East,62,True,30,1,0,True,True,False,0,0,0,,30,1
user_006997,80,30k-50k,desktop,new,West,48,True,79,4,1,False,False,True,91,3,0,4.604364766233887,-12,1
user_006998,50,30k-50k,mobile,returning,West,38,True,74,3,0,False,True,False,0,0,0,,74,3
user_006999,44,100k-150k,desktop,returning,South,39,True,130,5,0,False,True,True,91,3,0,9.149836175709634,39,2
user_007000,32,75k-100k,mobile,returning,Midwest,62,True,86,2,0,True,True,True,78,1,0,8.346750597452264,8,1
user_007001,63,<30k,mobile,new,South,1,True,145,3,1,False,False,False,0,0,0,,145,3
user_007002,32,30k-50k,desktop,returning,South,64,True,93,1,0,True,True,True,78,1,0,10.0,15,0
user_007003,63,50k-75k,mobile,returning,Midwest,39,True,81,2,0,True,True,True,54,1,0,9.287325393182156,27,1
user_007004,56,50k-75k,desktop,new,West,52,True,146,3,1,False,False,True,159,5,0,5.924366907092898,-13,-2
user_007005,54,50k-75k,desktop,new,East,38,True,125,5,1,False,False,False,0,0,0,,125,5
user_007006,37,50k-75k,desktop,new,Midwest,26,True,158,4,0,False,False,True,170,3,0,5.921891047790145,-12,1
user_007007,74,50k-75k,mobile,new,South,11,True,156,2,1,False,False,True,151,1,0,6.201999056400871,5,1
user_007008,39,75k-100k,desktop,returning,South,64,True,87,1,0,False,False,True,72,1,0,8.706385304170858,15,0
user_007009,49,75k-100k,mobile,new,East,61,True,159,2,1,True,False,True,170,1,0,9.374294839628597,-11,1
user_007010,38,75k-100k,mobile,returning,East,55,True,124,2,0,False,True,True,111,1,0,10.0,13,1
user_007011,53,50k-75k,desktop,returning,South,42,True,34,1,1,True,True,True,20,1,0,7.883899920654299,14,0
user_007012,37,100k-150k,desktop,returning,South,54,True,145,2,0,True,True,True,151,1,0,7.829699409230088,-6,1
user_007013,28,75k-100k,desktop,new,Midwest,56,True,75,2,1,False,False,True,97,3,0,6.595404084740913,-22,-1
user_007014,45,75k-100k,desktop,returning,Midwest,41,True,119,2,0,False,False,True,115,4,0,7.528894342033323,4,-2
user_007015,35,100k-150k,desktop,new,South,43,True,80,3,0,False,True,True,65,4,0,8.582816075340636,15,-1
user_007016,56,<30k,desktop,returning,Midwest,37,True,83,6,1,False,False,False,0,0,0,,83,6
user_007017,43,50k-75k,desktop,returning,South,32,True,109,5,0,True,True,True,92,3,0,7.790420140053195,17,2
user_007018,41,50k-75k,desktop,returning,East,77,True,53,3,0,True,True,True,24,1,0,7.552548702207068,29,2
user_007019,42,30k-50k,desktop,new,West,56,True,94,2,0,False,False,False,0,0,0,,94,2
user_007020,44,50k-75k,desktop,returning,West,43,False,0,0,0,False,True,True,117,1,0,9.067099862558134,-117,-1
user_007021,32,50k-75k,mobile,new,West,98,True,99,5,0,False,True,True,111,2,0,9.929400540150631,-12,3
user_007022,49,<30k,desktop,returning,East,33,True,92,3,0,True,False,True,111,5,0,8.189804843205668,-19,-2
user_007023,53,75k-100k,mobile,returning,West,81,True,108,4,0,True,True,False,0,0,0,,108,4
user_007024,61,<30k,mobile,returning,East,4,False,0,0,0,False,True,True,77,1,0,8.357995773249938,-77,-1
user_007025,31,30k-50k,desktop,returning,South,88,True,69,4,0,True,True,True,31,4,0,7.757234456737251,38,0
user_007026,39,75k-100k,desktop,returning,West,48,True,129,2,0,True,True,True,117,2,0,7.971680634688388,12,0
user_007027,66,50k-75k,desktop,returning,West,61,False,0,0,0,True,True,False,0,0,0,,0,0
user_007028,37,100k-150k,mobile,new,Midwest,80,True,149,2,0,True,True,True,133,2,0,7.449238709467583,16,0
user_007029,33,50k-75k,desktop,returning,West,70,True,60,1,0,True,True,True,74,1,0,8.713272905962235,-14,0
user_007030,46,>150k,desktop,returning,West,72,True,30,1,1,False,True,True,33,1,0,7.083328422216934,-3,0
user_007031,41,100k-150k,mobile,returning,East,62,True,104,3,0,True,True,True,87,4,0,7.521761712122359,17,-1
user_007032,33,75k-100k,desktop,returning,West,85,True,101,2,0,True,True,True,95,3,0,7.2955984125127555,6,-1
user_007033,39,<30k,mobile,returning,Midwest,18,True,125,1,0,False,False,True,136,1,0,8.026829907887754,-11,0
user_007034,76,75k-100k,mobile,returning,South,42,True,101,2,0,True,False,True,68,3,1,6.318396637935478,33,-1
user_007035,47,75k-100k,mobile,returning,West,65,False,0,0,0,True,False,True,127,1,0,6.074434602463442,-127,-1
user_007036,63,<30k,desktop,new,South,0,False,0,0,0,False,False,True,109,1,0,6.6742903567894984,-109,-1
user_007037,67,30k-50k,desktop,new,West,64,True,138,1,0,False,False,False,0,0,0,,138,1
user_007038,47,>150k,desktop,returning,South,78,True,30,3,0,False,False,True,64,2,0,6.157205154014485,-34,1
user_007039,48,50k-75k,desktop,returning,Midwest,38,True,43,5,0,True,False,True,32,4,0,9.292195864572523,11,1
user_007040,23,30k-50k,mobile,returning,Midwest,35,False,0,0,0,False,True,True,105,2,0,10.0,-105,-2
user_007041,62,30k-50k,mobile,new,West,40,True,106,2,0,False,True,True,106,1,0,6.211906088682172,0,1
user_007042,29,<30k,mobile,returning,Midwest,76,True,70,1,0,True,True,True,39,1,0,7.451689517993736,31,0
user_007043,43,75k-100k,mobile,returning,Midwest,39,True,125,5,0,True,True,True,57,7,0,9.54706605940766,68,-2
user_007044,78,50k-75k,mobile,new,West,51,True,120,1,0,True,True,True,69,1,0,6.406239903106716,51,0
user_007045,44,<30k,desktop,returning,South,42,True,78,2,0,True,False,True,79,3,1,6.011657477939614,-1,-1
user_007046,34,50k-75k,mobile,returning,West,70,False,0,0,0,True,True,False,0,0,0,,0,0
user_007047,24,100k-150k,mobile,returning,West,100,True,82,5,0,True,True,True,65,7,0,7.494960390064973,17,-2
user_007048,67,30k-50k,tablet,new,West,53,False,0,0,0,False,True,True,135,1,0,5.252897965374666,-135,-1
user_007049,69,>150k,desktop,returning,East,73,True,30,2,0,False,True,True,20,4,0,7.722055811624988,10,-2
user_007050,32,30k-50k,desktop,new,East,53,False,0,0,0,False,True,True,96,1,0,8.315755954528983,-96,-1
user_007051,38,75k-100k,mobile,new,West,52,True,139,5,0,True,False,True,115,8,0,8.405050466386948,24,-3
user_007052,50,75k-100k,mobile,returning,Midwest,32,True,63,2,0,False,True,True,83,2,0,6.485180958234098,-20,0
user_007053,34,<30k,mobile,new,South,85,True,137,1,0,False,True,False,0,0,0,,137,1
user_007054,35,50k-75k,desktop,new,South,85,True,150,4,0,True,True,True,78,3,0,7.324218580246638,72,1
user_007055,19,50k-75k,desktop,returning,West,72,True,49,1,0,True,True,True,44,1,0,7.818820903639576,5,0
user_007056,58,>150k,mobile,new,East,25,False,0,0,0,False,False,True,112,2,1,6.589419213389544,-112,-2
user_007057,60,30k-50k,mobile,new,East,28,True,154,4,0,True,False,False,0,0,0,,154,4
user_007058,18,30k-50k,mobile,returning,South,64,True,54,3,0,True,True,True,47,1,0,7.501257072034278,7,2
user_007059,18,75k-100k,mobile,returning,South,70,True,85,1,0,False,False,True,61,2,0,7.017410256736713,24,-1
user_007060,42,<30k,tablet,returning,East,28,True,104,1,1,True,False,False,0,0,0,,104,1
user_007061,58,<30k,desktop,new,Midwest,27,True,202,8,1,True,False,True,213,11,0,4.990742177370231,-11,-3
user_007062,33,30k-50k,mobile,returning,South,68,True,103,4,0,False,True,False,0,0,0,,103,4
user_007063,68,50k-75k,desktop,returning,Midwest,28,True,84,2,1,True,False,True,105,1,0,6.033594809775973,-21,1
user_007064,34,<30k,tablet,returning,East,45,False,0,0,0,False,False,True,135,1,1,8.576914614453994,-135,-1
user_007065,44,50k-75k,mobile,new,South,18,True,124,5,0,False,False,True,130,4,0,8.278220458934204,-6,1
user_007066,52,50k-75k,desktop,returning,South,17,True,99,5,1,False,False,False,0,0,0,,99,5
user_007067,20,50k-75k,tablet,returning,East,67,True,127,5,1,False,True,False,0,0,0,,127,5
user_007068,35,75k-100k,desktop,returning,Midwest,73,True,56,3,0,True,True,True,20,1,0,10.0,36,2
user_007069,47,75k-100k,mobile,returning,West,69,True,62,6,1,True,True,True,20,5,0,9.18156033813492,42,1
user_007070,23,75k-100k,desktop,returning,West,75,True,67,4,0,False,True,True,33,5,1,7.110860565318235,34,-1
user_007071,50,100k-150k,desktop,new,West,48,True,143,3,0,False,True,True,115,2,0,6.686663943666451,28,1
user_007072,45,30k-50k,mobile,returning,East,71,True,73,2,0,False,True,True,70,2,0,8.575430444868125,3,0
user_007073,36,30k-50k,mobile,new,West,65,True,125,3,0,True,True,True,106,1,0,8.167325949029017,19,2
user_007074,47,50k-75k,desktop,returning,East,64,True,58,1,0,True,True,True,57,1,0,9.573874944511577,1,0
user_007075,47,>150k,desktop,returning,Midwest,44,True,98,3,0,False,True,True,56,2,0,6.937063914173503,42,1
user_007076,80,30k-50k,mobile,new,East,28,True,160,2,0,True,True,True,128,1,0,6.7324488003935405,32,1
user_007077,57,30k-50k,desktop,returning,Midwest,21,True,73,4,0,True,False,True,67,3,0,9.424233659064758,6,1
user_007078,41,75k-100k,desktop,new,East,45,True,130,1,0,True,False,False,0,0,0,,130,1
user_007079,64,50k-75k,desktop,returning,East,10,True,125,4,0,True,True,True,102,3,0,8.324494212843103,23,1
user_007080,60,50k-75k,desktop,new,East,14,True,156,7,0,True,False,True,160,7,0,6.823899958253328,-4,0
user_007081,50,30k-50k,mobile,returning,East,65,True,30,1,0,False,False,True,71,1,0,9.31384178263242,-41,0
user_007082,26,75k-100k,mobile,returning,South,63,True,78,9,0,True,True,True,73,12,0,8.935728919000713,5,-3
user_007083,41,>150k,mobile,returning,West,70,True,73,3,1,False,False,True,27,3,0,6.4238820529990734,46,0
user_007084,66,50k-75k,desktop,returning,Midwest,29,True,62,5,0,False,False,True,78,8,0,6.993366677711407,-16,-3
user_007085,49,100k-150k,mobile,new,East,41,True,128,3,0,False,True,True,99,1,0,9.54323877376478,29,2
user_007086,43,<30k,desktop,new,South,37,False,0,0,0,False,True,True,95,2,0,6.267346578898314,-95,-2
user_007087,36,30k-50k,mobile,returning,West,68,True,91,4,0,True,True,True,78,1,0,9.479381851331063,13,3
user_007088,51,<30k,desktop,new,Midwest,28,True,152,4,0,False,False,False,0,0,0,,152,4
user_007089,24,50k-75k,desktop,new,West,90,False,0,0,0,False,True,True,90,1,0,7.390741041429459,-90,-1
user_007090,43,50k-75k,desktop,new,South,55,True,126,3,1,False,True,True,86,2,0,6.210359598455854,40,1
user_007091,80,100k-150k,desktop,new,West,27,True,166,7,2,False,True,True,128,9,0,6.201354355540107,38,-2
user_007092,48,30k-50k,mobile,returning,Midwest,37,True,69,2,0,False,True,True,73,1,1,7.979734159230741,-4,1
user_007093,54,100k-150k,desktop,new,West,74,False,0,0,0,False,True,True,97,1,0,7.8403797083033995,-97,-1
user_007094,49,100k-150k,desktop,new,Midwest,96,True,36,1,0,True,True,True,20,2,0,8.214673981020072,16,-1
user_007095,58,75k-100k,desktop,returning,East,39,True,30,6,0,False,False,True,34,8,0,8.96309853564069,-4,-2
user_007096,46,50k-75k,desktop,returning,Midwest,43,True,95,2,0,True,False,True,60,6,0,6.178584441475939,35,-4
user_007097,37,50k-75k,desktop,returning,East,53,True,101,3,0,False,True,True,66,3,0,8.943446246679532,35,0
user_007098,35,<30k,desktop,returning,East,10,False,0,0,0,False,False,True,118,1,1,6.7350254170282255,-118,-1
user_007099,53,100k-150k,mobile,new,South,77,True,101,5,0,False,True,True,57,2,0,7.027581221120726,44,3
user_007100,69,30k-50k,desktop,returning,West,45,False,0,0,0,False,False,True,151,1,1,7.140172791830726,-151,-1
user_007101,45,30k-50k,desktop,new,East,27,True,110,2,0,False,True,True,101,2,0,8.200037762502738,9,0
user_007102,36,<30k,mobile,new,Midwest,39,True,137,1,0,True,False,True,144,1,0,7.471079807612487,-7,0
user_007103,58,>150k,desktop,returning,East,50,True,99,2,0,True,True,True,116,1,0,6.812300557290878,-17,1
user_007104,63,50k-75k,desktop,returning,West,52,True,142,6,0,False,False,True,118,8,0,8.987744155772619,24,-2
user_007105,50,>150k,mobile,new,South,75,True,73,2,0,False,False,True,58,1,0,6.141054641749781,15,1
user_007106,49,30k-50k,desktop,new,West,80,True,95,3,0,True,True,True,58,3,0,6.046440295631284,37,0
user_007107,62,30k-50k,desktop,returning,South,30,True,95,7,1,True,False,True,77,7,0,7.106522472586497,18,0
user_007108,34,30k-50k,mobile,new,West,98,True,109,1,1,True,True,True,45,2,0,7.807786343606946,64,-1
user_007109,33,30k-50k,desktop,returning,Midwest,83,True,40,2,0,True,True,True,40,1,0,7.624069290822995,0,1
user_007110,50,50k-75k,mobile,returning,Midwest,41,True,92,6,0,False,False,True,65,9,0,8.119737613224318,27,-3
user_007111,46,50k-75k,desktop,new,South,53,False,0,0,0,False,True,True,109,1,0,7.327185598940125,-109,-1
user_007112,53,50k-75k,mobile,new,Midwest,34,False,0,0,0,True,True,True,108,1,0,7.7739087046243975,-108,-1
user_007113,31,30k-50k,mobile,returning,South,76,True,90,2,1,False,True,True,32,2,1,8.150427683878673,58,0
user_007114,57,30k-50k,desktop,returning,Midwest,19,True,172,4,0,True,False,True,162,6,0,7.019897475619497,10,-2
user_007115,40,50k-75k,mobile,new,West,59,True,165,5,0,False,False,True,181,3,1,7.3870506978830806,-16,2
user_007116,44,50k-75k,desktop,returning,West,32,True,108,5,0,True,True,True,95,2,0,7.844299944258687,13,3
user_007117,34,30k-50k,mobile,returning,Midwest,75,True,66,1,0,False,True,True,38,1,0,9.061626573825738,28,0
user_007118,60,75k-100k,desktop,returning,South,47,True,81,1,0,False,False,True,40,1,0,5.784973438703077,41,0
user_007119,41,<30k,desktop,returning,East,38,False,0,0,0,False,False,False,0,0,0,,0,0
user_007120,38,<30k,desktop,new,South,49,True,191,1,0,False,False,True,221,1,0,7.019222025202433,-30,0
user_007121,55,50k-75k,mobile,new,West,58,True,79,5,0,False,False,True,96,7,0,6.412198673001054,-17,-2
user_007122,24,100k-150k,desktop,returning,South,80,True,47,1,0,True,True,True,70,1,0,8.190171442814282,-23,0
user_007123,37,75k-100k,desktop,new,East,45,True,123,1,0,False,False,True,97,1,0,7.18654751405482,26,0
user_007124,23,30k-50k,mobile,returning,South,70,False,0,0,0,False,True,False,0,0,0,,0,0
user_007125,36,<30k,mobile,returning,West,30,True,47,3,0,True,True,False,0,0,0,,47,3
user_007126,47,75k-100k,desktop,returning,East,28,True,151,2,0,False,False,True,125,1,0,6.632834725652995,26,1
user_007127,25,50k-75k,desktop,returning,South,57,True,75,4,0,True,True,True,30,3,0,7.683591023487736,45,1
user_007128,34,100k-150k,mobile,returning,South,100,True,30,5,0,True,True,True,37,6,0,8.899807191487687,-7,-1
user_007129,50,75k-100k,mobile,returning,East,33,True,61,5,0,False,False,True,56,6,0,7.200807695961906,5,-1
user_007130,36,50k-75k,desktop,returning,West,78,True,108,1,0,False,True,True,97,1,0,8.465991923869051,11,0
user_007131,67,75k-100k,desktop,new,Midwest,28,True,162,2,2,False,False,True,180,3,0,8.306581223224743,-18,-1
user_007132,31,75k-100k,desktop,new,Midwest,98,True,148,4,0,True,False,True,173,5,1,10.0,-25,-1
user_007133,45,50k-75k,mobile,new,West,60,True,140,3,0,False,True,True,95,1,0,8.620666513156245,45,2
user_007134,40,100k-150k,mobile,returning,South,59,True,132,1,0,True,False,True,140,1,0,8.166071262403555,-8,0
user_007135,42,30k-50k,mobile,returning,Midwest,11,False,0,0,0,False,True,True,65,1,0,6.247462603934052,-65,-1
user_007136,38,100k-150k,mobile,returning,East,64,True,102,4,0,True,True,True,45,7,0,5.000829045054796,57,-3
user_007137,66,100k-150k,mobile,new,East,62,True,161,3,0,True,True,True,119,2,0,7.933820156800136,42,1
user_007138,52,<30k,mobile,returning,Midwest,49,True,83,3,0,False,False,True,97,6,0,6.946155215103833,-14,-3
user_007139,40,75k-100k,mobile,returning,South,26,True,115,2,0,True,True,True,129,1,0,9.660579108568916,-14,1
user_007140,37,75k-100k,desktop,returning,East,44,True,130,3,0,False,False,True,165,6,0,6.72467639029158,-35,-3
user_007141,54,<30k,mobile,new,West,61,True,63,2,1,False,True,True,27,3,0,9.450283733145627,36,-1
user_007142,39,<30k,desktop,returning,West,53,True,99,3,0,False,False,True,76,2,0,7.352118383736024,23,1
user_007143,63,30k-50k,mobile,returning,Midwest,24,True,132,8,0,True,False,True,100,7,0,6.958428598334594,32,1
user_007144,53,30k-50k,desktop,returning,Midwest,62,True,64,4,0,False,False,True,63,2,0,7.3925335085128,1,2
user_007145,42,100k-150k,desktop,new,West,74,True,154,5,0,True,True,True,131,5,0,6.590816464421433,23,0
user_007146,43,30k-50k,desktop,returning,West,76,True,119,6,0,False,True,True,91,4,0,7.844833998631527,28,2
user_007147,48,>150k,desktop,returning,West,74,True,69,2,0,True,True,True,54,2,0,7.245746577349281,15,0
user_007148,48,<30k,desktop,new,East,53,True,120,2,0,False,True,False,0,0,0,,120,2
user_007149,44,75k-100k,desktop,returning,South,67,True,73,2,0,True,False,True,31,3,0,7.662259901109544,42,-1
user_007150,39,30k-50k,mobile,new,East,43,True,162,2,0,False,True,True,161,1,0,7.282011197228725,1,1
user_007151,63,<30k,desktop,new,Midwest,2,True,120,6,0,False,False,False,0,0,0,,120,6
user_007152,42,100k-150k,mobile,returning,Midwest,54,True,158,6,0,True,True,True,146,3,0,7.511810928984293,12,3
user_007153,55,100k-150k,desktop,new,South,72,True,143,1,0,True,True,True,116,1,0,7.156951737384321,27,0
user_007154,39,100k-150k,desktop,new,Midwest,65,True,101,4,0,False,True,True,97,1,0,9.204486435169388,4,3
user_007155,50,30k-50k,mobile,new,West,65,True,132,1,1,True,True,True,88,1,1,7.098969739938878,44,0
user_007156,33,30k-50k,desktop,returning,East,57,True,119,4,0,False,True,True,68,6,0,6.883460187548156,51,-2
user_007157,48,75k-100k,mobile,new,West,65,True,121,3,0,True,True,True,118,1,0,8.546261970762888,3,2
user_007158,28,50k-75k,desktop,new,Midwest,47,True,149,3,0,True,False,True,168,3,0,4.853152691910587,-19,0
user_007159,64,100k-150k,desktop,new,West,49,True,121,1,0,True,False,True,115,3,0,8.541677678169973,6,-2
user_007160,61,<30k,desktop,returning,West,44,True,132,3,0,True,True,True,82,4,0,7.705755327604603,50,-1
user_007161,18,50k-75k,mobile,returning,West,93,True,52,3,0,False,True,True,25,4,0,10.0,27,-1
user_007162,44,50k-75k,desktop,returning,West,53,True,53,1,1,True,True,True,57,1,0,6.682266503902513,-4,0
user_007163,64,50k-75k,mobile,returning,East,15,True,63,5,0,False,True,True,39,5,0,6.900032920435077,24,0
user_007164,55,>150k,desktop,returning,West,93,True,66,4,0,True,False,True,84,2,0,6.572686405705582,-18,2
user_007165,48,75k-100k,desktop,new,East,43,True,123,2,0,False,False,True,129,1,0,8.015285491527557,-6,1
user_007166,41,100k-150k,mobile,returning,Midwest,53,True,92,1,0,True,True,True,68,1,0,7.920875505955395,24,0
user_007167,56,50k-75k,desktop,returning,West,46,True,118,2,0,False,True,True,92,1,0,7.435361364154768,26,1
user_007168,64,<30k,desktop,returning,South,42,True,68,5,1,True,True,True,62,2,0,7.538266049314397,6,3
user_007169,33,75k-100k,mobile,returning,East,68,True,57,4,0,True,True,True,20,4,0,8.36571433029221,37,0
user_007170,53,30k-50k,mobile,returning,South,52,True,154,1,0,False,True,True,93,1,0,7.776583685219932,61,0
user_007171,44,30k-50k,mobile,new,West,62,False,0,0,0,True,True,False,0,0,0,,0,0
user_007172,41,75k-100k,desktop,returning,Midwest,31,True,54,1,0,False,True,True,46,1,0,8.361262100630546,8,0
user_007173,62,>150k,mobile,returning,South,66,True,97,1,0,True,True,True,84,1,0,7.765932670639198,13,0
user_007174,45,100k-150k,mobile,returning,South,55,True,106,1,0,False,True,True,87,1,0,5.291557806146386,19,0
user_007175,48,30k-50k,mobile,returning,Midwest,55,False,0,0,0,True,True,True,79,1,0,6.3116204513262035,-79,-1
user_007176,40,100k-150k,mobile,new,South,66,True,111,2,0,True,True,True,57,1,0,8.63532592503103,54,1
user_007177,31,75k-100k,mobile,returning,South,76,True,54,1,1,True,True,True,20,1,0,9.380392105428381,34,0
user_007178,54,30k-50k,mobile,returning,East,40,True,57,6,0,True,True,True,30,7,0,6.772339573042649,27,-1
user_007179,72,50k-75k,mobile,returning,South,28,True,148,4,0,False,False,True,180,2,0,5.999074540791208,-32,2
user_007180,42,50k-75k,mobile,returning,South,39,True,135,2,0,False,False,True,82,3,0,7.859066023231523,53,-1
user_007181,52,50k-75k,mobile,returning,West,78,True,63,4,0,False,True,True,63,4,0,9.786109559673143,0,0
user_007182,32,30k-50k,mobile,new,East,91,True,127,4,0,True,True,True,105,4,0,9.306344585157927,22,0
user_007183,32,75k-100k,desktop,new,East,85,True,112,2,2,False,True,True,70,1,0,5.78770592146609,42,1
user_007184,65,75k-100k,mobile,new,East,26,True,133,4,0,False,False,True,123,7,0,7.182654263768272,10,-3
user_007185,60,50k-75k,mobile,returning,East,26,True,102,4,1,False,False,True,130,4,1,9.157786293317287,-28,0
user_007186,47,30k-50k,desktop,new,East,38,True,117,1,0,False,True,True,114,1,0,7.9235270188965625,3,0
user_007187,45,30k-50k,desktop,returning,East,38,True,72,3,0,True,False,True,52,2,0,9.518245722192688,20,1
user_007188,26,<30k,mobile,returning,Midwest,55,True,93,4,0,True,True,True,104,6,0,6.804939368059216,-11,-2
user_007189,56,100k-150k,desktop,new,South,74,False,0,0,0,False,True,True,121,1,1,7.20230950793205,-121,-1
user_007190,31,30k-50k,mobile,returning,East,83,True,55,2,2,False,True,True,56,1,0,8.071100224714291,-1,1
user_007191,58,75k-100k,mobile,returning,East,42,True,155,3,0,False,False,True,149,3,0,6.970072542310695,6,0
user_007192,68,75k-100k,mobile,new,East,29,True,150,2,0,False,False,True,161,1,0,9.761553636369278,-11,1
user_007193,67,<30k,desktop,new,West,33,True,117,5,0,False,False,False,0,0,0,,117,5
user_007194,40,30k-50k,desktop,returning,South,31,True,93,2,0,False,True,True,98,1,0,8.067156434692187,-5,1
user_007195,27,50k-75k,desktop,new,Midwest,43,True,45,4,0,True,True,True,65,2,0,7.464868316944052,-20,2
user_007196,48,<30k,desktop,returning,South,39,True,61,7,0,True,False,True,64,7,0,9.677948091668782,-3,0
user_007197,55,30k-50k,mobile,returning,South,58,True,76,3,0,True,True,True,76,1,0,8.972404184205683,0,2
user_007198,56,30k-50k,desktop,new,East,5,True,91,1,0,True,False,True,57,1,0,7.458625862975331,34,0
user_007199,56,50k-75k,desktop,returning,East,17,False,0,0,0,False,False,True,94,1,0,6.790391961472556,-94,-1
user_007200,43,75k-100k,desktop,returning,East,40,True,127,2,0,True,True,True,110,2,0,7.400454165237733,17,0
user_007201,59,<30k,desktop,returning,West,36,True,97,7,0,False,False,True,109,13,0,6.0544467094540035,-12,-6
user_007202,39,30k-50k,tablet,returning,South,63,True,76,2,0,False,False,False,0,0,0,,76,2
user_007203,52,50k-75k,tablet,returning,West,48,True,114,1,0,False,True,True,100,2,0,6.092874677624661,14,-1
user_007204,27,50k-75k,mobile,returning,East,73,False,0,0,0,True,True,True,80,1,0,7.530822294654014,-80,-1
user_007205,31,30k-50k,mobile,returning,South,78,True,122,1,0,True,True,True,128,1,0,7.9658838020918115,-6,0
user_007206,57,100k-150k,mobile,new,South,29,True,188,7,0,False,False,True,188,2,0,5.993412568568077,0,5
user_007207,44,<30k,mobile,returning,West,42,True,65,6,0,True,False,True,70,9,0,10.0,-5,-3
user_007208,39,30k-50k,desktop,returning,Midwest,17,True,85,4,0,True,False,True,75,7,0,7.331217647116189,10,-3
user_007209,70,75k-100k,mobile,new,South,10,True,156,1,0,False,True,True,152,1,0,7.622606119311939,4,0
user_007210,65,<30k,desktop,new,South,0,False,0,0,0,False,False,True,173,1,1,6.042484114814522,-173,-1
user_007211,67,100k-150k,mobile,new,South,32,True,165,4,0,False,True,True,159,6,0,9.067639033131037,6,-2
user_007212,39,<30k,desktop,new,Midwest,5,True,163,2,1,True,True,True,128,2,0,9.321437477945771,35,0
user_007213,29,30k-50k,desktop,new,East,77,True,82,2,0,True,False,True,89,3,0,5.197011755031243,-7,-1
user_007214,35,100k-150k,desktop,returning,West,89,True,77,3,0,True,True,True,65,6,0,9.322213435185624,12,-3
user_007215,51,<30k,mobile,returning,South,25,True,139,2,1,False,False,True,176,3,0,7.784188239011001,-37,-1
user_007216,24,75k-100k,desktop,returning,East,94,True,49,3,0,True,True,True,30,2,0,9.484409123828314,19,1
user_007217,28,<30k,desktop,returning,East,42,True,96,1,0,False,False,False,0,0,0,,96,1
user_007218,32,75k-100k,desktop,returning,South,77,True,69,2,0,True,True,True,61,1,0,6.874784247387332,8,1
user_007219,46,<30k,desktop,new,South,50,True,133,3,0,True,True,True,130,2,0,6.500968953229861,3,1
user_007220,39,50k-75k,desktop,returning,South,46,False,0,0,0,True,False,True,120,2,0,7.15421477843314,-120,-2
user_007221,42,30k-50k,desktop,new,West,52,True,162,3,0,True,True,True,123,3,0,7.823299600447501,39,0
user_007222,65,30k-50k,desktop,returning,South,56,False,0,0,0,True,True,True,78,1,0,8.60701355617016,-78,-1
user_007223,80,50k-75k,desktop,new,Midwest,39,True,159,4,0,True,False,True,172,3,0,7.250001531127126,-13,1
user_007224,34,50k-75k,desktop,returning,East,64,True,105,4,0,True,True,True,99,6,0,5.8740002345999365,6,-2
user_007225,18,30k-50k,mobile,returning,South,61,False,0,0,0,False,True,True,122,1,0,8.642775454775517,-122,-1
user_007226,53,75k-100k,mobile,returning,West,57,True,96,2,0,False,False,True,128,4,0,6.714384921009365,-32,-2
user_007227,54,<30k,mobile,new,East,34,True,135,5,0,True,True,True,116,4,0,7.713239316132802,19,1
user_007228,32,100k-150k,desktop,returning,South,99,True,113,3,0,False,True,True,56,1,0,8.157254038198266,57,2
user_007229,49,<30k,desktop,returning,West,50,True,135,1,0,True,True,True,75,2,0,6.096516511842411,60,-1
user_007230,33,30k-50k,mobile,returning,West,77,True,68,3,0,True,True,True,54,1,0,7.670669445567929,14,2
user_007231,57,<30k,mobile,returning,East,42,True,123,3,0,False,True,True,21,3,0,8.499581381163999,102,0
user_007232,57,50k-75k,tablet,returning,South,15,True,89,2,0,True,False,True,96,3,0,7.305516356777419,-7,-1
user_007233,25,50k-75k,desktop,returning,East,61,True,112,4,0,False,True,True,87,5,0,7.175171525754201,25,-1
user_007234,56,30k-50k,desktop,returning,West,38,True,76,8,0,True,False,True,73,9,0,8.437420369511825,3,-1
user_007235,43,30k-50k,tablet,new,East,61,True,108,3,0,False,False,True,108,2,0,5.3652391062314075,0,1
user_007236,43,75k-100k,tablet,returning,West,76,True,51,5,0,False,True,True,58,4,0,9.520150235867604,-7,1
user_007237,27,>150k,desktop,new,East,80,True,88,1,0,True,True,True,92,1,0,6.422704353816285,-4,0
user_007238,63,75k-100k,tablet,returning,Midwest,0,True,153,7,0,False,False,True,155,8,1,6.2443429673049895,-2,-1
user_007239,45,50k-75k,desktop,returning,Midwest,28,False,0,0,0,False,False,True,103,1,0,8.691612871172666,-103,-1
user_007240,30,100k-150k,desktop,returning,Midwest,76,True,75,4,0,True,True,True,55,4,1,8.87949690030366,20,0
user_007241,43,100k-150k,desktop,returning,West,95,True,56,2,0,True,True,True,22,2,1,9.289846923888767,34,0
user_007242,34,<30k,mobile,new,Midwest,49,False,0,0,0,False,True,True,113,1,0,9.30741097426169,-113,-1
user_007243,28,100k-150k,tablet,new,West,99,True,148,3,0,True,True,True,123,3,0,8.862278514929892,25,0
user_007244,52,30k-50k,mobile,returning,South,57,True,123,4,0,True,True,True,121,6,0,9.128418187103062,2,-2
user_007245,37,75k-100k,desktop,returning,Midwest,49,False,0,0,0,True,False,True,117,2,0,7.1139600121789055,-117,-2
user_007246,19,30k-50k,tablet,new,East,60,False,0,0,0,False,True,True,95,1,0,6.412965616354331,-95,-1
user_007247,33,<30k,mobile,returning,West,74,True,126,1,0,True,True,False,0,0,0,,126,1
user_007248,39,<30k,desktop,returning,Midwest,39,True,100,4,1,False,False,True,87,8,0,6.355403869301558,13,-4
user_007249,20,100k-150k,desktop,returning,Midwest,70,False,0,0,0,False,True,True,87,4,0,8.219492748550696,-87,-4
user_007250,56,75k-100k,desktop,new,East,5,True,161,1,0,True,False,True,170,1,0,6.411245080940448,-9,0
user_007251,37,<30k,desktop,returning,South,42,True,147,1,0,False,True,True,128,2,0,9.238005676216162,19,-1
user_007252,44,<30k,desktop,returning,West,61,False,0,0,0,True,False,True,101,1,0,6.563511953777251,-101,-1
user_007253,24,30k-50k,desktop,returning,West,63,True,116,1,0,True,True,True,64,1,0,7.621701889472969,52,0
user_007254,64,100k-150k,desktop,returning,Midwest,15,True,151,3,2,False,True,True,126,5,0,8.050313266633994,25,-2
user_007255,48,>150k,desktop,returning,Midwest,55,True,58,6,0,True,True,False,0,0,0,,58,6
user_007256,50,30k-50k,desktop,returning,South,40,True,80,3,0,True,False,True,41,2,0,6.592640738771072,39,1
user_007257,68,100k-150k,mobile,returning,East,29,True,119,4,1,False,False,True,118,5,0,7.0420687930345744,1,-1
user_007258,44,50k-75k,mobile,returning,West,69,False,0,0,0,False,True,False,0,0,0,,0,0
user_007259,33,30k-50k,mobile,returning,West,77,True,81,1,0,True,True,True,72,1,0,8.751598498869964,9,0
user_007260,45,<30k,desktop,returning,West,44,True,99,2,0,False,True,True,89,1,0,6.361981552333081,10,1
user_007261,58,30k-50k,desktop,new,East,69,False,0,0,0,False,True,True,96,2,0,6.865409233079848,-96,-2
user_007262,34,50k-75k,mobile,returning,West,83,True,61,4,0,False,True,True,66,3,0,8.653351430825515,-5,1
user_007263,49,75k-100k,mobile,new,Midwest,18,True,137,5,0,False,False,True,145,1,0,7.979645332865968,-8,4
user_007264,41,<30k,mobile,returning,West,45,True,170,2,0,False,True,True,152,1,0,10.0,18,1
user_007265,48,<30k,mobile,new,West,53,False,0,0,0,False,False,True,99,4,1,6.634066098022923,-99,-4
user_007266,61,<30k,mobile,new,Midwest,42,False,0,0,0,False,True,True,103,1,0,6.322305131536479,-103,-1
user_007267,44,50k-75k,mobile,returning,East,50,True,132,2,0,False,False,True,120,1,0,7.426476274675772,12,1
user_007268,58,30k-50k,desktop,returning,Midwest,26,True,152,2,2,False,False,False,0,0,0,,152,2
user_007269,46,100k-150k,mobile,new,Midwest,67,True,157,3,0,False,False,False,0,0,0,,157,3
user_007270,43,>150k,mobile,returning,West,41,True,160,4,0,True,True,True,141,4,0,9.966246481300585,19,0
user_007271,41,75k-100k,mobile,returning,South,47,True,149,3,0,False,False,True,169,3,0,9.420155408282737,-20,0
user_007272,51,<30k,desktop,returning,West,82,True,81,3,0,False,True,True,46,1,0,6.850411604229443,35,2
user_007273,47,75k-100k,mobile,returning,West,58,True,77,2,0,False,False,True,41,2,0,8.465133686748882,36,0
user_007274,58,30k-50k,tablet,new,East,22,True,191,6,0,False,False,True,172,4,0,4.8958159306258615,19,2
user_007275,65,100k-150k,desktop,returning,West,74,True,30,1,0,True,True,True,20,2,0,8.992328824842007,10,-1
user_007276,33,30k-50k,desktop,returning,South,47,True,100,8,0,False,True,True,79,5,0,8.515478114468946,21,3
user_007277,34,50k-75k,mobile,returning,West,97,True,36,3,0,True,True,True,27,6,0,9.677567772391187,9,-3
user_007278,61,50k-75k,mobile,new,East,45,True,102,5,0,False,True,True,45,4,0,7.033437008078088,57,1
user_007279,33,<30k,mobile,returning,South,43,True,127,6,0,False,False,True,116,4,0,7.385306345986271,11,2
user_007280,51,<30k,mobile,new,Midwest,58,False,0,0,0,True,True,True,102,1,0,8.41487249130859,-102,-1
user_007281,37,100k-150k,desktop,returning,Midwest,76,True,116,1,0,True,True,True,89,1,0,9.11736898576637,27,0
user_007282,39,30k-50k,desktop,returning,West,73,True,30,2,0,True,True,True,52,1,1,7.268881474691856,-22,1
user_007283,39,30k-50k,desktop,returning,East,48,True,92,3,0,True,False,True,94,2,0,6.900510689553542,-2,1
user_007284,44,100k-150k,desktop,returning,South,88,True,70,1,0,False,False,True,96,1,0,8.417488186945233,-26,0
user_007285,39,50k-75k,mobile,new,Midwest,39,True,177,2,1,False,False,True,208,3,0,7.809441085803615,-31,-1
user_007286,59,<30k,desktop,returning,South,30,True,66,4,0,False,False,True,101,4,0,7.5933564772922875,-35,0
user_007287,28,50k-75k,mobile,returning,West,86,True,30,3,0,True,True,True,20,1,0,7.900305931395476,10,2
user_007288,44,75k-100k,mobile,new,South,30,True,103,1,0,False,False,True,163,1,1,6.266214801666469,-60,0
user_007289,49,<30k,mobile,returning,Midwest,31,True,74,3,0,True,False,False,0,0,0,,74,3
user_007290,34,75k-100k,mobile,new,South,71,True,91,2,0,False,True,False,0,0,0,,91,2
user_007291,34,30k-50k,mobile,new,East,83,True,113,2,0,False,True,True,107,1,0,6.512676894538996,6,1
user_007292,48,<30k,mobile,returning,East,54,True,83,3,0,False,True,True,62,4,0,9.094552119811407,21,-1
user_007293,52,<30k,desktop,returning,East,32,True,82,4,0,True,False,False,0,0,0,,82,4
user_007294,53,30k-50k,desktop,new,East,35,True,130,5,1,False,True,True,115,2,0,7.164911939546015,15,3
user_007295,48,>150k,mobile,new,East,70,True,72,3,0,False,True,True,65,2,0,7.491744028097051,7,1
user_007296,22,30k-50k,tablet,returning,West,100,True,91,7,0,True,True,True,86,1,0,7.8846392762273325,5,6
user_007297,27,100k-150k,mobile,returning,South,92,True,51,1,0,True,True,True,59,1,0,6.645092015166006,-8,0
user_007298,31,>150k,desktop,returning,West,92,True,90,3,0,True,True,True,94,2,0,9.64012918602368,-4,1
user_007299,48,<30k,mobile,returning,Midwest,33,True,86,2,0,True,True,False,0,0,0,,86,2
user_007300,62,75k-100k,desktop,returning,South,11,True,140,2,0,True,False,True,163,1,0,6.458468684860867,-23,1
user_007301,48,100k-150k,mobile,returning,East,79,True,57,4,0,False,True,False,0,0,0,,57,4
user_007302,48,75k-100k,desktop,returning,East,33,True,92,1,1,False,False,True,95,1,0,7.613660056261989,-3,0
user_007303,48,50k-75k,mobile,returning,East,70,True,70,6,0,True,False,False,0,0,0,,70,6
user_007304,18,100k-150k,desktop,returning,East,98,True,126,5,0,True,True,True,82,3,0,7.435191654602079,44,2
user_007305,49,50k-75k,desktop,new,West,78,True,132,1,0,True,False,False,0,0,0,,132,1
user_007306,39,30k-50k,mobile,returning,Midwest,62,True,112,1,0,True,True,True,94,1,0,7.266965980834131,18,0
user_007307,61,75k-100k,desktop,returning,East,9,True,123,5,0,True,True,True,93,7,0,6.608118232562116,30,-2
user_007308,62,100k-150k,desktop,returning,South,41,True,91,2,0,True,False,True,117,1,0,6.481102728892678,-26,1
user_007309,42,100k-150k,desktop,returning,East,44,True,113,3,0,False,False,True,147,4,0,8.494752315667125,-34,-1
user_007310,18,100k-150k,desktop,new,West,100,True,82,3,0,True,True,True,68,1,0,7.67821040871202,14,2
user_007311,34,<30k,desktop,new,Midwest,76,True,152,2,0,False,False,False,0,0,0,,152,2
user_007312,37,75k-100k,mobile,returning,South,51,True,109,2,1,False,True,True,84,4,0,9.528641252524032,25,-2
user_007313,18,<30k,desktop,new,South,41,True,82,2,0,False,True,True,54,1,0,8.925537427638385,28,1
user_007314,29,<30k,tablet,returning,West,45,True,98,2,0,False,True,True,61,2,1,6.831244867659473,37,0
user_007315,50,30k-50k,desktop,returning,South,52,True,116,4,0,True,True,True,117,3,0,8.138624990856998,-1,1
user_007316,48,75k-100k,desktop,returning,West,92,True,110,4,0,False,True,True,102,4,0,8.444398668948626,8,0
user_007317,43,>150k,desktop,new,East,65,False,0,0,0,True,True,True,79,1,0,9.202241580798272,-79,-1
user_007318,47,<30k,desktop,returning,South,44,True,43,2,0,False,False,True,35,1,0,7.266215580071683,8,1
user_007319,55,100k-150k,mobile,new,South,46,True,166,3,0,True,True,True,138,2,0,8.543483866215906,28,1
user_007320,70,75k-100k,mobile,new,East,20,False,0,0,0,False,False,True,107,1,0,6.928991820591347,-107,-1
user_007321,48,30k-50k,mobile,returning,East,51,True,150,1,0,True,True,True,87,1,0,7.308462209688691,63,0
user_007322,48,<30k,desktop,returning,Midwest,51,True,84,1,1,False,False,True,81,1,0,7.633055194868422,3,0
user_007323,18,<30k,mobile,returning,West,96,False,0,0,0,False,False,False,0,0,0,,0,0
user_007324,25,30k-50k,desktop,returning,Midwest,56,False,0,0,0,False,True,True,74,1,0,7.795047019346754,-74,-1
user_007325,58,50k-75k,desktop,returning,South,37,True,84,6,0,True,True,True,84,7,0,9.200406187666239,0,-1
user_007326,26,30k-50k,desktop,returning,South,47,True,86,2,0,True,True,False,0,0,0,,86,2
user_007327,49,75k-100k,desktop,returning,East,60,True,111,1,0,True,True,True,72,1,0,6.167652442751076,39,0
user_007328,47,50k-75k,mobile,returning,East,39,True,94,5,0,True,False,True,111,7,0,7.369230803562137,-17,-2
user_007329,39,30k-50k,mobile,returning,Midwest,41,True,162,4,0,True,True,True,168,1,0,7.863066796445737,-6,3
user_007330,26,50k-75k,mobile,returning,South,78,True,92,1,0,True,True,True,111,1,0,9.870670417462806,-19,0
user_007331,49,30k-50k,mobile,new,East,63,True,129,4,1,True,True,True,147,2,0,8.280716892489744,-18,2
user_007332,34,<30k,desktop,new,West,42,False,0,0,0,True,False,False,0,0,0,,0,0
user_007333,26,50k-75k,mobile,new,South,56,True,123,1,0,False,True,True,97,1,0,8.703060462147393,26,0
user_007334,69,50k-75k,mobile,returning,West,66,True,140,2,0,True,True,True,105,2,0,5.274053801882449,35,0
user_007335,47,100k-150k,mobile,returning,South,70,True,98,5,0,True,True,True,75,4,0,6.870287085236099,23,1
user_007336,58,30k-50k,desktop,returning,Midwest,53,True,71,3,0,True,True,True,71,1,0,8.382609688253964,0,2
user_007337,48,50k-75k,mobile,new,South,60,True,84,1,0,True,True,True,62,1,0,8.905527543558534,22,0
user_007338,28,30k-50k,mobile,new,West,72,True,82,3,0,True,True,True,89,3,0,8.501758067162696,-7,0
user_007339,48,30k-50k,desktop,returning,West,59,True,113,3,0,False,False,True,121,8,0,7.068018558053459,-8,-5
user_007340,42,100k-150k,mobile,new,West,56,True,125,1,0,False,True,True,127,1,0,6.76234040579902,-2,0
user_007341,55,30k-50k,desktop,new,Midwest,20,True,126,1,0,False,False,True,113,1,0,9.668298934652622,13,0
user_007342,51,75k-100k,desktop,new,East,27,True,136,1,1,True,False,True,139,1,0,5.818680603592608,-3,0
user_007343,33,<30k,desktop,new,East,85,True,97,4,0,True,True,True,75,6,0,6.929539661940571,22,-2
user_007344,59,30k-50k,desktop,returning,East,14,True,172,1,0,False,False,True,147,1,0,4.454493932833277,25,0
user_007345,18,>150k,mobile,returning,South,73,True,82,2,0,True,True,True,50,1,0,8.787709985916177,32,1
user_007346,35,75k-100k,mobile,returning,East,41,True,59,1,1,True,True,True,79,1,0,7.6167209967811775,-20,0
user_007347,49,75k-100k,tablet,returning,West,86,True,41,2,0,False,False,True,60,1,0,7.39104099817904,-19,1
user_007348,37,75k-100k,desktop,returning,West,44,True,161,1,0,False,True,True,143,1,0,8.478071708774236,18,0
user_007349,55,50k-75k,desktop,returning,South,31,True,149,6,0,False,True,True,71,3,0,9.764756472456341,78,3
user_007350,52,50k-75k,desktop,new,West,71,True,92,2,0,False,True,True,69,2,0,8.372969658797377,23,0
user_007351,59,100k-150k,mobile,returning,Midwest,72,True,30,1,0,False,True,True,20,1,0,6.2419746427360145,10,0
user_007352,35,75k-100k,mobile,new,East,56,True,47,1,0,False,True,True,23,1,1,8.326775371554993,24,0
user_007353,32,30k-50k,desktop,new,West,51,True,151,2,0,False,True,True,101,1,0,9.07704335536749,50,1
user_007354,24,50k-75k,mobile,returning,Midwest,44,True,118,1,0,False,False,True,87,1,0,6.679419207340682,31,0
user_007355,60,50k-75k,mobile,returning,West,55,False,0,0,0,False,False,True,123,2,0,7.13902094257476,-123,-2
user_007356,44,100k-150k,mobile,returning,West,96,True,45,3,0,True,True,True,59,7,0,6.542122956568415,-14,-4
user_007357,21,30k-50k,desktop,new,West,76,True,154,5,0,False,True,True,114,1,0,9.569069918852458,40,4
user_007358,20,>150k,mobile,returning,South,61,True,60,5,0,True,False,True,66,4,0,6.373538115602159,-6,1
user_007359,54,30k-50k,desktop,returning,West,56,True,62,2,0,False,True,False,0,0,0,,62,2
user_007360,51,50k-75k,desktop,returning,South,50,True,56,1,0,False,False,True,63,3,0,6.948878009783131,-7,-2
user_007361,41,50k-75k,mobile,new,West,61,True,95,1,0,True,True,True,80,1,0,9.346879094375646,15,0
user_007362,18,100k-150k,mobile,returning,West,100,True,65,4,0,True,True,True,34,1,0,9.765462337256912,31,3
user_007363,58,<30k,desktop,returning,West,19,True,177,4,0,True,True,True,117,4,0,6.320570483151752,60,0
user_007364,32,100k-150k,mobile,new,West,64,True,83,2,0,True,True,True,86,1,0,9.030801662161787,-3,1
user_007365,35,50k-75k,mobile,returning,West,40,False,0,0,0,True,True,True,111,1,0,8.369279723509338,-111,-1
user_007366,18,<30k,desktop,new,South,15,True,145,2,0,True,True,True,87,1,0,8.535815059488463,58,1
user_007367,21,75k-100k,mobile,new,East,41,True,181,2,0,False,True,True,192,4,1,7.655905343419422,-11,-2
user_007368,50,75k-100k,mobile,returning,West,56,True,89,6,0,True,True,True,63,5,0,7.338252875749989,26,1
user_007369,39,<30k,tablet,new,West,26,False,0,0,0,False,False,True,112,2,0,5.160522443078695,-112,-2
user_007370,49,50k-75k,mobile,new,West,57,True,112,1,0,False,False,True,121,1,0,5.057496963843511,-9,0
user_007371,64,50k-75k,desktop,new,West,48,False,0,0,0,False,False,True,131,2,0,6.786832713724421,-131,-2
user_007372,26,100k-150k,desktop,new,West,100,True,104,6,0,True,True,False,0,0,0,,104,6
user_007373,33,100k-150k,desktop,returning,Midwest,94,True,72,1,1,False,True,True,33,1,0,6.4898076991961124,39,0
user_007374,57,50k-75k,mobile,returning,East,48,True,153,1,0,False,True,True,133,1,1,8.938765151912877,20,0
user_007375,43,75k-100k,mobile,returning,West,81,True,72,1,0,True,True,True,33,1,0,7.1812824457130855,39,0
user_007376,32,100k-150k,desktop,returning,East,97,True,45,2,0,True,True,False,0,0,0,,45,2
user_007377,57,75k-100k,mobile,returning,East,25,True,146,3,1,True,True,True,111,1,0,6.31545102282326,35,2
user_007378,31,100k-150k,desktop,returning,West,79,True,44,2,1,True,True,True,45,2,0,5.431947717346188,-1,0
user_007379,53,30k-50k,mobile,returning,East,24,True,115,3,0,False,False,True,102,3,1,7.863850757769195,13,0
user_007380,57,30k-50k,mobile,new,South,23,True,138,2,1,True,True,False,0,0,0,,138,2
user_007381,41,50k-75k,mobile,new,Midwest,31,True,152,4,0,False,False,True,148,1,0,7.878017614897059,4,3
user_007382,41,50k-75k,desktop,returning,West,70,True,44,1,0,False,True,True,33,1,0,6.201812939940706,11,0
user_007383,39,75k-100k,desktop,new,West,64,True,121,1,0,False,False,True,98,2,1,8.56114835644149,23,-1
user_007384,31,75k-100k,desktop,new,East,78,True,142,3,0,True,True,True,87,1,0,8.68068869653249,55,2
user_007385,63,100k-150k,desktop,new,South,29,True,156,2,1,True,True,True,127,4,0,10.0,29,-2
user_007386,20,75k-100k,mobile,returning,East,79,True,72,3,0,True,True,True,20,5,0,7.335843577264478,52,-2
user_007387,61,>150k,desktop,new,Midwest,42,True,105,3,0,False,False,True,105,1,0,7.09809573056721,0,2
user_007388,26,30k-50k,mobile,new,South,55,True,123,4,0,False,True,True,59,2,0,7.98721637580333,64,2
user_007389,45,50k-75k,mobile,new,Midwest,32,True,104,7,0,True,False,True,122,9,0,8.197816978882074,-18,-2
user_007390,41,50k-75k,desktop,new,Midwest,34,True,115,3,0,False,False,True,136,4,1,8.035249173158695,-21,-1
user_007391,26,30k-50k,mobile,returning,Midwest,91,False,0,0,0,True,True,True,120,1,0,9.017232791166304,-120,-1
user_007392,43,30k-50k,desktop,returning,West,56,True,102,1,1,False,True,True,78,1,0,8.89174498959552,24,0
user_007393,42,50k-75k,mobile,returning,East,48,True,102,1,0,True,True,False,0,0,0,,102,1
user_007394,46,75k-100k,mobile,returning,South,21,True,123,2,0,True,False,True,104,2,0,7.05335818620714,19,0
user_007395,40,50k-75k,desktop,new,East,56,True,89,3,0,False,True,True,61,1,0,7.28850267456453,28,2
user_007396,46,<30k,desktop,new,East,59,False,0,0,0,True,True,True,153,1,0,6.98668363676897,-153,-1
user_007397,33,50k-75k,mobile,returning,Midwest,48,True,109,5,1,True,False,True,97,5,1,6.997079115251978,12,0
user_007398,38,75k-100k,mobile,returning,East,35,True,61,4,0,False,True,True,31,4,0,6.630200897337143,30,0
user_007399,44,100k-150k,desktop,returning,West,69,True,81,2,1,True,True,True,64,2,0,8.857922117420662,17,0
user_007400,35,50k-75k,mobile,returning,East,59,True,157,1,1,True,True,True,127,3,0,8.06902760229544,30,-2
user_007401,39,30k-50k,desktop,new,West,52,True,108,2,0,False,False,True,91,1,0,6.0700902700420905,17,1
user_007402,39,50k-75k,desktop,new,West,65,False,0,0,0,False,True,True,100,2,0,9.577948255549305,-100,-2
user_007403,43,75k-100k,desktop,new,West,33,True,85,2,0,False,True,True,59,2,0,7.772638063469006,26,0
user_007404,20,30k-50k,tablet,new,East,100,False,0,0,0,False,True,True,82,1,0,10.0,-82,-1
user_007405,27,50k-75k,tablet,returning,East,65,True,72,1,0,True,False,True,76,1,0,8.530269605358123,-4,0
user_007406,43,75k-100k,mobile,returning,East,61,True,47,4,0,True,True,True,51,2,0,6.804166339701129,-4,2
user_007407,30,100k-150k,desktop,returning,Midwest,93,True,71,1,0,False,True,True,39,2,0,7.863355974976032,32,-1
user_007408,36,50k-75k,mobile,new,Midwest,23,True,175,2,0,False,False,True,167,3,0,5.47954630984705,8,-1
user_007409,46,30k-50k,mobile,new,East,37,True,129,5,0,False,True,True,106,5,0,7.727880096338883,23,0
user_007410,37,<30k,desktop,returning,East,35,False,0,0,0,True,False,True,115,1,1,8.9651260721942,-115,-1
user_007411,51,100k-150k,desktop,returning,South,64,False,0,0,0,True,True,True,75,2,0,7.6656214103314,-75,-2
user_007412,31,100k-150k,mobile,returning,Midwest,49,True,65,1,0,False,False,True,52,2,0,8.044715862764352,13,-1
user_007413,40,75k-100k,mobile,returning,West,68,True,30,1,0,True,True,True,41,1,0,8.566283127554035,-11,0
user_007414,50,30k-50k,desktop,new,South,42,True,154,2,0,False,True,True,145,2,0,9.337646356836009,9,0
user_007415,43,30k-50k,mobile,returning,West,47,True,57,2,0,True,False,True,37,2,0,8.924884616414149,20,0
user_007416,58,<30k,mobile,returning,Midwest,0,True,87,8,0,False,False,True,85,7,0,5.466412727832876,2,1
user_007417,23,30k-50k,desktop,returning,South,85,True,88,4,0,True,True,True,78,1,0,10.0,10,3
user_007418,25,75k-100k,desktop,returning,East,36,True,109,5,0,True,True,True,95,3,1,7.187156023903199,14,2
user_007419,33,50k-75k,mobile,returning,West,73,True,91,3,0,True,True,False,0,0,0,,91,3
user_007420,18,<30k,mobile,returning,South,57,False,0,0,0,True,True,True,90,1,0,9.757429723010224,-90,-1
user_007421,65,100k-150k,mobile,new,East,46,True,77,4,0,True,False,True,93,4,0,5.0920289565419985,-16,0
user_007422,56,100k-150k,desktop,returning,West,58,True,84,3,0,False,True,True,95,1,0,8.434215358308393,-11,2
user_007423,24,50k-75k,mobile,new,East,99,False,0,0,0,False,True,True,95,1,0,7.668172873067761,-95,-1
user_007424,40,75k-100k,desktop,returning,South,50,True,67,3,0,False,False,True,52,5,0,7.3639144183669805,15,-2
user_007425,52,75k-100k,desktop,new,South,37,True,72,4,1,False,False,True,87,5,0,7.97826913139805,-15,-1
user_007426,38,30k-50k,desktop,new,East,39,True,98,2,1,False,False,True,91,1,0,8.020683143569984,7,1
user_007427,50,>150k,mobile,returning,Midwest,45,True,86,4,0,False,True,False,0,0,0,,86,4
user_007428,18,100k-150k,desktop,returning,Midwest,59,True,90,1,0,True,True,True,105,2,0,10.0,-15,-1
user_007429,30,<30k,desktop,new,Midwest,35,False,0,0,0,True,True,True,115,1,0,9.409114600752332,-115,-1
user_007430,38,>150k,desktop,returning,West,73,True,30,3,1,True,True,True,33,3,0,10.0,-3,0
user_007431,65,75k-100k,mobile,returning,Midwest,8,True,161,3,0,False,False,True,175,2,1,6.491378836273182,-14,1
user_007432,29,75k-100k,mobile,returning,Midwest,58,True,81,4,0,False,True,False,0,0,0,,81,4
user_007433,44,30k-50k,desktop,returning,West,43,True,87,2,0,True,True,True,29,1,0,7.91492747174355,58,1
user_007434,43,30k-50k,desktop,returning,East,64,True,57,5,1,False,True,True,36,3,0,7.591734314899361,21,2
user_007435,57,75k-100k,mobile,new,West,32,True,128,6,0,False,False,True,132,12,0,6.312416199197613,-4,-6
user_007436,31,30k-50k,mobile,returning,Midwest,64,True,114,4,1,False,False,True,99,3,0,7.194708922061699,15,1
user_007437,56,100k-150k,mobile,returning,Midwest,42,True,113,1,0,False,True,True,77,1,0,8.338441552551453,36,0
user_007438,45,<30k,desktop,returning,Midwest,38,False,0,0,0,True,True,True,67,2,1,6.816005993336406,-67,-2
user_007439,42,75k-100k,mobile,returning,South,22,True,99,4,0,False,True,True,69,2,0,7.777730785112824,30,2
user_007440,65,100k-150k,desktop,returning,West,41,True,35,1,0,True,True,True,20,1,0,6.435535809580228,15,0
user_007441,44,75k-100k,mobile,new,Midwest,57,True,137,3,0,False,False,True,124,4,0,5.118927746932145,13,-1
user_007442,54,100k-150k,mobile,returning,South,55,True,120,2,0,False,True,True,115,1,0,8.362592964006213,5,1
user_007443,52,75k-100k,mobile,new,East,69,True,115,3,1,True,True,True,92,2,0,7.607890754105419,23,1
user_007444,48,50k-75k,mobile,returning,West,59,True,66,5,0,False,True,True,49,8,0,8.730158717519139,17,-3
user_007445,48,100k-150k,mobile,returning,East,23,True,123,3,0,True,False,True,140,1,0,6.30734180031187,-17,2
user_007446,26,75k-100k,mobile,new,West,72,True,106,3,0,False,True,True,106,1,0,7.220267669512833,0,2
user_007447,29,100k-150k,desktop,returning,South,92,True,30,1,1,True,True,True,20,1,0,8.752360348206619,10,0
user_007448,29,75k-100k,mobile,new,Midwest,70,True,112,2,0,False,True,True,74,1,0,10.0,38,1
user_007449,55,50k-75k,mobile,returning,South,52,True,80,1,1,False,True,True,80,1,0,7.272698700553295,0,0
user_007450,68,50k-75k,mobile,returning,East,22,True,139,1,0,False,False,True,106,1,0,8.475269198276607,33,0
user_007451,45,100k-150k,desktop,returning,East,49,True,65,1,0,True,True,True,48,1,0,7.535761861744846,17,0
user_007452,18,100k-150k,desktop,returning,East,90,True,91,5,0,True,False,True,105,6,0,7.650796260626511,-14,-1
user_007453,39,30k-50k,mobile,returning,South,50,True,82,2,0,False,True,True,41,2,0,7.642998520289212,41,0
user_007454,51,50k-75k,mobile,returning,Midwest,41,True,73,1,0,True,True,True,85,1,0,9.018495771403966,-12,0
user_007455,28,100k-150k,mobile,returning,West,100,True,62,3,0,False,True,True,57,2,0,10.0,5,1
user_007456,50,75k-100k,desktop,returning,West,64,True,149,3,1,True,True,True,115,3,0,4.92853546840066,34,0
user_007457,61,50k-75k,desktop,new,West,44,True,130,4,0,False,True,True,90,2,0,6.839222460321794,40,2
user_007458,23,100k-150k,desktop,returning,South,86,True,78,2,1,True,True,True,61,3,0,6.414811614809523,17,-1
user_007459,47,30k-50k,mobile,new,West,59,True,109,4,0,False,False,True,91,5,0,8.515577485131487,18,-1
user_007460,80,75k-100k,desktop,new,Midwest,29,True,176,2,2,False,True,True,139,4,0,6.568540625105007,37,-2
user_007461,41,50k-75k,desktop,returning,East,28,True,129,5,0,False,False,True,133,4,0,5.770516017397847,-4,1
user_007462,71,50k-75k,mobile,returning,East,20,True,157,4,0,False,True,True,115,3,0,8.164211128056653,42,1
user_007463,62,75k-100k,tablet,new,East,37,True,89,2,0,False,False,True,92,1,0,6.765413781341523,-3,1
user_007464,45,>150k,desktop,new,East,60,True,177,3,0,True,True,True,143,1,0,6.307061969582938,34,2
user_007465,47,<30k,mobile,new,Midwest,24,True,231,6,0,False,True,True,219,3,0,7.644247607747907,12,3
user_007466,36,75k-100k,tablet,returning,Midwest,62,False,0,0,0,False,False,True,90,1,0,8.033678733057302,-90,-1
user_007467,31,50k-75k,mobile,new,Midwest,42,True,168,3,0,False,True,True,129,2,0,8.212910401261938,39,1
user_007468,72,50k-75k,desktop,new,East,20,True,146,3,1,False,False,True,183,3,1,7.611940424149539,-37,0
user_007469,39,>150k,desktop,new,South,50,True,162,1,0,False,False,True,103,1,0,7.620448659451857,59,0
user_007470,33,100k-150k,mobile,returning,East,96,True,55,1,0,True,True,True,42,1,0,7.587289867173506,13,0
user_007471,49,50k-75k,mobile,new,East,48,False,0,0,0,True,True,True,77,1,0,6.92992301616732,-77,-1
user_007472,64,50k-75k,desktop,returning,South,44,False,0,0,0,False,True,True,119,1,0,8.26530359015636,-119,-1
user_007473,63,30k-50k,desktop,new,Midwest,18,True,163,6,1,True,True,True,153,5,0,7.2316516361213985,10,1
user_007474,41,30k-50k,mobile,returning,West,52,True,84,3,0,True,True,True,74,2,0,7.049740502715296,10,1
user_007475,57,50k-75k,desktop,returning,East,79,True,30,1,1,True,True,True,20,1,0,7.484077316978908,10,0
user_007476,51,<30k,mobile,new,East,62,True,76,6,0,False,True,True,54,3,0,9.468107039981884,22,3
user_007477,22,30k-50k,mobile,new,East,64,False,0,0,0,False,True,True,105,1,0,7.124690400230319,-105,-1
user_007478,57,75k-100k,mobile,returning,Midwest,33,True,81,3,0,True,True,True,98,1,0,8.039429670762466,-17,2
user_007479,50,<30k,mobile,returning,East,21,False,0,0,0,False,False,True,121,1,0,5.968507178648159,-121,-1
user_007480,18,30k-50k,mobile,returning,West,85,True,56,3,0,False,True,True,62,3,1,8.069512528605475,-6,0
user_007481,45,30k-50k,mobile,new,West,57,True,149,2,1,False,False,True,136,2,0,6.809284600166408,13,0
user_007482,51,75k-100k,mobile,returning,East,40,False,0,0,0,False,True,True,81,1,0,8.550518784797834,-81,-1
user_007483,50,30k-50k,mobile,returning,West,63,True,53,3,0,False,False,True,80,7,0,7.10470597797731,-27,-4
user_007484,59,<30k,desktop,returning,West,58,False,0,0,0,True,True,True,63,1,0,8.821909634971256,-63,-1
user_007485,34,75k-100k,desktop,new,Midwest,72,True,78,3,0,False,True,True,52,2,0,6.2881527288071135,26,1
user_007486,28,>150k,mobile,returning,South,80,True,81,5,0,True,True,False,0,0,0,,81,5
user_007487,18,30k-50k,mobile,returning,East,75,True,113,2,0,False,True,True,77,1,0,9.09475196888168,36,1
user_007488,45,<30k,mobile,returning,South,58,True,66,4,0,False,False,False,0,0,0,,66,4
user_007489,46,<30k,desktop,returning,South,64,True,95,5,0,True,True,True,91,5,0,8.610493374451448,4,0
user_007490,37,30k-50k,mobile,new,South,26,True,180,3,1,False,False,True,176,3,0,7.504023209188171,4,0
user_007491,69,50k-75k,mobile,new,East,34,False,0,0,0,False,True,True,79,1,0,7.404656547688561,-79,-1
user_007492,38,50k-75k,mobile,returning,Midwest,40,True,108,1,0,False,True,True,82,1,0,7.686337281051909,26,0
user_007493,55,100k-150k,desktop,new,East,83,True,92,5,0,False,True,True,74,3,0,8.293664174787256,18,2
user_007494,32,100k-150k,desktop,new,Midwest,62,True,143,2,0,True,True,True,112,2,1,6.935578880643867,31,0
user_007495,48,30k-50k,mobile,returning,Midwest,31,True,104,4,0,True,False,True,124,1,0,8.218570265966337,-20,3
user_007496,52,75k-100k,desktop,returning,West,52,True,67,3,0,False,True,False,0,0,0,,67,3
user_007497,61,75k-100k,desktop,returning,East,28,True,137,7,1,True,True,True,147,8,0,7.470181927321414,-10,-1
user_007498,60,100k-150k,mobile,returning,West,57,True,94,1,0,False,True,True,94,1,0,8.208489371889964,0,0
user_007499,36,75k-100k,desktop,returning,West,51,True,68,1,0,True,True,True,68,1,0,4.759057760724741,0,0
user_007500,51,75k-100k,desktop,returning,South,69,True,78,4,0,True,False,True,77,5,1,9.346855534726123,1,-1
user_007501,52,75k-100k,desktop,new,West,55,True,131,1,0,False,False,True,132,3,0,5.926952331207233,-1,-2
user_007502,64,100k-150k,mobile,returning,East,48,True,114,2,0,True,False,True,131,2,0,7.7326752383377855,-17,0
user_007503,35,50k-75k,desktop,new,West,62,True,138,1,1,True,True,True,124,1,0,7.5315622197918035,14,0
user_007504,62,75k-100k,desktop,returning,Midwest,32,True,109,3,0,False,True,True,80,1,0,6.6383404096579195,29,2
user_007505,42,<30k,mobile,returning,Midwest,23,True,122,3,0,False,False,True,133,1,1,7.43100209422374,-11,2
user_007506,18,50k-75k,mobile,returning,South,46,True,30,5,0,False,False,True,20,5,0,8.62213962049236,10,0
user_007507,29,75k-100k,desktop,returning,East,73,True,87,3,0,True,True,True,41,3,0,7.367728008573279,46,0
user_007508,40,100k-150k,mobile,returning,East,48,True,49,2,1,True,True,True,22,1,0,5.924974016071391,27,1
user_007509,32,30k-50k,mobile,new,Midwest,78,True,97,5,0,True,True,True,96,6,0,8.176628925123092,1,-1
user_007510,48,50k-75k,desktop,returning,East,46,True,88,1,0,True,False,True,101,2,0,6.648458437353671,-13,-1
user_007511,55,100k-150k,mobile,returning,East,50,True,113,1,0,True,True,True,102,1,0,8.624548806855813,11,0
user_007512,49,50k-75k,desktop,returning,Midwest,51,True,44,3,0,False,False,True,35,2,0,5.534014809967038,9,1
user_007513,57,100k-150k,desktop,returning,East,36,True,85,4,0,True,True,True,79,5,0,7.630768153463342,6,-1
user_007514,52,100k-150k,desktop,returning,East,75,True,66,6,0,False,True,True,60,5,0,9.257002707143698,6,1
user_007515,35,100k-150k,desktop,returning,West,78,False,0,0,0,True,True,True,98,1,1,7.150182458660296,-98,-1
user_007516,44,75k-100k,desktop,new,Midwest,27,True,142,2,0,True,False,True,134,5,0,8.317400296929097,8,-3
user_007517,56,<30k,mobile,new,West,13,False,0,0,0,True,False,False,0,0,0,,0,0
user_007518,21,75k-100k,tablet,new,South,42,True,192,3,1,False,False,True,161,2,0,5.893427357471311,31,1
user_007519,53,30k-50k,mobile,returning,South,63,False,0,0,0,True,True,False,0,0,0,,0,0
user_007520,34,50k-75k,desktop,returning,West,100,True,50,2,0,True,True,True,24,2,0,8.073378914738303,26,0
user_007521,39,50k-75k,desktop,returning,South,52,True,57,2,0,True,True,True,44,2,0,7.840032132381519,13,0
user_007522,33,75k-100k,desktop,returning,West,68,True,105,5,0,False,True,True,68,7,0,8.940268547800413,37,-2
user_007523,51,50k-75k,mobile,returning,East,52,True,88,4,0,False,True,True,78,3,0,5.38875483925467,10,1
user_007524,35,75k-100k,mobile,returning,West,38,True,114,4,0,True,True,True,106,8,0,7.37132564083639,8,-4
user_007525,36,30k-50k,desktop,returning,East,23,True,101,3,1,True,True,True,78,3,0,9.556595231593523,23,0
user_007526,24,30k-50k,mobile,returning,Midwest,79,True,30,2,0,False,True,True,20,5,0,7.017750723496806,10,-3
user_007527,37,100k-150k,mobile,returning,West,100,True,74,4,0,True,False,True,67,6,0,9.159767353728697,7,-2
user_007528,33,50k-75k,mobile,returning,South,76,True,93,2,0,True,True,True,45,1,0,10.0,48,1
user_007529,60,50k-75k,mobile,new,West,33,True,64,3,0,False,False,True,106,1,1,8.27788843304063,-42,2
user_007530,56,50k-75k,desktop,returning,Midwest,29,True,79,1,0,False,False,True,68,1,0,6.988890888031716,11,0
user_007531,33,50k-75k,desktop,returning,West,84,True,34,2,0,False,True,True,63,5,0,7.218208589078193,-29,-3
user_007532,43,100k-150k,desktop,returning,Midwest,83,True,68,3,1,False,False,True,20,3,0,4.873188554403065,48,0
user_007533,55,100k-150k,mobile,returning,Midwest,53,True,84,6,0,True,True,True,53,11,0,6.953256095130228,31,-5
user_007534,18,50k-75k,mobile,returning,East,67,True,88,5,0,False,True,True,40,4,0,8.23933998633793,48,1
user_007535,51,100k-150k,desktop,returning,Midwest,55,True,73,1,0,True,True,False,0,0,0,,73,1
user_007536,60,<30k,mobile,new,East,10,False,0,0,0,False,False,True,141,3,0,4.755487418855953,-141,-3
user_007537,40,100k-150k,desktop,returning,Midwest,68,True,127,2,0,True,True,True,123,2,0,7.727513887935733,4,0
user_007538,36,<30k,mobile,returning,Midwest,65,True,99,4,0,False,False,True,112,4,0,8.358918467128838,-13,0
user_007539,28,75k-100k,desktop,returning,West,60,True,103,1,0,False,True,True,66,1,0,8.557037398682443,37,0
user_007540,37,100k-150k,desktop,new,West,96,True,152,1,1,True,True,True,142,1,1,6.654011097645572,10,0
user_007541,64,30k-50k,mobile,new,East,19,True,108,1,0,True,False,True,117,1,1,8.565934911883076,-9,0
user_007542,73,>150k,mobile,new,East,45,True,100,3,0,True,False,True,70,4,1,7.631404447847577,30,-1
user_007543,36,50k-75k,mobile,returning,South,39,True,99,6,1,True,False,True,103,2,2,8.361341117356755,-4,4
user_007544,54,50k-75k,mobile,returning,South,36,True,65,3,0,False,False,True,45,7,0,6.857087055153244,20,-4
user_007545,38,75k-100k,mobile,returning,Midwest,39,True,83,3,0,False,False,True,92,3,0,7.7484194309330485,-9,0
user_007546,48,50k-75k,desktop,returning,West,67,True,125,3,0,True,True,True,99,3,0,8.374552186111751,26,0
user_007547,50,75k-100k,desktop,returning,South,35,True,118,4,0,True,True,True,112,1,0,6.816357107110318,6,3
user_007548,53,50k-75k,desktop,returning,Midwest,48,True,84,4,1,False,True,True,95,3,0,7.787919971097519,-11,1
user_007549,18,50k-75k,mobile,returning,West,94,True,50,5,1,False,True,True,76,6,0,5.8059421678998016,-26,-1
user_007550,18,50k-75k,desktop,returning,West,92,True,85,3,0,False,True,True,35,1,0,6.828951190720297,50,2
user_007551,51,75k-100k,desktop,returning,South,30,True,38,4,0,True,False,True,23,5,0,9.333957967444704,15,-1
user_007552,40,<30k,mobile,returning,West,41,True,30,2,0,True,False,False,0,0,0,,30,2
user_007553,34,50k-75k,mobile,returning,Midwest,62,True,78,5,0,False,True,True,55,4,0,10.0,23,1
user_007554,54,75k-100k,desktop,returning,Midwest,29,True,129,2,0,False,False,True,124,1,1,8.081220157594045,5,1
user_007555,52,30k-50k,mobile,new,South,45,True,116,4,1,False,False,True,126,5,0,8.464367898422179,-10,-1
user_007556,57,100k-150k,tablet,new,Midwest,8,True,160,3,0,True,False,True,124,4,1,7.238594582059779,36,-1
user_007557,18,30k-50k,mobile,returning,South,70,True,95,2,0,False,True,True,83,2,0,10.0,12,0
user_007558,74,100k-150k,mobile,returning,South,49,True,88,1,0,True,False,True,119,1,0,5.9258566976241855,-31,0
user_007559,20,75k-100k,desktop,new,Midwest,70,True,184,1,0,True,True,True,205,3,0,7.380895481341969,-21,-2
user_007560,27,100k-150k,mobile,returning,West,89,True,43,4,0,True,True,True,77,5,0,4.876046498980191,-34,-1
user_007561,80,30k-50k,mobile,new,East,47,True,94,1,0,False,False,True,81,2,0,6.896864549644302,13,-1
user_007562,80,50k-75k,desktop,new,Midwest,28,True,174,1,1,False,False,True,224,1,0,7.375933970010252,-50,0
user_007563,61,30k-50k,mobile,returning,Midwest,18,True,113,5,0,True,True,True,69,8,0,7.975500381857923,44,-3
user_007564,63,75k-100k,mobile,returning,Midwest,8,True,123,4,0,True,False,True,134,4,0,4.942186180546492,-11,0
user_007565,48,30k-50k,mobile,new,South,63,True,159,4,0,True,True,True,151,1,0,9.678117473083843,8,3
user_007566,61,50k-75k,mobile,returning,East,40,True,136,5,0,False,False,False,0,0,0,,136,5
user_007567,56,<30k,desktop,returning,West,65,True,64,1,0,True,False,False,0,0,0,,64,1
user_007568,61,75k-100k,mobile,returning,South,47,True,74,1,0,True,False,True,82,1,0,6.475972243280971,-8,0
user_007569,37,30k-50k,mobile,returning,West,46,True,121,4,0,True,False,True,136,2,0,7.103029430994492,-15,2
user_007570,45,50k-75k,desktop,returning,East,46,True,91,2,1,True,True,True,79,1,0,6.482325940383131,12,1
user_007571,43,75k-100k,mobile,new,East,82,True,86,3,0,True,True,True,26,3,0,8.849569145127278,60,0
user_007572,58,75k-100k,mobile,returning,West,19,True,126,4,0,True,False,True,179,3,0,8.518298903000847,-53,1
user_007573,55,75k-100k,mobile,returning,Midwest,31,True,58,4,0,True,True,True,63,5,0,6.733087506324993,-5,-1
user_007574,62,75k-100k,desktop,returning,Midwest,21,True,111,2,0,False,False,True,136,2,1,7.116825737344273,-25,0
user_007575,79,75k-100k,desktop,returning,South,33,True,76,5,1,True,True,True,58,5,0,8.199591944931036,18,0
user_007576,49,50k-75k,desktop,new,South,35,True,127,5,0,True,True,False,0,0,0,,127,5
user_007577,53,50k-75k,desktop,returning,West,59,True,134,6,0,False,True,True,98,8,0,8.220317889524889,36,-2
user_007578,63,75k-100k,mobile,returning,South,5,True,137,5,0,False,True,True,95,4,0,5.870100764587039,42,1
user_007579,72,50k-75k,mobile,returning,West,39,False,0,0,0,False,True,True,106,1,0,6.5791730883121895,-106,-1
user_007580,51,100k-150k,mobile,returning,Midwest,51,True,90,7,0,True,True,True,82,5,0,6.992445151882368,8,2
user_007581,35,30k-50k,desktop,returning,West,55,True,98,4,0,True,True,True,87,2,0,8.498512472544206,11,2
user_007582,58,<30k,mobile,returning,Midwest,8,True,130,2,1,True,True,True,169,1,0,8.163991219032118,-39,1
user_007583,48,50k-75k,mobile,returning,East,48,True,63,2,1,False,True,True,62,1,0,7.350535561600529,1,1
user_007584,18,100k-150k,desktop,new,East,79,False,0,0,0,False,True,True,98,1,0,5.364018384904298,-98,-1
user_007585,47,100k-150k,mobile,returning,Midwest,80,True,55,2,0,False,True,True,53,2,0,7.334381423869077,2,0
user_007586,35,75k-100k,tablet,new,West,24,True,167,3,0,False,False,True,154,1,0,6.636077206953739,13,2
user_007587,63,30k-50k,mobile,new,South,29,False,0,0,0,False,True,False,0,0,0,,0,0
user_007588,34,50k-75k,desktop,returning,Midwest,61,True,90,1,0,True,True,True,98,1,0,7.210591948447682,-8,0
user_007589,37,100k-150k,desktop,new,South,32,True,76,6,0,False,False,True,86,4,0,7.50132873608568,-10,2
user_007590,29,75k-100k,mobile,new,East,68,True,110,1,0,False,True,True,58,1,0,7.713819288233839,52,0
user_007591,33,<30k,desktop,returning,West,85,False,0,0,0,False,True,True,75,1,1,10.0,-75,-1
user_007592,52,30k-50k,tablet,returning,West,93,True,68,3,1,False,True,True,20,3,0,10.0,48,0
user_007593,30,30k-50k,mobile,returning,South,73,False,0,0,0,False,True,True,76,1,0,9.969169705519652,-76,-1
user_007594,66,30k-50k,desktop,returning,West,55,True,70,3,0,False,True,True,49,2,0,10.0,21,1
user_007595,56,30k-50k,mobile,new,South,0,True,209,5,0,False,True,True,170,3,0,6.922521919580113,39,2
user_007596,26,75k-100k,mobile,new,Midwest,77,True,133,1,0,False,True,True,100,2,0,8.679978812106242,33,-1
user_007597,50,<30k,desktop,returning,West,52,True,79,1,0,True,False,True,55,1,0,8.739228410135693,24,0
user_007598,53,30k-50k,desktop,returning,West,65,False,0,0,0,True,True,True,90,1,0,9.315646873744045,-90,-1
user_007599,33,100k-150k,mobile,returning,East,77,True,30,1,0,False,True,True,20,1,0,7.688834150842217,10,0
user_007600,39,100k-150k,mobile,returning,West,79,True,98,5,1,True,True,True,76,7,0,7.059106896186319,22,-2
user_007601,46,<30k,tablet,new,East,42,False,0,0,0,True,True,True,118,1,0,9.130598443607775,-118,-1
user_007602,30,50k-75k,desktop,returning,West,63,True,95,2,0,False,True,True,73,3,1,8.939651892058894,22,-1
user_007603,41,50k-75k,mobile,new,East,14,True,187,1,0,False,False,True,235,1,0,7.839727874175263,-48,0
user_007604,50,30k-50k,desktop,returning,West,50,True,118,1,0,True,True,False,0,0,0,,118,1
user_007605,51,100k-150k,mobile,new,West,98,True,55,3,0,True,True,True,43,3,0,8.524136410368078,12,0
user_007606,34,75k-100k,mobile,returning,East,58,True,94,4,0,False,False,True,109,1,0,4.907433091306396,-15,3
user_007607,34,75k-100k,desktop,returning,West,56,True,118,4,1,False,True,True,88,6,0,8.596532474967143,30,-2
user_007608,31,<30k,desktop,returning,East,62,True,56,3,0,False,False,True,46,3,0,9.99339439463516,10,0
user_007609,51,50k-75k,desktop,returning,West,73,True,30,4,0,False,True,True,49,1,0,8.65995044565253,-19,3
user_007610,54,50k-75k,desktop,new,Midwest,47,False,0,0,0,False,True,True,109,1,0,7.823735274955389,-109,-1
user_007611,39,<30k,mobile,returning,West,53,True,105,4,0,True,True,False,0,0,0,,105,4
user_007612,29,50k-75k,mobile,new,East,60,True,130,3,0,False,False,True,149,3,0,6.247952658227938,-19,0
user_007613,33,50k-75k,desktop,new,East,48,True,135,1,1,False,False,True,149,1,0,5.6861235345712355,-14,0
user_007614,58,100k-150k,desktop,new,Midwest,52,True,108,5,0,False,True,True,98,4,0,7.811957095119554,10,1
user_007615,80,100k-150k,desktop,returning,South,52,True,78,1,0,True,True,True,91,2,0,7.665195157988215,-13,-1
user_007616,37,75k-100k,mobile,returning,East,69,True,72,4,2,True,True,True,70,1,0,6.78847365226684,2,3
user_007617,51,50k-75k,desktop,returning,East,62,True,63,1,0,False,True,True,53,1,0,8.088922656403396,10,0
user_007618,59,50k-75k,desktop,returning,West,40,True,110,5,0,True,True,True,94,3,0,6.602147985906265,16,2
user_007619,53,75k-100k,desktop,new,South,52,True,138,2,0,False,True,True,129,4,0,7.095742705487167,9,-2
user_007620,70,50k-75k,mobile,returning,East,37,True,65,6,0,True,True,True,21,4,0,8.154733341510955,44,2
user_007621,55,50k-75k,mobile,returning,West,68,True,86,1,0,False,False,True,101,1,0,7.894552903585059,-15,0
user_007622,47,50k-75k,desktop,new,South,56,True,178,2,0,False,True,True,138,1,0,6.36594115322269,40,1
user_007623,43,<30k,desktop,new,Midwest,14,True,182,5,0,False,False,True,177,3,0,6.113232405822856,5,2
user_007624,30,30k-50k,mobile,new,West,96,True,170,4,0,True,True,True,127,4,0,9.504048565421146,43,0
user_007625,57,75k-100k,desktop,new,East,36,True,145,3,0,False,True,True,100,3,0,6.3765779003920615,45,0
user_007626,44,50k-75k,desktop,returning,South,57,True,30,2,1,True,True,True,20,1,0,5.5525554310972245,10,1
user_007627,66,30k-50k,desktop,new,East,49,True,123,1,0,True,False,True,118,2,0,7.617492900290345,5,-1
user_007628,49,75k-100k,mobile,returning,West,49,True,116,2,0,True,True,True,106,4,0,5.727133085323662,10,-2
user_007629,46,100k-150k,desktop,returning,East,61,True,129,1,0,False,False,True,130,1,1,7.253197591450963,-1,0
user_007630,18,50k-75k,desktop,new,East,81,True,132,4,1,True,True,True,162,3,0,7.944456116910986,-30,1
user_007631,77,50k-75k,mobile,new,South,7,False,0,0,0,True,False,True,119,1,1,7.152240064721403,-119,-1
user_007632,51,50k-75k,desktop,returning,Midwest,19,False,0,0,0,True,False,True,118,2,0,5.711203385326385,-118,-2
user_007633,31,30k-50k,desktop,returning,West,94,True,59,2,1,True,True,True,24,1,0,6.224930724915593,35,1
user_007634,31,100k-150k,mobile,returning,East,67,True,71,3,0,False,True,True,55,2,0,7.714826915515077,16,1
user_007635,80,<30k,mobile,returning,Midwest,24,True,111,1,0,False,False,False,0,0,0,,111,1
user_007636,49,<30k,desktop,returning,South,47,True,98,2,0,False,False,True,126,1,0,8.467703939957563,-28,1
user_007637,53,75k-100k,desktop,new,Midwest,30,True,155,3,0,True,True,True,106,2,1,10.0,49,1
user_007638,48,<30k,mobile,returning,East,68,False,0,0,0,True,True,True,102,2,0,8.50504763119889,-102,-2
user_007639,57,>150k,mobile,returning,South,32,True,91,3,0,False,False,False,0,0,0,,91,3
user_007640,18,50k-75k,mobile,new,Midwest,64,True,97,3,0,False,True,True,57,3,0,9.229756236892625,40,0
user_007641,64,75k-100k,mobile,new,East,36,True,127,8,1,True,True,True,76,6,0,10.0,51,2
user_007642,64,50k-75k,desktop,new,Midwest,43,False,0,0,0,False,True,True,90,1,1,7.751639633902774,-90,-1
user_007643,21,>150k,desktop,returning,South,74,False,0,0,0,True,True,False,0,0,0,,0,0
user_007644,32,50k-75k,tablet,new,Midwest,49,True,143,2,0,False,True,True,91,2,0,6.975885006180163,52,0
user_007645,33,30k-50k,desktop,new,Midwest,91,True,90,2,3,False,True,True,27,4,0,7.598923482242553,63,-2
user_007646,25,<30k,mobile,returning,South,85,True,79,3,0,False,True,False,0,0,0,,79,3
user_007647,35,100k-150k,mobile,returning,Midwest,58,True,76,4,0,False,False,True,99,2,0,5.888739161105372,-23,2
user_007648,70,30k-50k,desktop,returning,South,45,True,70,5,0,False,True,True,72,6,0,8.133827334624558,-2,-1
user_007649,24,30k-50k,mobile,returning,South,96,True,71,3,0,True,True,True,94,5,0,6.371030855791177,-23,-2
user_007650,18,50k-75k,desktop,new,Midwest,76,True,83,3,0,False,True,True,68,3,0,6.94128562160375,15,0
user_007651,56,50k-75k,mobile,returning,Midwest,17,True,173,1,0,True,False,True,172,1,1,8.74927777235865,1,0
user_007652,54,50k-75k,desktop,returning,East,37,True,96,2,0,True,True,True,84,2,0,9.984701981392261,12,0
user_007653,22,50k-75k,desktop,new,Midwest,47,True,88,2,1,True,False,True,92,1,0,5.625397742423542,-4,1
user_007654,49,>150k,mobile,returning,Midwest,53,True,107,3,0,False,True,True,82,1,0,9.301889284545851,25,2
user_007655,64,30k-50k,desktop,returning,East,22,True,130,5,0,False,False,True,107,7,1,9.242501083074368,23,-2
user_007656,60,50k-75k,desktop,new,South,7,True,169,2,0,False,False,True,168,1,0,6.6004986890051,1,1
user_007657,50,<30k,mobile,returning,East,52,False,0,0,0,False,True,True,93,4,0,9.946914064763066,-93,-4
user_007658,35,100k-150k,mobile,new,Midwest,30,True,115,5,0,False,True,True,124,5,0,5.245505516761732,-9,0
user_007659,80,75k-100k,desktop,new,South,24,True,99,3,0,False,False,True,91,5,0,8.875811408357869,8,-2
user_007660,68,30k-50k,mobile,returning,South,16,True,134,5,0,True,False,True,163,4,0,6.499639262299071,-29,1
user_007661,21,30k-50k,desktop,returning,South,63,True,138,1,0,False,True,True,145,2,0,8.914365049347289,-7,-1
user_007662,41,50k-75k,mobile,new,West,62,True,139,3,0,False,True,True,120,3,0,6.947158036665574,19,0
user_007663,46,100k-150k,mobile,returning,South,59,True,80,3,0,False,True,True,45,3,0,9.579902187968422,35,0
user_007664,49,100k-150k,mobile,returning,West,56,True,63,2,0,True,True,True,57,1,1,7.665109393438698,6,1
user_007665,46,<30k,mobile,returning,South,56,False,0,0,0,False,False,False,0,0,0,,0,0
user_007666,51,100k-150k,mobile,returning,East,77,True,44,1,0,True,True,True,24,1,0,8.952600407342516,20,0
user_007667,52,>150k,desktop,returning,Midwest,69,True,73,1,0,True,True,False,0,0,0,,73,1
user_007668,27,30k-50k,desktop,new,South,59,True,125,4,0,True,False,True,132,8,0,6.1143031281189915,-7,-4
user_007669,49,100k-150k,mobile,returning,South,30,True,79,3,0,False,True,True,64,4,0,7.70890580866042,15,-1
user_007670,18,75k-100k,tablet,new,West,84,True,128,1,0,True,True,True,122,1,0,8.407733984658034,6,0
user_007671,38,50k-75k,mobile,returning,South,36,True,63,2,0,False,False,True,103,1,0,5.74178094793016,-40,1
user_007672,27,75k-100k,mobile,returning,East,44,True,120,1,0,False,False,True,147,5,1,8.082717888837585,-27,-4
user_007673,34,30k-50k,desktop,returning,East,72,True,55,2,0,True,True,True,63,2,0,5.90085240325075,-8,0
user_007674,37,75k-100k,desktop,new,West,53,True,143,3,0,True,True,True,109,3,0,9.574416099221558,34,0
user_007675,19,75k-100k,desktop,returning,East,48,True,77,1,0,False,False,True,79,1,0,7.692868016953362,-2,0
user_007676,43,75k-100k,mobile,new,Midwest,44,True,139,2,0,False,True,True,77,1,0,7.339455091896865,62,1
user_007677,27,<30k,mobile,returning,East,70,False,0,0,0,True,True,True,110,1,0,8.550685966371503,-110,-1
user_007678,64,50k-75k,mobile,returning,South,44,True,84,3,0,True,True,True,55,1,1,7.492868347983202,29,2
user_007679,41,50k-75k,tablet,returning,West,55,True,30,1,0,True,True,True,43,1,0,6.422670105187262,-13,0
user_007680,47,50k-75k,mobile,returning,East,64,True,131,1,0,True,False,True,132,2,0,5.539452458801736,-1,-1
user_007681,47,75k-100k,desktop,returning,West,54,True,30,2,0,False,False,True,20,1,1,5.576003508497761,10,1
user_007682,48,75k-100k,mobile,returning,East,47,False,0,0,0,False,True,True,114,1,0,9.634268559314098,-114,-1
user_007683,43,30k-50k,desktop,returning,West,57,True,60,1,0,True,False,True,72,1,1,5.745973414854286,-12,0
user_007684,43,75k-100k,mobile,new,East,47,True,82,4,1,False,False,True,67,5,0,5.625264042007536,15,-1
user_007685,60,30k-50k,mobile,returning,East,60,False,0,0,0,True,True,True,87,1,0,7.769645824181272,-87,-1
user_007686,37,100k-150k,mobile,new,South,67,True,112,4,0,False,True,True,70,4,0,8.205622124937763,42,0
user_007687,41,<30k,desktop,new,South,52,True,178,4,0,False,False,True,166,4,0,5.4505052160674445,12,0
user_007688,33,75k-100k,mobile,new,Midwest,62,True,119,2,0,True,True,True,67,4,0,7.920965382346993,52,-2
user_007689,43,30k-50k,desktop,new,South,25,True,228,3,0,False,False,True,241,6,0,8.065717986999797,-13,-3
user_007690,68,100k-150k,mobile,new,South,55,True,140,1,0,False,True,True,72,1,0,7.9053132663651775,68,0
user_007691,32,100k-150k,desktop,returning,Midwest,86,True,34,1,0,True,True,True,20,2,1,7.54684874827631,14,-1
user_007692,67,100k-150k,desktop,new,Midwest,27,True,144,7,0,False,True,True,111,2,0,8.43977891794542,33,5
user_007693,25,>150k,mobile,returning,West,52,True,130,3,0,True,True,True,105,2,0,8.213482299907666,25,1
user_007694,47,30k-50k,desktop,returning,East,40,True,43,1,0,True,False,True,20,2,0,6.536151493591877,23,-1
user_007695,21,75k-100k,tablet,new,South,63,False,0,0,0,False,True,True,102,1,0,7.402437868314247,-102,-1
user_007696,71,>150k,mobile,returning,South,35,True,48,2,0,True,True,False,0,0,0,,48,2
user_007697,48,50k-75k,mobile,returning,South,44,True,128,4,0,False,True,True,45,4,0,6.010277660920851,83,0
user_007698,49,50k-75k,desktop,returning,West,74,True,30,2,0,False,True,True,27,3,0,8.41208170104775,3,-1
user_007699,45,100k-150k,desktop,returning,South,16,True,161,3,1,False,False,True,191,3,0,6.205184541266455,-30,0
user_007700,43,30k-50k,desktop,new,West,46,True,147,1,0,True,False,True,182,1,0,8.935733742882373,-35,0
user_007701,35,30k-50k,desktop,new,Midwest,34,True,121,1,0,True,False,True,111,1,0,9.60306163988786,10,0
user_007702,40,100k-150k,mobile,new,South,55,True,78,4,0,False,True,True,54,2,0,8.670285450760803,24,2
user_007703,42,50k-75k,mobile,new,South,60,True,70,1,0,False,True,True,46,1,0,10.0,24,0
user_007704,52,30k-50k,desktop,new,East,51,True,137,1,0,True,False,True,149,1,0,7.62241706748009,-12,0
user_007705,44,30k-50k,desktop,new,East,26,True,198,5,1,True,True,True,140,6,0,7.5152841052346595,58,-1
user_007706,48,50k-75k,tablet,returning,Midwest,25,True,150,4,0,True,False,True,166,2,0,8.49006862937005,-16,2
user_007707,40,75k-100k,mobile,returning,West,56,True,93,2,0,False,True,True,78,2,0,8.770852823554238,15,0
user_007708,69,>150k,mobile,new,South,46,True,126,1,0,True,True,True,72,2,0,7.982144197160637,54,-1
user_007709,56,30k-50k,desktop,new,East,77,False,0,0,0,True,False,True,82,1,1,8.363148505446278,-82,-1
user_007710,49,50k-75k,desktop,returning,Midwest,40,True,41,3,0,False,False,True,23,2,0,7.593630513461733,18,1
user_007711,42,50k-75k,desktop,returning,South,49,True,102,1,0,False,False,True,93,3,0,8.094292931952275,9,-2
user_007712,63,75k-100k,mobile,new,South,36,True,101,3,0,True,True,True,75,3,1,8.161251652182624,26,0
user_007713,48,30k-50k,mobile,new,West,47,True,140,4,0,True,False,True,155,5,0,7.4775544093979835,-15,-1
user_007714,40,100k-150k,desktop,new,Midwest,69,True,164,2,0,True,True,True,127,1,0,8.99282381930487,37,1
user_007715,57,30k-50k,mobile,returning,West,64,True,89,1,0,True,False,True,113,1,0,6.79333705166309,-24,0
user_007716,69,50k-75k,desktop,new,Midwest,49,False,0,0,0,False,False,True,118,1,1,7.213117886770437,-118,-1
user_007717,18,<30k,desktop,returning,East,38,True,125,1,0,True,True,True,116,1,0,7.572700578376008,9,0
user_007718,80,50k-75k,desktop,new,East,34,False,0,0,0,False,True,False,0,0,0,,0,0
user_007719,18,50k-75k,desktop,returning,West,100,True,44,1,0,True,True,True,32,1,0,10.0,12,0
user_007720,42,50k-75k,tablet,returning,Midwest,39,False,0,0,0,True,True,False,0,0,0,,0,0
user_007721,61,<30k,mobile,returning,South,32,True,97,4,0,True,True,True,102,1,0,9.489606957380772,-5,3
user_007722,62,<30k,desktop,new,East,1,False,0,0,0,True,False,True,102,1,0,8.744428702625427,-102,-1
user_007723,31,<30k,mobile,returning,Midwest,48,False,0,0,0,False,True,False,0,0,0,,0,0
user_007724,66,100k-150k,mobile,returning,West,77,True,59,2,0,True,True,True,55,1,0,7.384543269960157,4,1
user_007725,62,100k-150k,mobile,new,South,42,True,118,2,0,False,False,False,0,0,0,,118,2
user_007726,60,75k-100k,desktop,returning,East,53,True,87,3,0,False,True,True,58,1,0,7.3835351121362764,29,2
user_007727,74,50k-75k,desktop,returning,Midwest,20,True,164,3,0,False,False,False,0,0,0,,164,3
user_007728,50,<30k,mobile,new,East,53,True,167,2,0,False,True,True,123,1,0,7.007283074236288,44,1
user_007729,38,>150k,mobile,returning,East,56,True,77,3,0,False,True,True,83,2,0,7.0256333294786515,-6,1
user_007730,43,30k-50k,desktop,returning,East,67,False,0,0,0,False,False,False,0,0,0,,0,0
user_007731,60,30k-50k,desktop,returning,Midwest,46,True,84,1,0,False,False,True,68,1,0,7.485020847876685,16,0
user_007732,58,<30k,mobile,returning,Midwest,13,True,64,1,0,True,True,True,49,1,0,6.848610257803346,15,0
user_007733,40,30k-50k,mobile,new,South,70,True,119,1,0,True,True,True,72,1,0,9.885199479958427,47,0
user_007734,57,100k-150k,desktop,returning,South,66,True,92,4,0,False,False,True,92,1,0,7.078289045072755,0,3
user_007735,41,50k-75k,mobile,new,South,30,False,0,0,0,False,True,True,101,1,0,8.219048094082316,-101,-1
user_007736,48,30k-50k,desktop,new,South,45,False,0,0,0,True,True,True,99,1,0,8.893368761943847,-99,-1
user_007737,51,50k-75k,desktop,new,South,27,True,167,4,1,True,True,True,134,2,0,7.998072101949591,33,2
user_007738,34,75k-100k,desktop,new,Midwest,73,False,0,0,0,True,True,True,106,1,0,8.608959161799044,-106,-1
user_007739,44,75k-100k,desktop,returning,East,44,True,146,3,0,False,False,True,130,3,0,7.880042921986151,16,0
user_007740,64,75k-100k,desktop,returning,South,46,True,102,3,0,False,False,True,93,1,0,6.970940678582142,9,2
user_007741,30,<30k,mobile,returning,Midwest,53,True,75,5,0,True,True,True,24,6,0,7.963404312154124,51,-1
user_007742,51,30k-50k,desktop,returning,West,45,True,84,1,1,False,True,True,48,2,0,4.107344151025102,36,-1
user_007743,57,30k-50k,mobile,new,East,37,True,125,5,0,False,False,False,0,0,0,,125,5
user_007744,27,50k-75k,desktop,new,Midwest,74,True,76,2,0,True,True,True,108,3,0,6.04072494651804,-32,-1
user_007745,53,75k-100k,mobile,returning,Midwest,49,True,82,3,0,False,True,True,54,4,0,6.574597312230695,28,-1
user_007746,39,100k-150k,desktop,returning,West,73,True,101,2,0,True,True,True,76,1,0,9.767699548763016,25,1
user_007747,25,30k-50k,mobile,returning,East,90,False,0,0,0,True,True,True,90,1,0,10.0,-90,-1
user_007748,45,75k-100k,desktop,new,South,38,True,130,1,0,True,True,True,131,1,0,5.677785194174866,-1,0
user_007749,41,>150k,desktop,returning,Midwest,58,True,66,3,0,False,False,True,86,7,0,7.655031710936738,-20,-4
user_007750,58,30k-50k,mobile,returning,South,22,True,97,2,0,False,False,True,116,1,0,8.377408660983646,-19,1
user_007751,47,30k-50k,mobile,returning,East,45,True,90,4,0,True,True,True,61,3,0,5.7544933519845465,29,1
user_007752,65,>150k,desktop,new,East,64,True,123,5,0,False,True,True,124,5,0,7.791286597669213,-1,0
user_007753,73,100k-150k,desktop,returning,Midwest,36,True,134,1,0,False,True,True,55,1,1,8.750673957395739,79,0
user_007754,40,75k-100k,mobile,returning,West,70,True,172,5,0,True,True,True,159,4,0,8.623625617637751,13,1
user_007755,35,100k-150k,mobile,returning,West,83,True,30,2,0,True,True,True,64,1,0,9.297657882243303,-34,1
user_007756,62,50k-75k,mobile,returning,South,29,True,131,5,0,False,False,True,125,2,0,7.459805503202558,6,3
user_007757,52,75k-100k,mobile,new,Midwest,30,True,57,6,1,False,False,True,69,1,0,4.795527490108559,-12,5
user_007758,24,75k-100k,mobile,returning,South,54,True,116,4,0,False,False,True,99,7,0,6.646582140135321,17,-3
user_007759,43,75k-100k,mobile,returning,South,52,True,92,4,0,False,True,True,89,4,0,7.420722840358127,3,0
user_007760,58,75k-100k,desktop,new,West,40,True,120,2,0,False,False,True,80,1,0,7.30732043080321,40,1
user_007761,46,50k-75k,desktop,returning,Midwest,35,False,0,0,0,False,False,True,142,1,0,7.6223035866194815,-142,-1
user_007762,43,75k-100k,desktop,returning,East,63,True,84,2,0,False,True,True,62,1,1,6.414227673312499,22,1
user_007763,39,50k-75k,desktop,returning,Midwest,32,True,121,5,0,True,False,True,125,6,0,6.345262531767526,-4,-1
user_007764,37,<30k,mobile,returning,South,36,True,75,1,1,False,False,False,0,0,0,,75,1
user_007765,69,30k-50k,desktop,returning,South,26,True,104,3,0,False,False,True,91,4,0,6.836063966513945,13,-1
user_007766,65,30k-50k,mobile,new,West,44,False,0,0,0,False,False,True,90,1,0,6.666808955661373,-90,-1
user_007767,76,100k-150k,tablet,returning,Midwest,26,True,135,5,0,False,True,True,84,3,0,7.734405270692484,51,2
user_007768,52,100k-150k,desktop,returning,Midwest,60,True,101,1,0,True,True,True,68,1,0,9.188577345715466,33,0
user_007769,63,>150k,desktop,returning,South,41,True,64,1,0,False,True,True,20,1,0,7.318518448703182,44,0
user_007770,40,<30k,desktop,returning,Midwest,44,True,93,1,0,True,True,True,67,1,0,8.056854207974917,26,0
user_007771,66,30k-50k,desktop,returning,South,21,True,107,3,0,False,False,True,103,3,0,8.735073640319198,4,0
user_007772,33,50k-75k,desktop,new,East,84,False,0,0,0,True,True,True,112,1,0,8.232747889214354,-112,-1
user_007773,33,50k-75k,mobile,new,East,58,True,120,2,1,False,True,True,98,1,1,8.689150362340644,22,1
user_007774,32,75k-100k,desktop,returning,South,41,True,30,1,0,False,True,True,20,1,0,9.0642798036414,10,0
user_007775,44,<30k,mobile,new,East,40,True,112,7,0,False,False,True,101,5,0,9.023598628886125,11,2
user_007776,66,30k-50k,mobile,new,West,52,True,102,5,0,False,False,True,69,4,0,7.433777900391437,33,1
user_007777,53,100k-150k,desktop,returning,Midwest,63,True,104,4,0,True,True,True,87,1,0,8.42421160520189,17,3
user_007778,58,30k-50k,mobile,new,South,28,True,138,3,0,False,True,True,116,1,0,6.934864585557701,22,2
user_007779,34,50k-75k,mobile,returning,Midwest,83,True,65,2,0,False,True,True,72,3,0,10.0,-7,-1
user_007780,38,75k-100k,mobile,returning,East,49,False,0,0,0,True,True,True,98,1,0,4.972322802364672,-98,-1
user_007781,64,100k-150k,mobile,returning,West,39,True,74,6,0,False,True,True,20,7,1,7.991095175067577,54,-1
user_007782,38,50k-75k,desktop,returning,Midwest,43,True,68,2,0,False,True,True,62,1,0,6.948149135536648,6,1
user_007783,69,75k-100k,desktop,returning,East,38,True,121,8,0,True,False,True,156,12,0,7.719386533548533,-35,-4
user_007784,45,75k-100k,desktop,returning,Midwest,44,True,69,4,0,False,True,True,55,6,0,9.74123476569754,14,-2
user_007785,54,75k-100k,mobile,returning,Midwest,49,True,123,3,0,True,True,True,100,1,0,7.980549133167705,23,2
user_007786,31,100k-150k,mobile,returning,Midwest,71,True,30,6,0,False,True,True,20,6,0,8.167729912410326,10,0
user_007787,32,30k-50k,mobile,returning,West,69,True,142,2,0,True,True,True,84,1,0,7.024629349669812,58,1
user_007788,32,75k-100k,mobile,new,East,45,True,160,3,0,False,False,True,126,3,0,5.957710332332423,34,0
user_007789,69,75k-100k,mobile,new,East,30,True,32,3,0,False,False,True,25,1,0,7.261300238541644,7,2
user_007790,47,50k-75k,desktop,returning,Midwest,36,True,114,2,0,False,False,True,102,1,0,5.383005424073445,12,1
user_007791,48,75k-100k,mobile,returning,West,69,True,94,1,0,True,True,True,62,1,0,6.812176574860342,32,0
user_007792,42,75k-100k,desktop,returning,East,51,True,31,3,0,False,False,True,29,3,0,7.035216613184311,2,0
user_007793,18,50k-75k,desktop,new,West,95,True,88,6,0,False,True,True,69,8,0,8.633302616464558,19,-2
user_007794,48,50k-75k,desktop,returning,East,50,True,74,2,0,False,True,True,78,4,0,9.038127729625485,-4,-2
user_007795,42,>150k,desktop,new,East,79,False,0,0,0,True,True,True,113,2,0,7.124989989410677,-113,-2
user_007796,71,>150k,desktop,returning,West,51,True,91,4,0,False,True,True,81,4,0,7.010384409250179,10,0
user_007797,31,100k-150k,desktop,new,South,82,True,36,2,0,False,True,True,20,1,0,8.496550319886364,16,1
user_007798,71,50k-75k,desktop,returning,South,5,True,89,3,0,True,False,True,100,5,1,5.560470720671057,-11,-2
user_007799,40,30k-50k,desktop,new,West,42,True,135,3,0,False,True,True,97,3,0,6.961340501064096,38,0
user_007800,22,<30k,mobile,returning,East,50,False,0,0,0,True,False,False,0,0,0,,0,0
user_007801,48,50k-75k,desktop,returning,East,51,True,108,3,1,False,True,True,93,2,0,6.512912400668507,15,1
user_007802,36,100k-150k,mobile,returning,West,100,True,120,4,0,True,True,True,113,3,0,6.344718954720906,7,1
user_007803,60,50k-75k,desktop,returning,Midwest,20,True,82,2,0,False,False,True,72,3,0,7.27150105806709,10,-1
user_007804,42,50k-75k,desktop,returning,South,49,True,106,2,1,False,False,True,95,3,0,8.422072468223634,11,-1
user_007805,53,50k-75k,mobile,new,East,56,True,117,2,0,False,True,True,108,2,0,6.308332787922089,9,0
user_007806,44,100k-150k,mobile,returning,East,43,True,30,4,0,True,False,True,53,6,0,6.164507711724337,-23,-2
user_007807,18,100k-150k,mobile,returning,Midwest,78,True,30,1,1,False,True,True,35,1,1,8.504109443752451,-5,0
user_007808,63,<30k,desktop,returning,East,26,True,162,4,1,True,False,True,161,2,0,4.852237482816478,1,2
user_007809,47,30k-50k,desktop,returning,West,64,True,121,3,0,True,True,True,96,1,0,10.0,25,2
user_007810,45,<30k,desktop,returning,South,34,True,118,6,0,True,False,True,123,6,0,7.6471764143017955,-5,0
user_007811,35,<30k,desktop,new,East,57,False,0,0,0,True,True,True,64,1,0,6.740792342002832,-64,-1
user_007812,29,100k-150k,mobile,new,Midwest,73,True,96,1,0,False,True,True,43,1,0,8.23241441011562,53,0
user_007813,22,100k-150k,desktop,returning,Midwest,92,True,52,2,0,True,True,True,37,1,0,9.595475792073138,15,1
user_007814,52,75k-100k,mobile,new,Midwest,16,True,134,1,0,True,False,True,100,1,0,6.015490052361081,34,0
user_007815,47,75k-100k,desktop,new,Midwest,55,True,131,2,0,False,True,True,99,1,0,8.651117944317365,32,1
user_007816,59,75k-100k,desktop,returning,East,32,True,54,3,0,True,False,True,20,3,0,7.499701438778021,34,0
user_007817,44,30k-50k,mobile,returning,Midwest,42,True,30,6,0,True,False,True,39,4,0,7.500252354491056,-9,2
user_007818,62,50k-75k,mobile,returning,West,30,True,63,5,1,False,False,True,85,5,0,7.917613310818046,-22,0
user_007819,45,100k-150k,desktop,new,Midwest,74,False,0,0,0,True,True,True,72,1,0,6.629948076916736,-72,-1
user_007820,26,50k-75k,tablet,returning,South,74,True,52,4,1,True,True,True,48,3,0,7.4153144851453945,4,1
user_007821,43,30k-50k,desktop,returning,East,65,True,119,4,0,True,True,True,80,2,0,6.9264981620620585,39,2
user_007822,38,75k-100k,mobile,returning,East,81,False,0,0,0,True,True,True,114,1,0,8.9012711552302,-114,-1
user_007823,18,50k-75k,mobile,new,South,56,False,0,0,0,False,True,True,105,1,0,10.0,-105,-1
user_007824,44,50k-75k,desktop,new,West,43,True,96,2,0,True,True,True,80,3,0,8.222151490478701,16,-1
user_007825,58,100k-150k,mobile,returning,South,26,True,141,3,1,False,False,True,115,3,0,5.90577667178761,26,0
user_007826,49,75k-100k,desktop,returning,East,26,True,128,2,1,True,True,True,94,1,0,10.0,34,1
user_007827,20,<30k,mobile,returning,East,53,True,79,2,0,True,False,True,83,5,0,7.509825648863531,-4,-3
user_007828,32,30k-50k,mobile,returning,South,66,True,90,4,0,False,False,True,106,3,0,9.186010489527506,-16,1
user_007829,80,75k-100k,desktop,returning,Midwest,32,False,0,0,0,False,False,True,115,2,0,8.115021686193542,-115,-2
user_007830,71,<30k,desktop,returning,Midwest,28,True,173,3,0,True,False,True,160,1,0,6.217236419115516,13,2
user_007831,31,75k-100k,mobile,returning,Midwest,83,True,83,3,0,True,True,True,106,2,0,8.568826315745914,-23,1
user_007832,48,100k-150k,desktop,returning,South,70,True,61,1,0,True,True,True,74,1,0,8.30518637558957,-13,0
user_007833,74,30k-50k,tablet,returning,West,14,True,116,2,0,True,True,True,65,2,0,7.290775149409352,51,0
user_007834,42,<30k,mobile,returning,South,0,False,0,0,0,False,False,False,0,0,0,,0,0
user_007835,40,50k-75k,desktop,returning,West,33,False,0,0,0,False,True,True,74,1,0,8.41629135407738,-74,-1
user_007836,46,>150k,desktop,returning,West,90,True,58,2,0,True,True,True,58,3,0,7.4397270448140995,0,-1
user_007837,38,100k-150k,mobile,returning,East,54,True,83,6,1,False,True,True,60,8,1,9.42546869391159,23,-2
user_007838,18,<30k,mobile,returning,West,59,True,82,5,0,True,False,True,51,3,0,6.583978556972397,31,2
user_007839,54,50k-75k,mobile,returning,East,25,True,120,7,1,True,False,True,177,7,0,5.48562651987544,-57,0
user_007840,59,<30k,desktop,returning,Midwest,0,True,120,3,0,False,False,True,104,4,0,5.677751031074307,16,-1
user_007841,54,75k-100k,mobile,new,West,42,True,90,5,0,False,False,True,125,8,0,7.34325340718489,-35,-3
user_007842,23,100k-150k,mobile,new,West,87,True,91,3,1,True,True,True,61,1,1,8.594096991602857,30,2
user_007843,48,30k-50k,mobile,returning,Midwest,52,True,97,3,0,False,True,True,76,1,0,7.478865201979957,21,2
user_007844,30,30k-50k,desktop,new,Midwest,63,True,74,2,0,True,False,False,0,0,0,,74,2
user_007845,68,30k-50k,mobile,returning,East,34,False,0,0,0,False,False,True,144,2,0,6.52419838521281,-144,-2
user_007846,18,30k-50k,desktop,returning,South,51,True,103,2,0,True,True,True,69,1,0,8.052294462662541,34,1
user_007847,36,75k-100k,mobile,new,East,55,True,137,2,0,False,True,True,104,5,0,6.834698430752177,33,-3
user_007848,40,75k-100k,mobile,returning,East,42,True,107,2,0,False,False,True,115,2,0,7.80842713495211,-8,0
user_007849,59,30k-50k,mobile,returning,South,36,True,82,5,0,True,True,True,39,3,0,8.07089381676556,43,2
user_007850,62,>150k,desktop,new,South,54,True,142,2,0,False,True,True,94,1,0,7.202630421481091,48,1
user_007851,52,100k-150k,desktop,returning,East,74,True,42,4,0,False,False,True,55,2,0,5.860631177299175,-13,2
user_007852,32,50k-75k,desktop,returning,West,67,True,119,1,0,True,True,True,98,1,0,6.62926252357138,21,0
user_007853,36,100k-150k,mobile,returning,South,54,True,64,1,0,True,False,True,59,1,0,5.596909195811228,5,0
user_007854,52,100k-150k,desktop,new,South,66,False,0,0,0,True,False,True,97,2,1,5.361970644940167,-97,-2
user_007855,19,30k-50k,mobile,returning,East,89,True,69,1,0,False,True,True,30,1,0,10.0,39,0
user_007856,39,<30k,desktop,returning,East,66,True,94,4,0,True,True,True,56,4,0,9.903753971813831,38,0
user_007857,30,75k-100k,mobile,new,Midwest,72,True,137,3,0,True,True,True,110,2,0,8.030163990688795,27,1
user_007858,56,30k-50k,mobile,returning,East,21,True,160,6,1,False,False,False,0,0,0,,160,6
user_007859,47,30k-50k,mobile,new,South,58,True,134,2,1,False,False,True,154,1,0,6.210654415869318,-20,1
user_007860,34,50k-75k,desktop,new,Midwest,67,True,118,1,1,True,True,True,100,1,0,7.136063094534027,18,0
user_007861,40,100k-150k,desktop,new,East,79,True,79,2,0,True,True,True,106,1,0,9.237529675583914,-27,1
user_007862,56,50k-75k,desktop,returning,Midwest,12,True,104,4,0,True,False,True,56,5,0,5.635483318165874,48,-1
user_007863,42,50k-75k,desktop,new,East,40,True,132,4,0,False,False,True,95,8,1,4.479717683311058,37,-4
user_007864,40,<30k,desktop,returning,Midwest,23,True,139,1,1,False,False,True,141,1,0,7.792991249887496,-2,0
user_007865,46,>150k,mobile,returning,East,62,True,71,4,0,False,True,True,55,7,0,10.0,16,-3
user_007866,54,30k-50k,desktop,new,East,16,True,174,7,0,True,False,True,208,4,0,8.286579395606305,-34,3
user_007867,31,100k-150k,tablet,returning,South,80,False,0,0,0,False,True,True,98,1,0,8.682043077896147,-98,-1
user_007868,25,75k-100k,mobile,new,Midwest,81,True,69,2,0,True,True,True,67,3,0,8.801361908236165,2,-1
user_007869,53,75k-100k,desktop,returning,Midwest,40,True,94,2,0,True,True,True,63,1,0,8.125581672491892,31,1
user_007870,47,100k-150k,desktop,returning,East,69,True,47,1,0,True,True,True,38,1,0,8.470447587729705,9,0
user_007871,47,30k-50k,mobile,returning,South,47,True,88,4,0,False,True,True,81,6,0,8.807054361091536,7,-2
user_007872,63,30k-50k,mobile,returning,Midwest,13,False,0,0,0,False,False,True,110,2,1,9.091373504979005,-110,-2
user_007873,56,50k-75k,desktop,returning,Midwest,17,True,117,4,0,True,True,True,66,4,1,7.07126749403026,51,0
user_007874,36,30k-50k,desktop,returning,West,64,True,83,1,0,False,True,True,90,2,0,9.44652891900012,-7,-1
user_007875,18,100k-150k,desktop,new,South,77,True,115,5,0,False,True,True,106,6,0,9.627005630860278,9,-1
user_007876,39,100k-150k,desktop,returning,South,67,True,69,1,0,True,True,True,41,1,0,9.176338339604026,28,0
user_007877,33,100k-150k,mobile,returning,South,96,True,106,2,0,False,True,True,75,3,1,9.096743675869565,31,-1
user_007878,52,75k-100k,desktop,new,South,54,True,78,2,1,False,False,True,120,7,1,6.092132606959515,-42,-5
user_007879,50,50k-75k,mobile,returning,East,64,False,0,0,0,False,False,True,137,1,0,6.082322835278112,-137,-1
user_007880,59,<30k,mobile,returning,Midwest,30,True,39,3,0,False,True,True,30,1,0,8.416231805074982,9,2
user_007881,58,50k-75k,desktop,returning,Midwest,51,True,115,2,0,False,False,True,117,2,0,6.984144777691974,-2,0
user_007882,71,30k-50k,mobile,new,South,0,True,175,2,0,True,False,False,0,0,0,,175,2
user_007883,52,100k-150k,mobile,returning,East,59,True,112,4,0,True,True,True,39,2,0,8.444996778342434,73,2
user_007884,42,75k-100k,mobile,returning,South,34,True,52,4,0,False,True,True,20,4,0,9.828492139828281,32,0
user_007885,70,100k-150k,desktop,returning,East,50,False,0,0,0,True,True,True,87,1,0,7.116203389820139,-87,-1
user_007886,40,30k-50k,desktop,returning,South,33,True,101,3,0,False,True,True,116,1,0,7.994468311143982,-15,2
user_007887,48,50k-75k,desktop,returning,East,50,True,95,3,0,True,True,True,84,2,0,8.518474721616421,11,1
user_007888,18,50k-75k,desktop,new,South,85,True,97,1,0,False,False,True,124,2,1,9.401878172128944,-27,-1
user_007889,24,<30k,mobile,new,East,62,True,159,5,0,True,True,True,138,5,0,9.64491807178177,21,0
user_007890,51,75k-100k,desktop,new,South,61,True,111,1,0,False,False,True,115,1,0,7.888491721513549,-4,0
user_007891,29,75k-100k,desktop,new,Midwest,47,True,123,1,1,False,True,True,78,3,0,7.589825235543813,45,-2
user_007892,60,100k-150k,desktop,returning,South,43,True,65,3,0,False,True,True,62,1,0,5.313559993142423,3,2
user_007893,44,30k-50k,desktop,new,West,32,True,79,2,1,False,False,True,67,1,1,7.009436545502234,12,1
user_007894,46,100k-150k,desktop,new,South,70,True,107,3,0,False,True,True,115,3,0,8.574347817795386,-8,0
user_007895,55,<30k,desktop,returning,East,30,False,0,0,0,False,True,False,0,0,0,,0,0
user_007896,36,50k-75k,mobile,returning,South,42,True,62,1,0,False,False,True,82,1,0,7.0488938874876785,-20,0
user_007897,43,75k-100k,mobile,new,South,45,True,146,3,0,True,True,True,110,1,0,8.818943330673916,36,2
user_007898,41,50k-75k,mobile,new,Midwest,65,True,156,3,0,False,False,True,155,3,0,7.747373455383628,1,0
user_007899,42,50k-75k,mobile,returning,East,34,True,72,1,0,False,False,True,86,1,0,7.325302095599548,-14,0
user_007900,80,<30k,desktop,returning,West,3,True,98,7,0,True,False,False,0,0,0,,98,7
user_007901,22,>150k,mobile,returning,East,85,True,30,2,1,True,True,True,20,1,1,6.677905904971536,10,1
user_007902,60,30k-50k,mobile,new,East,54,True,88,1,0,False,True,True,90,1,0,8.335684923513917,-2,0
user_007903,51,50k-75k,mobile,new,South,41,True,134,2,0,False,True,True,63,1,0,7.977968016923507,71,1
user_007904,60,100k-150k,mobile,returning,Midwest,50,True,118,1,0,False,True,True,96,1,0,6.749271442295588,22,0
user_007905,35,50k-75k,desktop,returning,South,48,True,76,3,0,False,True,True,24,5,0,8.405641485432845,52,-2
user_007906,34,30k-50k,desktop,new,East,66,True,97,3,0,False,True,True,39,2,0,10.0,58,1
user_007907,77,30k-50k,mobile,returning,South,33,True,168,2,0,True,False,False,0,0,0,,168,2
user_007908,64,50k-75k,desktop,returning,West,43,True,61,1,0,False,False,True,64,1,1,5.205490462816547,-3,0
user_007909,43,75k-100k,desktop,new,South,44,True,113,2,0,True,False,True,112,1,1,9.253677232838564,1,1
user_007910,47,50k-75k,mobile,returning,South,55,True,110,1,0,False,True,True,79,1,0,8.786779255777272,31,0
user_007911,41,50k-75k,tablet,returning,South,52,False,0,0,0,False,False,False,0,0,0,,0,0
user_007912,28,<30k,mobile,returning,South,59,True,43,4,0,True,True,True,46,2,1,8.23671084165994,-3,2
user_007913,37,<30k,tablet,returning,Midwest,76,False,0,0,0,True,True,False,0,0,0,,0,0
user_007914,43,75k-100k,mobile,returning,West,66,True,84,1,0,False,True,True,44,2,1,8.88771491116026,40,-1
user_007915,61,50k-75k,mobile,new,East,3,False,0,0,0,False,True,True,119,1,0,6.907792437660939,-119,-1
user_007916,24,30k-50k,mobile,returning,Midwest,85,True,35,5,0,True,True,True,52,5,0,8.822594760228293,-17,0
user_007917,18,30k-50k,mobile,new,West,67,True,100,7,0,False,True,True,65,7,0,10.0,35,0
user_007918,33,30k-50k,mobile,returning,South,77,True,72,4,0,False,False,True,52,8,0,7.16924182162176,20,-4
user_007919,49,30k-50k,desktop,new,East,82,True,58,6,0,False,False,True,67,5,1,6.535547579830714,-9,1
user_007920,30,50k-75k,mobile,returning,Midwest,87,True,81,1,1,False,True,True,21,2,0,8.346889641141995,60,-1
user_007921,52,75k-100k,tablet,returning,East,69,True,81,3,0,False,False,True,67,2,0,7.776433340673142,14,1
user_007922,44,100k-150k,desktop,returning,Midwest,46,True,67,1,0,True,True,True,35,1,0,7.654911399848912,32,0
user_007923,54,<30k,mobile,returning,East,48,True,55,5,0,False,False,True,60,6,0,9.008347284935315,-5,-1
user_007924,61,<30k,mobile,returning,West,44,False,0,0,0,False,False,True,106,1,0,4.947664701345945,-106,-1
user_007925,30,50k-75k,desktop,new,South,54,True,97,3,0,False,True,True,105,2,1,9.265407739508051,-8,1
user_007926,58,50k-75k,mobile,returning,East,27,True,96,4,0,True,False,True,104,6,0,8.012808207781617,-8,-2
user_007927,47,<30k,mobile,new,Midwest,36,False,0,0,0,True,False,False,0,0,0,,0,0
user_007928,55,50k-75k,mobile,new,East,65,True,100,4,0,True,True,True,60,3,1,8.10211595316035,40,1
user_007929,35,30k-50k,desktop,returning,South,38,True,83,3,0,True,True,True,20,3,1,5.285085213143354,63,0
user_007930,56,<30k,mobile,returning,South,0,True,158,2,0,True,False,True,167,1,0,8.185207185148673,-9,1
user_007931,49,75k-100k,mobile,new,Midwest,49,True,123,4,0,False,True,True,89,1,1,8.958585240411608,34,3
user_007932,21,75k-100k,mobile,returning,South,51,False,0,0,0,True,True,True,100,1,0,8.668067744537366,-100,-1
user_007933,53,50k-75k,tablet,new,Midwest,53,True,142,3,0,True,True,True,110,4,0,7.7399396772519165,32,-1
user_007934,29,50k-75k,desktop,new,West,73,True,148,1,0,False,True,True,76,1,0,6.312596974398987,72,0
user_007935,40,75k-100k,mobile,returning,East,46,True,73,2,0,True,False,True,49,1,0,7.0116044724079,24,1
user_007936,39,30k-50k,desktop,new,East,36,True,108,3,0,False,False,True,128,5,0,5.370335870501407,-20,-2
user_007937,57,50k-75k,desktop,returning,East,59,True,111,4,1,False,False,True,115,6,0,4.264510577704533,-4,-2
user_007938,28,<30k,mobile,returning,East,56,True,136,2,0,True,True,True,100,1,0,8.7840032265238,36,1
user_007939,50,100k-150k,mobile,new,East,64,True,123,4,0,False,False,True,165,1,0,6.650512717297503,-42,3
user_007940,69,<30k,desktop,new,Midwest,2,True,176,4,1,False,False,False,0,0,0,,176,4
user_007941,18,30k-50k,desktop,returning,East,80,True,85,3,0,False,False,True,82,1,0,7.121447014298479,3,2
user_007942,40,100k-150k,desktop,returning,West,61,True,86,3,0,True,True,True,42,4,0,8.036477848258768,44,-1
user_007943,43,30k-50k,mobile,new,South,87,True,89,2,1,True,True,True,94,1,0,10.0,-5,1
user_007944,48,75k-100k,mobile,returning,East,45,True,68,4,0,True,False,True,77,2,0,6.2744482238995705,-9,2
user_007945,42,50k-75k,desktop,returning,South,58,True,123,1,1,False,False,True,120,1,0,7.5093940092582345,3,0
user_007946,59,75k-100k,mobile,returning,East,33,True,82,5,0,True,True,True,59,4,0,8.239444128679104,23,1
user_007947,44,100k-150k,tablet,returning,West,88,True,63,1,0,True,True,True,62,1,1,9.967098152531445,1,0
user_007948,41,100k-150k,desktop,returning,Midwest,62,True,54,4,0,True,True,True,42,1,0,7.8074941731627305,12,3
user_007949,60,>150k,mobile,new,East,64,True,116,6,0,False,True,True,111,4,0,8.34363488295877,5,2
user_007950,67,30k-50k,desktop,returning,Midwest,7,False,0,0,0,False,False,False,0,0,0,,0,0
user_007951,44,100k-150k,desktop,new,West,72,True,99,2,0,True,True,True,84,1,0,10.0,15,1
user_007952,37,50k-75k,desktop,returning,East,30,False,0,0,0,False,False,False,0,0,0,,0,0
user_007953,60,<30k,desktop,returning,Midwest,0,False,0,0,0,False,False,True,93,1,0,7.50458646294988,-93,-1
user_007954,72,50k-75k,mobile,returning,West,42,True,54,6,0,True,False,True,43,6,0,7.809680377231394,11,0
user_007955,59,50k-75k,desktop,new,West,9,True,163,1,1,False,False,True,171,1,1,8.44856483596647,-8,0
user_007956,37,75k-100k,desktop,returning,East,25,True,132,2,0,False,True,True,116,1,0,9.130499767771793,16,1
user_007957,52,30k-50k,desktop,returning,East,46,True,60,3,0,False,False,True,55,5,0,7.3564146843453395,5,-2
user_007958,26,100k-150k,mobile,new,South,91,True,90,3,0,True,True,False,0,0,0,,90,3
user_007959,37,50k-75k,desktop,new,West,50,True,127,1,0,False,False,True,125,2,0,7.4973997562657235,2,-1
user_007960,18,100k-150k,desktop,returning,Midwest,100,True,124,1,0,True,True,True,112,1,0,8.138550363022427,12,0
user_007961,74,100k-150k,desktop,new,South,52,True,128,1,1,True,True,True,131,2,0,9.33666006936844,-3,-1
user_007962,70,30k-50k,mobile,new,East,36,False,0,0,0,False,False,False,0,0,0,,0,0
user_007963,33,75k-100k,mobile,returning,Midwest,48,True,86,2,0,False,True,True,102,3,0,9.289895120169724,-16,-1
user_007964,64,50k-75k,desktop,new,Midwest,14,True,137,7,0,False,False,True,152,4,0,8.088852516591219,-15,3
user_007965,56,100k-150k,desktop,returning,West,80,True,38,1,0,True,True,True,25,1,0,9.98687933856399,13,0
user_007966,31,75k-100k,desktop,new,Midwest,45,False,0,0,0,False,True,True,94,1,0,8.837809115978544,-94,-1
user_007967,50,50k-75k,mobile,returning,South,46,True,41,4,0,False,True,True,31,2,0,9.349135278830405,10,2
user_007968,68,75k-100k,tablet,returning,East,26,True,136,5,0,False,False,True,128,4,0,6.500509412435457,8,1
user_007969,50,75k-100k,desktop,returning,South,22,True,98,4,1,False,False,True,97,7,0,7.955625967044456,1,-3
user_007970,28,75k-100k,mobile,returning,South,44,True,114,3,0,False,True,True,95,1,0,6.821737009031749,19,2
user_007971,50,75k-100k,mobile,returning,East,56,True,32,4,0,True,False,True,24,2,0,6.498987214456499,8,2
user_007972,51,30k-50k,desktop,returning,Midwest,36,True,41,4,1,True,False,True,22,3,1,7.344820586566057,19,1
user_007973,67,30k-50k,desktop,new,East,20,True,162,3,0,False,False,True,136,3,0,6.433784405252692,26,0
user_007974,36,<30k,desktop,returning,West,55,True,82,2,0,True,False,True,95,1,0,5.9992568290204735,-13,1
user_007975,43,75k-100k,desktop,returning,East,49,True,68,1,0,True,True,True,57,1,0,9.142978055743521,11,0
user_007976,48,100k-150k,desktop,returning,South,75,True,116,5,0,True,True,True,101,4,0,9.67296791480933,15,1
user_007977,43,<30k,desktop,new,East,57,True,148,3,0,False,False,True,140,3,0,7.88806878478415,8,0
user_007978,54,30k-50k,mobile,returning,South,50,True,100,2,0,True,True,True,51,1,0,7.819680173903189,49,1
user_007979,33,<30k,mobile,returning,West,66,False,0,0,0,True,False,True,138,2,1,6.603590636716505,-138,-2
user_007980,55,50k-75k,mobile,new,South,36,True,151,4,0,False,False,True,151,5,0,7.6224529216748635,0,-1
user_007981,32,50k-75k,desktop,new,East,51,True,158,3,0,False,True,True,115,1,0,7.057487262417343,43,2
user_007982,43,50k-75k,desktop,new,South,39,False,0,0,0,True,False,False,0,0,0,,0,0
user_007983,43,30k-50k,desktop,new,Midwest,26,False,0,0,0,False,False,True,122,1,0,6.2744480960042255,-122,-1
user_007984,56,50k-75k,mobile,returning,South,7,True,114,4,0,True,False,True,127,2,0,6.712730080126536,-13,2
user_007985,39,50k-75k,desktop,returning,West,65,True,51,2,1,True,False,True,50,1,0,5.411913793785308,1,1
user_007986,59,30k-50k,desktop,new,West,38,True,141,3,0,True,False,False,0,0,0,,141,3
user_007987,34,30k-50k,mobile,new,East,93,False,0,0,0,True,True,True,146,1,0,8.15465407436574,-146,-1
user_007988,49,75k-100k,desktop,returning,East,77,True,70,1,0,True,True,True,65,3,0,10.0,5,-2
user_007989,37,100k-150k,desktop,returning,South,61,True,74,6,0,True,True,True,85,3,0,8.760307154368304,-11,3
user_007990,29,50k-75k,mobile,new,East,53,True,113,5,0,False,True,True,90,8,0,7.84576949601465,23,-3
user_007991,62,50k-75k,mobile,new,South,24,False,0,0,0,False,False,True,116,3,0,6.898597346149347,-116,-3
user_007992,51,100k-150k,desktop,returning,Midwest,45,True,118,2,0,False,True,True,112,2,0,8.177532489564124,6,0
user_007993,27,50k-75k,desktop,returning,Midwest,73,True,67,2,0,False,True,True,58,1,0,7.982132043619896,9,1
user_007994,28,50k-75k,desktop,returning,East,53,True,56,2,0,True,True,True,31,3,1,8.535612329467051,25,-1
user_007995,62,75k-100k,desktop,new,West,48,True,76,2,0,False,False,True,43,1,0,5.680332762493456,33,1
user_007996,50,<30k,desktop,returning,West,46,True,98,2,0,False,True,True,71,1,0,9.657973718250252,27,1
user_007997,45,<30k,desktop,returning,West,41,True,89,3,0,True,True,True,41,1,0,8.343412932107958,48,2
user_007998,65,75k-100k,mobile,returning,East,17,True,74,2,1,False,False,True,40,3,1,6.875744395810666,34,-1
user_007999,67,30k-50k,desktop,returning,East,25,True,113,1,0,False,False,False,0,0,0,,113,1
user_008000,18,75k-100k,desktop,returning,South,77,True,73,4,0,True,True,True,55,4,0,9.822648225522594,18,0
user_008001,43,75k-100k,mobile,returning,East,71,True,51,4,1,True,True,False,0,0,0,,51,4
user_008002,37,50k-75k,mobile,returning,Midwest,50,True,119,1,0,True,False,False,0,0,0,,119,1
user_008003,54,50k-75k,desktop,new,East,70,True,92,3,0,True,True,False,0,0,0,,92,3
user_008004,41,30k-50k,mobile,new,East,45,False,0,0,0,False,False,True,140,1,1,6.9893195490568205,-140,-1
user_008005,49,75k-100k,desktop,returning,East,43,True,57,1,1,True,True,True,35,1,0,7.465525635240346,22,0
user_008006,62,<30k,mobile,new,East,14,True,116,5,0,False,False,False,0,0,0,,116,5
user_008007,47,30k-50k,desktop,returning,East,36,True,78,6,0,False,True,True,35,6,1,8.360788752602536,43,0
user_008008,41,100k-150k,mobile,returning,Midwest,39,True,64,3,0,True,False,True,76,1,0,7.326229443391779,-12,2
user_008009,49,<30k,mobile,returning,South,14,False,0,0,0,True,True,True,98,1,0,5.125131352845427,-98,-1
user_008010,44,30k-50k,mobile,returning,South,59,True,95,7,0,True,True,True,57,3,0,7.649282477324727,38,4
user_008011,34,50k-75k,desktop,new,South,80,True,84,4,0,False,True,True,31,1,1,7.521109932289815,53,3
user_008012,43,75k-100k,mobile,returning,Midwest,24,True,119,5,0,False,False,True,110,7,0,7.89735386777564,9,-2
user_008013,50,100k-150k,desktop,returning,East,69,True,103,2,0,True,True,True,70,3,0,7.490841659085889,33,-1
user_008014,38,100k-150k,desktop,new,East,58,True,123,2,0,True,True,True,87,4,0,9.679607841776068,36,-2
user_008015,37,50k-75k,tablet,returning,South,32,True,75,3,0,True,True,True,55,3,0,9.484924667626089,20,0
user_008016,39,75k-100k,mobile,returning,West,43,True,88,3,0,False,True,True,89,6,0,6.6424300768850655,-1,-3
user_008017,49,50k-75k,desktop,returning,South,32,True,104,5,0,True,True,True,98,3,0,8.55896788167712,6,2
user_008018,34,50k-75k,mobile,returning,East,65,True,125,4,0,False,False,True,127,3,0,6.392925489686281,-2,1
user_008019,27,>150k,desktop,new,South,100,True,104,1,0,True,True,True,97,1,0,8.452076544562921,7,0
user_008020,58,50k-75k,desktop,returning,South,8,False,0,0,0,False,False,True,118,2,0,7.362916674755063,-118,-2
user_008021,32,50k-75k,desktop,new,Midwest,59,True,94,4,0,True,True,True,75,6,0,4.932023760860492,19,-2
user_008022,60,75k-100k,mobile,returning,West,31,True,94,5,0,True,True,True,66,5,0,6.408554070095228,28,0
user_008023,34,<30k,desktop,new,East,62,True,136,1,0,False,True,False,0,0,0,,136,1
user_008024,41,75k-100k,mobile,new,East,44,True,90,4,0,False,False,True,110,4,0,6.990043809440847,-20,0
user_008025,40,75k-100k,tablet,returning,East,53,True,64,2,0,False,True,True,56,3,1,10.0,8,-1
user_008026,78,100k-150k,tablet,returning,West,79,True,52,4,0,True,True,True,28,5,0,9.862489837100233,24,-1
user_008027,38,30k-50k,desktop,returning,East,47,True,115,4,0,True,False,True,110,7,0,5.985754672129114,5,-3
user_008028,27,>150k,desktop,returning,West,100,True,92,8,0,False,True,True,26,7,0,9.371966223641445,66,1
user_008029,43,75k-100k,desktop,returning,East,63,True,76,5,0,True,True,True,48,1,0,7.411171698209899,28,4
user_008030,39,<30k,desktop,returning,South,37,True,64,6,0,True,False,True,57,4,1,8.418771753474157,7,2
user_008031,80,75k-100k,mobile,new,East,19,True,180,4,1,True,False,True,183,3,0,6.386566645930409,-3,1
user_008032,29,50k-75k,tablet,returning,South,59,False,0,0,0,False,True,True,97,2,0,8.644091921313926,-97,-2
user_008033,74,50k-75k,mobile,new,West,32,True,118,2,0,True,False,True,120,4,0,8.550007499689261,-2,-2
user_008034,51,75k-100k,desktop,returning,East,50,True,70,1,1,True,True,True,81,1,0,7.859341471905746,-11,0
user_008035,74,<30k,desktop,new,West,21,False,0,0,0,False,False,True,104,2,1,7.862675133316278,-104,-2
user_008036,25,50k-75k,mobile,returning,West,63,False,0,0,0,True,True,True,104,1,0,7.605608581326591,-104,-1
user_008037,64,100k-150k,mobile,new,East,57,True,152,3,0,False,True,True,103,2,0,8.29955284253623,49,1
user_008038,42,75k-100k,desktop,new,South,44,True,188,1,0,True,True,True,133,1,0,9.058979467283912,55,0
user_008039,26,75k-100k,desktop,new,South,100,True,148,2,1,True,True,True,114,3,0,7.340946174389405,34,-1
user_008040,74,50k-75k,mobile,returning,Midwest,45,True,94,3,1,False,True,True,33,3,0,7.36073534615137,61,0
user_008041,52,100k-150k,desktop,new,Midwest,61,True,138,2,0,True,True,True,101,1,1,6.70040671461623,37,1
user_008042,30,75k-100k,mobile,new,East,78,False,0,0,0,True,True,True,79,1,0,7.648569445507851,-79,-1
user_008043,46,75k-100k,desktop,new,Midwest,40,True,96,2,0,False,False,True,110,5,0,5.261988204525452,-14,-3
user_008044,35,>150k,desktop,new,West,86,True,87,1,0,True,True,True,45,1,0,9.723118792222722,42,0
user_008045,50,30k-50k,mobile,returning,East,23,True,170,1,0,True,False,True,188,1,0,7.994192492653852,-18,0
user_008046,24,50k-75k,tablet,new,West,82,True,75,1,0,False,True,False,0,0,0,,75,1
user_008047,45,50k-75k,mobile,returning,East,60,True,87,4,0,True,True,True,91,4,0,7.454054161356691,-4,0
user_008048,27,>150k,desktop,new,South,78,True,79,1,1,True,True,True,56,1,1,6.808136116770562,23,0
user_008049,27,75k-100k,desktop,returning,South,52,True,97,3,0,False,True,True,64,2,0,6.699109101341818,33,1
user_008050,49,75k-100k,desktop,new,West,43,True,61,1,0,False,True,True,36,1,0,10.0,25,0
user_008051,50,<30k,mobile,returning,West,46,True,50,1,0,True,False,True,39,2,0,6.418069466239394,11,-1
user_008052,18,75k-100k,mobile,returning,East,88,True,56,1,0,False,True,True,82,1,0,9.715420276974886,-26,0
user_008053,48,75k-100k,mobile,new,Midwest,69,True,101,3,0,True,False,True,108,5,0,7.962410680073765,-7,-2
user_008054,47,75k-100k,mobile,returning,Midwest,43,True,111,4,0,False,False,True,75,4,0,5.702851055718038,36,0
user_008055,41,100k-150k,tablet,returning,Midwest,66,True,100,7,0,False,True,True,64,6,0,7.561257116593364,36,1
user_008056,62,<30k,mobile,returning,West,32,False,0,0,0,False,False,False,0,0,0,,0,0
user_008057,23,30k-50k,mobile,new,East,52,True,84,4,1,False,True,True,68,3,1,8.093098621907618,16,1
user_008058,36,50k-75k,desktop,new,East,40,True,95,3,0,False,False,True,93,3,0,7.787235413549761,2,0
user_008059,48,30k-50k,desktop,returning,South,58,True,91,2,0,False,True,True,80,4,0,7.846296278687715,11,-2
user_008060,49,30k-50k,desktop,returning,South,60,True,128,1,0,False,False,True,76,2,0,6.93020664690322,52,-1
user_008061,45,75k-100k,desktop,returning,South,57,False,0,0,0,False,False,True,132,1,0,6.712963914616087,-132,-1
user_008062,36,<30k,mobile,returning,East,5,True,150,3,0,False,True,True,127,1,0,8.608464431681474,23,2
user_008063,57,30k-50k,desktop,returning,East,52,True,117,2,0,True,True,True,69,3,0,7.14654226089288,48,-1
user_008064,67,50k-75k,mobile,returning,East,15,True,64,6,0,False,False,True,83,8,0,7.3468691544349,-19,-2
user_008065,38,100k-150k,desktop,returning,East,60,True,44,7,1,False,False,True,58,6,0,8.21271679236033,-14,1
user_008066,18,<30k,mobile,returning,West,66,False,0,0,0,False,False,False,0,0,0,,0,0
user_008067,63,30k-50k,desktop,returning,East,14,False,0,0,0,False,False,True,132,1,0,7.610057122911394,-132,-1
user_008068,60,50k-75k,desktop,returning,South,18,True,141,9,0,True,False,False,0,0,0,,141,9
user_008069,39,50k-75k,desktop,returning,West,37,True,68,6,1,False,False,True,64,5,0,7.227665391730092,4,1
user_008070,80,<30k,desktop,returning,East,11,True,144,5,2,False,True,True,127,3,0,9.533514906538162,17,2
user_008071,58,<30k,desktop,returning,Midwest,37,True,98,7,0,False,False,False,0,0,0,,98,7
user_008072,32,<30k,desktop,returning,Midwest,44,True,71,2,0,True,True,True,65,4,2,8.806521044201283,6,-2
user_008073,34,100k-150k,mobile,returning,Midwest,82,True,70,4,0,False,True,True,42,4,0,8.453620351191397,28,0
user_008074,64,30k-50k,mobile,returning,South,22,False,0,0,0,True,False,True,138,1,0,7.406844557796744,-138,-1
user_008075,46,30k-50k,desktop,returning,East,78,True,36,1,0,False,True,True,24,1,0,7.067456415736507,12,0
user_008076,37,30k-50k,mobile,new,South,46,True,105,10,0,False,True,True,81,12,0,9.755786717277935,24,-2
user_008077,35,30k-50k,mobile,returning,West,69,False,0,0,0,True,True,True,83,1,0,8.854549273628539,-83,-1
user_008078,33,75k-100k,desktop,new,Midwest,54,True,105,6,0,True,True,True,84,8,0,6.073686480418624,21,-2
user_008079,56,<30k,mobile,new,East,10,False,0,0,0,True,True,True,118,1,0,7.9395840414090415,-118,-1
user_008080,58,75k-100k,mobile,returning,South,41,True,43,2,0,True,False,True,20,1,0,6.039446642507763,23,1
user_008081,65,50k-75k,desktop,returning,Midwest,51,True,131,1,0,True,False,True,117,1,0,6.260704504212982,14,0
user_008082,37,<30k,mobile,returning,South,41,False,0,0,0,False,False,True,110,1,0,6.828423045796447,-110,-1
user_008083,18,50k-75k,mobile,returning,South,45,True,111,4,0,True,True,True,103,6,0,8.61940711470916,8,-2
user_008084,26,50k-75k,desktop,new,East,77,True,86,2,0,True,True,True,55,1,0,10.0,31,1
user_008085,21,>150k,mobile,returning,Midwest,75,True,51,2,0,True,False,False,0,0,0,,51,2
user_008086,31,50k-75k,mobile,returning,West,87,True,56,6,1,True,True,True,53,7,1,7.976777291450065,3,-1
user_008087,52,100k-150k,mobile,new,West,99,True,138,3,0,False,True,True,113,2,0,9.081781534284213,25,1
user_008088,43,<30k,mobile,returning,Midwest,54,False,0,0,0,False,True,True,75,1,0,6.830925823147624,-75,-1
user_008089,50,75k-100k,desktop,returning,East,36,True,93,6,0,False,True,True,111,5,0,6.253320863021695,-18,1
user_008090,35,75k-100k,mobile,returning,East,38,True,65,5,0,True,True,True,55,1,0,6.556031312975805,10,4
user_008091,47,30k-50k,mobile,returning,Midwest,32,True,76,5,0,False,True,True,62,6,0,5.203012141465664,14,-1
user_008092,18,<30k,mobile,returning,Midwest,63,True,97,5,1,False,True,True,69,5,0,7.39434778299196,28,0
user_008093,47,75k-100k,mobile,returning,Midwest,57,True,30,1,0,True,True,True,20,1,0,9.528355666015809,10,0
user_008094,60,100k-150k,mobile,new,East,31,True,106,5,0,False,True,False,0,0,0,,106,5
user_008095,57,<30k,desktop,new,West,20,True,108,5,0,True,False,True,137,3,0,7.420452872000124,-29,2
user_008096,38,50k-75k,mobile,returning,South,24,True,142,5,0,False,False,True,171,2,0,7.647319460120537,-29,3
user_008097,71,75k-100k,mobile,returning,South,4,False,0,0,0,True,False,False,0,0,0,,0,0
user_008098,34,50k-75k,desktop,returning,West,84,True,36,2,0,False,True,True,24,1,0,10.0,12,1
user_008099,41,50k-75k,desktop,new,West,48,True,134,1,0,True,False,True,153,1,0,8.111889004899165,-19,0
user_008100,28,75k-100k,tablet,new,West,76,True,104,2,0,True,True,True,68,1,0,10.0,36,1
user_008101,18,<30k,desktop,returning,South,52,True,92,1,1,False,True,True,27,1,0,6.502684191111137,65,0
user_008102,45,75k-100k,desktop,new,East,64,True,69,4,0,False,True,True,43,5,0,8.593356857909608,26,-1
user_008103,57,75k-100k,mobile,returning,West,55,True,70,1,0,True,False,True,90,4,1,6.59236264841265,-20,-3
user_008104,66,<30k,mobile,returning,Midwest,37,True,119,1,0,True,True,True,83,1,0,5.897067350172954,36,0
user_008105,44,75k-100k,desktop,returning,West,40,True,73,5,0,True,True,True,83,3,0,8.292095387799753,-10,2
user_008106,38,75k-100k,desktop,returning,East,24,True,80,2,0,True,True,True,58,3,0,8.002866151502797,22,-1
user_008107,73,<30k,desktop,new,West,50,True,113,3,0,False,False,True,102,3,0,5.000740208334133,11,0
user_008108,54,75k-100k,mobile,new,South,39,True,89,3,1,False,False,True,119,2,0,4.8631651121269535,-30,1
user_008109,48,30k-50k,desktop,new,East,63,True,101,2,0,True,True,True,103,2,0,8.624785038691078,-2,0
user_008110,41,75k-100k,mobile,returning,Midwest,55,True,93,2,0,False,False,True,112,5,0,8.427185269442528,-19,-3
user_008111,20,30k-50k,mobile,returning,West,100,True,70,2,0,True,True,True,48,2,0,9.102244234292499,22,0
user_008112,80,100k-150k,desktop,returning,South,88,True,111,3,1,True,True,True,78,1,0,5.805930117141153,33,2
user_008113,65,50k-75k,desktop,returning,Midwest,0,True,116,3,0,False,False,True,105,4,0,5.997975834710552,11,-1
user_008114,47,100k-150k,mobile,new,Midwest,65,True,100,1,0,True,True,True,65,1,0,8.977788748952959,35,0
user_008115,48,30k-50k,tablet,new,South,38,True,127,4,0,False,False,True,120,4,0,6.476235429978461,7,0
user_008116,42,75k-100k,desktop,returning,East,42,True,30,5,0,True,True,True,47,5,0,9.566283455184852,-17,0
user_008117,71,75k-100k,desktop,new,East,33,True,166,5,0,False,False,True,175,2,0,7.003029672675509,-9,3
user_008118,45,100k-150k,mobile,returning,South,56,True,107,2,0,True,True,True,76,2,0,6.824979765914152,31,0
user_008119,36,50k-75k,desktop,returning,East,45,True,60,3,0,False,True,False,0,0,0,,60,3
user_008120,21,30k-50k,desktop,new,South,38,True,107,4,0,True,True,True,116,2,0,9.054332017868223,-9,2
user_008121,24,100k-150k,mobile,new,South,82,False,0,0,0,True,True,True,125,1,0,7.901409507292275,-125,-1
user_008122,42,30k-50k,desktop,returning,West,74,True,34,4,1,False,True,True,20,2,0,7.849553660546103,14,2
user_008123,25,>150k,mobile,returning,West,91,True,66,3,0,True,True,True,20,4,0,9.861378786497074,46,-1
user_008124,44,30k-50k,mobile,new,South,36,True,114,6,0,True,False,True,101,7,0,8.374037394952293,13,-1
user_008125,46,75k-100k,desktop,returning,South,64,True,83,4,0,True,True,True,73,4,0,10.0,10,0
user_008126,24,75k-100k,desktop,new,East,51,True,149,8,0,False,True,True,90,7,0,10.0,59,1
user_008127,24,50k-75k,mobile,returning,South,57,True,78,3,0,False,False,True,61,2,0,8.694912198601564,17,1
user_008128,33,30k-50k,desktop,returning,South,42,True,90,2,0,False,True,False,0,0,0,,90,2
user_008129,43,>150k,mobile,new,East,72,True,117,3,0,False,False,True,133,7,0,7.633949925460795,-16,-4
user_008130,52,100k-150k,mobile,returning,West,56,True,99,3,0,False,True,True,80,1,0,5.2361892707802795,19,2
user_008131,52,50k-75k,desktop,returning,West,42,True,97,3,0,True,True,True,98,2,1,6.021551542116652,-1,1
user_008132,64,100k-150k,desktop,returning,Midwest,49,True,107,1,0,False,True,True,129,1,1,8.907898293314744,-22,0
user_008133,44,50k-75k,desktop,returning,East,65,True,106,2,1,True,True,True,40,1,0,8.827505598966832,66,1
user_008134,40,<30k,desktop,returning,Midwest,43,True,86,3,1,False,True,True,73,3,0,5.429271683531219,13,0
user_008135,61,50k-75k,desktop,new,South,43,True,153,2,0,False,False,True,111,1,0,5.424480861420487,42,1
user_008136,44,100k-150k,mobile,returning,South,78,True,125,1,0,False,False,True,113,1,0,7.652073827573952,12,0
user_008137,30,50k-75k,mobile,returning,East,73,True,46,5,0,False,True,True,20,10,0,8.27507476192652,26,-5
user_008138,50,75k-100k,mobile,returning,South,25,True,172,3,0,True,True,False,0,0,0,,172,3
user_008139,32,75k-100k,desktop,returning,South,59,True,30,2,0,True,True,True,21,1,0,9.118608504202324,9,1
user_008140,54,50k-75k,desktop,new,West,71,False,0,0,0,False,False,True,132,5,0,8.16730201223174,-132,-5
user_008141,57,30k-50k,desktop,new,West,40,True,149,2,1,False,False,True,175,1,0,6.600278160077342,-26,1
user_008142,47,75k-100k,mobile,new,Midwest,45,False,0,0,0,False,False,True,129,1,0,9.333228399686345,-129,-1
user_008143,44,75k-100k,mobile,returning,East,25,True,157,4,0,False,False,True,172,3,0,8.173491588065257,-15,1
user_008144,60,<30k,mobile,returning,East,23,True,113,5,0,False,False,True,90,7,0,6.947249353643066,23,-2
user_008145,25,50k-75k,desktop,new,East,83,True,124,5,0,True,True,True,135,5,0,8.92845217880551,-11,0
user_008146,31,30k-50k,desktop,returning,East,72,True,105,4,0,True,True,True,68,1,0,7.962584965070486,37,3
user_008147,21,30k-50k,mobile,returning,West,81,True,73,4,0,True,True,True,21,4,1,7.76463499599627,52,0
user_008148,41,50k-75k,desktop,returning,Midwest,53,True,108,2,0,False,False,True,111,1,0,3.387917299860059,-3,1
user_008149,27,<30k,desktop,returning,East,57,True,59,3,0,False,False,True,74,2,0,7.374321013992967,-15,1
user_008150,66,50k-75k,mobile,returning,West,22,False,0,0,0,True,False,False,0,0,0,,0,0
user_008151,50,30k-50k,desktop,returning,East,40,True,117,1,0,True,True,True,106,3,0,8.342880053670992,11,-2
user_008152,43,50k-75k,mobile,returning,Midwest,47,True,167,1,0,False,True,True,137,1,0,9.196542321529991,30,0
user_008153,25,75k-100k,mobile,returning,West,77,True,167,3,0,False,True,True,147,1,0,8.26984599027206,20,2
user_008154,31,30k-50k,desktop,new,Midwest,64,True,132,3,0,True,True,True,141,4,0,8.727309146587443,-9,-1
user_008155,54,50k-75k,desktop,returning,East,67,True,65,4,0,False,False,True,52,4,0,8.338814743018235,13,0
user_008156,32,30k-50k,mobile,returning,East,85,True,30,3,0,False,True,True,31,1,0,9.092650670975464,-1,2
user_008157,20,75k-100k,desktop,returning,Midwest,28,False,0,0,0,True,True,True,132,2,0,9.548216104997312,-132,-2
user_008158,52,30k-50k,tablet,returning,East,39,True,30,3,0,False,True,True,20,1,0,7.4542917170253,10,2
user_008159,57,75k-100k,mobile,returning,Midwest,69,True,93,3,0,False,False,True,95,1,0,7.453753491840537,-2,2
user_008160,53,75k-100k,tablet,new,West,55,True,119,2,1,False,True,True,124,1,0,8.198560702909184,-5,1
user_008161,41,50k-75k,desktop,new,East,34,True,102,6,0,True,True,True,109,8,0,7.714744493575669,-7,-2
user_008162,59,30k-50k,desktop,returning,South,16,True,136,5,0,True,False,True,150,4,0,4.394739077358895,-14,1
user_008163,53,100k-150k,mobile,returning,Midwest,36,True,94,1,0,False,False,True,122,1,0,6.93701633739229,-28,0
user_008164,42,30k-50k,mobile,returning,East,40,True,119,6,0,True,True,True,106,5,0,7.056459719223086,13,1
user_008165,52,>150k,mobile,new,West,50,True,88,2,0,True,False,False,0,0,0,,88,2
user_008166,44,>150k,desktop,returning,East,86,True,30,2,0,True,True,True,20,2,1,7.976063738178314,10,0
user_008167,66,<30k,mobile,returning,South,15,False,0,0,0,False,False,True,112,1,1,6.322596765987157,-112,-1
user_008168,57,75k-100k,mobile,returning,West,35,True,128,4,0,True,True,True,102,5,0,8.737607884565685,26,-1
user_008169,59,30k-50k,mobile,returning,Midwest,9,True,121,2,0,False,False,True,75,2,1,4.411735786541287,46,0
user_008170,45,100k-150k,mobile,returning,South,68,True,122,3,0,False,True,False,0,0,0,,122,3
user_008171,64,<30k,desktop,new,Midwest,6,False,0,0,0,False,False,False,0,0,0,,0,0
user_008172,37,50k-75k,desktop,new,West,80,True,90,3,0,True,True,True,59,6,1,6.35870593250132,31,-3
user_008173,32,50k-75k,desktop,returning,Midwest,31,True,138,2,0,False,True,True,112,1,0,7.946537094418388,26,1
user_008174,54,100k-150k,desktop,returning,South,83,True,74,8,1,True,True,True,49,3,0,7.314698715745115,25,5
user_008175,43,50k-75k,mobile,new,West,63,True,159,6,1,False,True,True,128,2,0,6.830258150959446,31,4
user_008176,55,75k-100k,desktop,returning,Midwest,39,True,66,6,0,True,True,True,45,7,0,9.155516266328352,21,-1
user_008177,47,100k-150k,desktop,returning,West,61,True,91,1,0,False,True,True,75,2,0,8.726281175556984,16,-1
user_008178,43,100k-150k,mobile,returning,West,61,True,97,8,0,True,True,True,98,5,0,8.580646840313245,-1,3
user_008179,43,<30k,mobile,new,East,49,True,177,1,0,True,False,True,189,1,1,8.614210119410645,-12,0
user_008180,69,30k-50k,desktop,returning,South,34,True,113,2,0,False,False,True,105,2,0,4.43135543506065,8,0
user_008181,70,50k-75k,mobile,returning,East,24,True,103,5,1,False,False,True,83,3,0,8.582251713817262,20,2
user_008182,18,50k-75k,tablet,returning,East,89,False,0,0,0,True,True,False,0,0,0,,0,0
user_008183,52,50k-75k,tablet,new,East,39,True,100,5,0,False,False,True,145,4,0,6.657879014800232,-45,1
user_008184,29,30k-50k,desktop,returning,South,70,True,136,3,0,True,True,True,112,2,0,9.587053691395749,24,1
user_008185,47,100k-150k,desktop,new,East,56,True,76,2,0,False,True,True,21,2,0,7.341878661414259,55,0
user_008186,57,<30k,desktop,returning,East,24,True,139,2,0,False,False,True,118,2,0,7.080127906608815,21,0
user_008187,49,100k-150k,desktop,new,East,80,True,61,1,0,False,True,True,94,1,0,8.448178155176747,-33,0
user_008188,53,50k-75k,tablet,new,West,56,True,128,1,1,True,True,True,95,2,0,6.688978568659295,33,-1
user_008189,78,75k-100k,desktop,returning,East,42,True,148,1,0,True,False,True,171,2,0,5.901724696650154,-23,-1
user_008190,38,30k-50k,desktop,new,West,40,False,0,0,0,False,False,False,0,0,0,,0,0
user_008191,25,100k-150k,mobile,new,West,97,True,114,6,0,True,True,True,99,9,0,9.569259386954647,15,-3
user_008192,39,<30k,desktop,returning,South,50,True,30,3,0,True,True,True,49,2,0,7.398228639832449,-19,1
user_008193,41,75k-100k,desktop,new,East,67,True,156,3,0,True,True,True,147,5,0,7.804714596740182,9,-2
user_008194,50,30k-50k,mobile,returning,Midwest,44,True,42,3,0,False,False,True,46,4,0,7.21718668596716,-4,-1
user_008195,52,<30k,mobile,new,West,62,True,69,4,0,True,True,False,0,0,0,,69,4
user_008196,53,50k-75k,mobile,returning,West,69,True,107,3,0,True,True,True,85,3,0,8.196426433835583,22,0
user_008197,32,75k-100k,mobile,returning,East,49,True,82,1,0,False,True,True,65,2,0,7.67423053436447,17,-1
user_008198,40,<30k,mobile,new,West,44,False,0,0,0,False,False,False,0,0,0,,0,0
user_008199,45,50k-75k,desktop,new,West,70,True,116,2,1,False,False,True,103,3,0,8.99546255941703,13,-1
user_008200,20,75k-100k,desktop,new,Midwest,82,True,123,1,0,False,True,True,109,1,0,10.0,14,0
user_008201,32,75k-100k,desktop,returning,West,75,True,102,2,0,False,True,True,91,3,0,7.526467323814851,11,-1
user_008202,48,30k-50k,mobile,new,South,77,True,109,2,0,True,True,True,73,2,0,8.484265833505477,36,0
user_008203,31,<30k,mobile,returning,East,36,True,138,3,0,True,True,True,117,3,0,8.214729807355617,21,0
user_008204,59,>150k,mobile,returning,South,41,True,127,1,0,True,True,False,0,0,0,,127,1
user_008205,40,30k-50k,tablet,returning,Midwest,65,True,58,2,0,False,True,True,27,2,0,6.9982028419290865,31,0
user_008206,44,30k-50k,mobile,new,Midwest,63,True,162,2,0,True,True,True,93,1,0,7.42337074839749,69,1
user_008207,34,50k-75k,desktop,new,Midwest,68,True,121,3,0,False,True,True,120,2,0,6.803111054747543,1,1
user_008208,45,30k-50k,desktop,returning,Midwest,47,False,0,0,0,False,True,True,126,2,0,7.391472002443189,-126,-2
user_008209,33,50k-75k,mobile,returning,West,81,True,82,2,0,True,True,True,86,1,0,9.301341748370936,-4,1
user_008210,44,30k-50k,desktop,returning,East,9,True,159,6,0,False,False,True,179,8,0,5.984702739841592,-20,-2
user_008211,48,75k-100k,mobile,returning,West,30,True,59,3,0,False,False,True,61,2,0,7.925461838263426,-2,1
user_008212,50,<30k,desktop,returning,Midwest,56,True,83,1,0,True,True,True,68,1,0,7.467484064088556,15,0
user_008213,39,100k-150k,mobile,returning,Midwest,71,True,55,3,0,True,True,True,69,3,0,10.0,-14,0
user_008214,43,<30k,tablet,new,West,9,True,145,2,0,False,False,True,186,1,0,8.170660094796656,-41,1
user_008215,18,100k-150k,mobile,returning,West,100,False,0,0,0,True,True,True,129,1,0,8.114691467365102,-129,-1
user_008216,38,<30k,desktop,new,Midwest,12,True,183,4,1,False,False,True,186,3,0,6.213671349488657,-3,1
user_008217,52,30k-50k,desktop,new,South,30,True,158,3,0,False,False,True,198,2,0,8.377923504377929,-40,1
user_008218,76,<30k,desktop,returning,Midwest,52,True,103,2,0,False,False,False,0,0,0,,103,2
user_008219,57,30k-50k,mobile,returning,Midwest,20,True,107,10,2,False,False,True,96,12,0,6.1778628898750245,11,-2
user_008220,52,100k-150k,mobile,returning,East,57,True,81,1,1,False,True,True,43,1,0,8.457059694489068,38,0
user_008221,32,>150k,desktop,returning,Midwest,100,True,30,2,0,True,True,False,0,0,0,,30,2
user_008222,74,30k-50k,mobile,returning,Midwest,31,True,114,5,0,True,True,True,107,1,0,7.154004653110612,7,4
user_008223,49,30k-50k,mobile,returning,West,69,True,48,2,0,True,True,True,38,4,0,6.567843071079217,10,-2
user_008224,67,<30k,desktop,returning,East,19,True,91,2,0,True,True,True,72,2,0,7.709921108966064,19,0
user_008225,30,100k-150k,desktop,returning,Midwest,97,True,70,2,0,True,True,True,65,1,0,7.431899931092794,5,1
user_008226,34,30k-50k,desktop,returning,Midwest,51,True,143,4,0,True,True,True,92,6,0,5.979992013518095,51,-2
user_008227,43,75k-100k,tablet,returning,East,67,True,76,3,0,False,False,True,47,2,0,9.52995804988855,29,1
user_008228,34,75k-100k,mobile,returning,Midwest,46,True,102,3,0,True,True,True,60,1,0,6.846690568363701,42,2
user_008229,38,30k-50k,mobile,new,East,45,True,90,1,0,False,False,True,98,1,0,8.35852788728614,-8,0
user_008230,29,50k-75k,mobile,returning,East,75,True,71,6,1,False,True,True,56,3,0,8.374108135642471,15,3
user_008231,37,75k-100k,tablet,returning,South,27,True,123,2,0,False,False,True,121,3,0,7.392359154724268,2,-1
user_008232,40,50k-75k,desktop,returning,West,91,True,30,7,1,False,True,True,29,8,1,7.008432167784904,1,-1
user_008233,24,50k-75k,desktop,returning,West,78,True,53,2,1,True,True,True,63,1,0,8.766045096883959,-10,1
user_008234,43,<30k,mobile,new,Midwest,23,False,0,0,0,False,False,True,133,1,0,7.744501067118303,-133,-1
user_008235,48,>150k,mobile,returning,Midwest,42,True,94,2,0,False,False,True,63,3,1,6.947899246365587,31,-1
user_008236,28,30k-50k,mobile,returning,West,73,True,49,5,0,False,True,True,30,2,0,7.232064413948903,19,3
user_008237,46,30k-50k,mobile,new,Midwest,70,True,98,4,0,False,True,True,48,5,0,7.283945376809623,50,-1
user_008238,44,75k-100k,desktop,returning,East,61,True,129,4,0,True,True,True,76,1,0,7.964750487895804,53,3
user_008239,40,75k-100k,desktop,returning,East,78,True,81,4,1,True,True,True,89,5,0,7.4745981564538955,-8,-1
user_008240,46,100k-150k,tablet,new,East,76,True,165,3,0,True,True,True,112,3,0,7.294289942663824,53,0
user_008241,51,50k-75k,desktop,returning,East,28,True,196,1,1,False,False,False,0,0,0,,196,1
user_008242,38,30k-50k,mobile,new,South,46,True,125,2,0,False,True,True,113,1,0,9.125135875234426,12,1
user_008243,59,75k-100k,mobile,returning,South,19,True,152,5,0,False,False,True,150,3,0,7.282104136817197,2,2
user_008244,41,30k-50k,mobile,new,Midwest,19,True,149,2,1,False,False,True,186,4,0,7.377985086186775,-37,-2
user_008245,56,100k-150k,desktop,returning,West,62,True,99,2,0,True,True,True,71,3,0,7.906952825878247,28,-1
user_008246,50,<30k,desktop,new,Midwest,37,False,0,0,0,True,True,True,91,1,0,7.882498356369306,-91,-1
user_008247,67,50k-75k,desktop,new,East,0,True,207,4,0,False,True,True,162,3,0,7.555281965245647,45,1
user_008248,44,50k-75k,tablet,new,East,57,True,136,4,0,False,False,True,105,5,0,10.0,31,-1
user_008249,50,50k-75k,mobile,new,West,45,True,113,4,0,True,False,True,107,4,0,10.0,6,0
user_008250,32,75k-100k,desktop,new,East,72,True,30,2,0,False,True,True,33,3,0,6.882103339652095,-3,-1
user_008251,39,100k-150k,desktop,returning,West,61,True,88,1,0,True,True,True,94,1,0,10.0,-6,0
user_008252,33,30k-50k,desktop,returning,West,68,True,98,1,0,True,False,True,103,1,0,7.20702562696099,-5,0
user_008253,73,50k-75k,desktop,returning,Midwest,52,False,0,0,0,False,True,True,34,1,0,8.347240186870144,-34,-1
user_008254,43,100k-150k,mobile,new,West,68,True,115,1,0,False,False,False,0,0,0,,115,1
user_008255,55,50k-75k,mobile,returning,Midwest,33,True,78,4,0,True,False,True,96,9,0,6.639261801426362,-18,-5
user_008256,58,75k-100k,mobile,returning,West,63,True,82,3,0,False,True,True,77,2,0,8.953215447626349,5,1
user_008257,49,100k-150k,mobile,new,Midwest,73,False,0,0,0,False,True,True,85,1,0,8.501315583153895,-85,-1
user_008258,52,>150k,mobile,returning,South,58,True,44,2,0,True,True,True,36,2,0,8.943004530645076,8,0
user_008259,80,30k-50k,tablet,returning,West,73,True,116,4,0,True,True,True,74,2,0,7.2880309123674305,42,2
user_008260,55,<30k,mobile,new,East,39,True,134,2,0,False,False,True,108,1,0,6.41894204026328,26,1
user_008261,41,30k-50k,desktop,new,Midwest,55,True,56,4,0,False,False,True,42,6,0,6.588266973979236,14,-2
user_008262,31,30k-50k,desktop,new,East,50,True,87,2,0,False,False,True,96,1,0,7.837453968203674,-9,1
user_008263,62,75k-100k,desktop,returning,West,29,True,148,1,0,False,False,True,114,2,0,6.988269739843986,34,-1
user_008264,53,50k-75k,mobile,new,East,20,True,127,2,0,False,False,True,130,2,0,8.671138101448197,-3,0
user_008265,36,50k-75k,desktop,returning,East,38,True,80,5,0,False,False,True,84,5,0,6.3427038045920465,-4,0
user_008266,48,50k-75k,desktop,returning,Midwest,66,True,141,1,0,True,True,True,120,1,0,7.812449054605595,21,0
user_008267,18,>150k,mobile,returning,West,100,True,47,2,1,True,True,True,33,1,0,7.9546849003694415,14,1
user_008268,36,50k-75k,tablet,new,Midwest,53,False,0,0,0,True,False,True,127,2,0,7.352213828644897,-127,-2
user_008269,25,>150k,desktop,returning,Midwest,99,True,94,1,0,False,True,True,71,1,0,7.31472922961833,23,0
user_008270,35,75k-100k,mobile,returning,West,55,True,30,2,1,False,True,True,38,5,0,9.41895235285993,-8,-3
user_008271,36,100k-150k,desktop,returning,South,65,True,93,5,1,True,True,True,76,2,0,7.790947851948645,17,3
user_008272,18,75k-100k,tablet,new,Midwest,82,True,50,3,0,True,True,False,0,0,0,,50,3
user_008273,31,>150k,mobile,new,South,98,False,0,0,0,False,True,True,82,1,1,9.451036125565308,-82,-1
user_008274,50,30k-50k,desktop,new,East,72,False,0,0,0,False,True,True,96,1,0,8.311742321480201,-96,-1
user_008275,40,75k-100k,desktop,returning,South,61,False,0,0,0,True,True,True,108,1,0,7.283443635059626,-108,-1
user_008276,51,50k-75k,desktop,returning,South,33,True,78,3,0,True,False,True,67,4,1,6.735567772876918,11,-1
user_008277,63,75k-100k,desktop,new,South,13,False,0,0,0,False,True,True,82,1,0,7.466796057196929,-82,-1
user_008278,62,75k-100k,mobile,returning,South,17,True,157,4,1,True,False,True,195,4,1,7.265128341683326,-38,0
user_008279,44,30k-50k,desktop,returning,East,73,True,90,3,1,True,True,True,60,2,0,6.275581780593699,30,1
user_008280,57,30k-50k,tablet,returning,Midwest,34,True,71,5,0,True,True,True,64,8,1,7.7769228683776594,7,-3
user_008281,59,30k-50k,mobile,returning,Midwest,13,True,121,5,0,False,False,True,101,2,0,9.876875057982453,20,3
user_008282,58,<30k,desktop,returning,West,25,True,166,5,0,False,False,True,145,4,1,7.150322622307944,21,1
user_008283,40,75k-100k,desktop,new,South,47,False,0,0,0,True,True,True,53,1,0,7.163476302911711,-53,-1
user_008284,41,50k-75k,desktop,new,South,47,False,0,0,0,False,False,True,108,1,0,7.493795136846848,-108,-1
user_008285,32,100k-150k,mobile,returning,South,100,True,51,1,0,False,True,True,29,2,0,5.901140376645214,22,-1
user_008286,69,30k-50k,desktop,returning,Midwest,51,True,85,3,0,False,True,True,75,1,0,8.29108514877683,10,2
user_008287,37,50k-75k,desktop,new,West,61,True,159,3,0,True,False,True,144,1,0,6.30013469926792,15,2
user_008288,31,<30k,mobile,new,East,55,False,0,0,0,True,True,True,116,1,0,8.86569354881785,-116,-1
user_008289,57,30k-50k,mobile,returning,South,10,True,123,3,1,True,True,True,108,4,1,6.507234551508541,15,-1
user_008290,35,<30k,mobile,returning,East,26,True,196,3,0,True,False,True,192,2,0,5.7787512384535455,4,1
user_008291,30,<30k,desktop,new,West,56,False,0,0,0,True,True,True,96,1,0,8.421938929960849,-96,-1
user_008292,24,30k-50k,mobile,returning,South,33,True,81,2,0,False,True,True,70,3,0,8.313141214410766,11,-1
user_008293,42,50k-75k,desktop,returning,East,47,True,86,2,0,False,True,True,84,1,0,7.672485613579976,2,1
user_008294,26,100k-150k,mobile,returning,Midwest,74,True,79,6,0,True,True,True,77,4,0,9.142367929908575,2,2
user_008295,18,30k-50k,desktop,returning,Midwest,51,False,0,0,0,False,False,True,151,1,0,8.195906408421072,-151,-1
user_008296,67,75k-100k,desktop,returning,Midwest,20,True,128,2,1,False,False,True,127,1,0,6.381206995205376,1,1
user_008297,41,50k-75k,desktop,returning,West,68,True,76,1,0,True,True,True,65,1,0,9.753477679798053,11,0
user_008298,49,<30k,desktop,returning,South,38,True,62,1,0,True,True,True,43,1,0,9.227241792190732,19,0
user_008299,67,50k-75k,desktop,new,West,55,False,0,0,0,False,True,False,0,0,0,,0,0
user_008300,34,50k-75k,mobile,returning,East,44,True,109,3,0,True,True,True,105,1,0,6.2568439509426526,4,2
user_008301,62,75k-100k,mobile,returning,Midwest,20,True,168,2,0,False,False,True,161,2,0,8.578268601337136,7,0
user_008302,51,30k-50k,mobile,new,West,76,True,109,3,1,True,True,True,102,3,1,5.112739284733794,7,0
user_008303,41,50k-75k,desktop,returning,Midwest,62,True,84,4,0,True,True,True,100,3,0,8.65060699447013,-16,1
user_008304,50,100k-150k,desktop,new,East,70,False,0,0,0,False,True,True,106,1,0,9.754279781181875,-106,-1
user_008305,31,<30k,mobile,returning,West,56,True,57,2,0,False,True,True,21,3,0,8.941011638867554,36,-1
user_008306,66,30k-50k,mobile,returning,West,76,True,109,2,0,False,False,True,112,1,0,6.61010234994583,-3,1
user_008307,51,100k-150k,mobile,new,South,76,True,148,1,0,False,True,True,130,2,0,9.67643937973715,18,-1
user_008308,38,<30k,mobile,new,West,40,True,122,1,1,True,True,True,91,1,0,6.716213254595028,31,0
user_008309,48,30k-50k,desktop,returning,West,53,False,0,0,0,True,True,True,109,1,0,8.008585618098468,-109,-1
user_008310,42,30k-50k,mobile,returning,Midwest,16,True,112,4,0,False,False,True,106,8,2,6.074577350302953,6,-4
user_008311,31,30k-50k,mobile,returning,East,68,True,112,4,1,True,True,True,70,5,0,7.350485734321932,42,-1
user_008312,44,<30k,mobile,new,East,38,True,113,4,0,True,True,True,45,1,0,7.908428311624436,68,3
user_008313,54,30k-50k,desktop,returning,East,49,True,71,3,1,True,True,True,29,2,0,7.21427735710361,42,1
user_008314,42,50k-75k,desktop,returning,South,43,True,41,3,0,False,True,True,36,2,0,9.729268905713294,5,1
user_008315,57,<30k,desktop,returning,East,9,False,0,0,0,True,False,False,0,0,0,,0,0
user_008316,50,30k-50k,desktop,returning,East,45,True,58,2,0,False,False,True,54,1,0,5.868526916453859,4,1
user_008317,23,<30k,desktop,returning,Midwest,74,False,0,0,0,False,True,True,101,3,0,9.234609647517459,-101,-3
user_008318,35,100k-150k,mobile,returning,West,100,False,0,0,0,True,False,True,117,1,0,8.467683596863356,-117,-1
user_008319,62,30k-50k,desktop,returning,Midwest,31,False,0,0,0,False,False,False,0,0,0,,0,0
user_008320,53,30k-50k,desktop,returning,West,65,False,0,0,0,False,True,True,48,1,0,8.20552214829294,-48,-1
user_008321,44,50k-75k,desktop,returning,South,46,True,60,3,0,True,True,True,27,3,0,8.77794304800807,33,0
user_008322,18,50k-75k,desktop,returning,East,84,True,110,4,0,False,True,True,74,2,0,7.298204520103023,36,2
user_008323,40,30k-50k,mobile,returning,East,55,True,95,2,0,False,False,True,97,2,0,7.328084081366849,-2,0
user_008324,51,30k-50k,tablet,returning,East,59,True,80,2,0,False,True,True,99,3,0,9.512027214854818,-19,-1
user_008325,38,50k-75k,desktop,new,East,68,True,144,2,0,False,True,True,140,1,0,8.434466984572644,4,1
user_008326,30,100k-150k,mobile,new,East,94,False,0,0,0,True,False,True,120,1,0,7.419685045194638,-120,-1
user_008327,18,<30k,tablet,returning,East,15,False,0,0,0,True,True,True,104,1,0,9.84006979033319,-104,-1
user_008328,19,100k-150k,desktop,returning,South,87,True,101,2,1,True,True,True,71,1,0,7.7694044592317,30,1
user_008329,41,50k-75k,desktop,returning,South,57,True,98,2,0,False,True,True,58,2,0,6.4948118184430905,40,0
user_008330,47,50k-75k,desktop,new,East,47,False,0,0,0,False,False,False,0,0,0,,0,0
user_008331,56,100k-150k,mobile,returning,Midwest,60,True,89,5,1,False,True,True,91,3,1,8.19077328917415,-2,2
user_008332,51,30k-50k,mobile,new,South,45,False,0,0,0,False,False,False,0,0,0,,0,0
user_008333,33,50k-75k,desktop,returning,South,50,True,86,4,0,True,False,True,103,8,0,6.221838314676288,-17,-4
user_008334,39,<30k,desktop,returning,West,25,True,184,1,0,False,False,True,188,1,0,6.9892934860198155,-4,0
user_008335,39,50k-75k,desktop,returning,South,35,True,88,7,0,True,True,True,52,6,0,7.50856938408558,36,1
user_008336,80,30k-50k,mobile,returning,East,24,True,86,4,0,False,False,True,85,4,0,9.874002704578587,1,0
user_008337,46,30k-50k,mobile,returning,South,38,True,46,5,1,True,True,True,48,3,0,9.03997639324206,-2,2
user_008338,42,75k-100k,desktop,returning,South,34,True,58,9,1,False,True,True,30,9,0,10.0,28,0
user_008339,50,75k-100k,desktop,new,Midwest,40,True,116,1,0,False,True,True,95,1,0,7.583469572595473,21,0
user_008340,52,75k-100k,mobile,returning,East,45,True,91,3,0,False,True,True,82,1,1,10.0,9,2
user_008341,49,<30k,desktop,returning,South,19,True,148,1,0,True,False,True,137,1,0,8.537211655622581,11,0
user_008342,36,<30k,desktop,new,Midwest,36,True,59,4,0,True,False,True,64,7,0,6.6024703413776535,-5,-3
user_008343,58,30k-50k,mobile,returning,East,45,True,70,2,2,True,True,False,0,0,0,,70,2
user_008344,52,100k-150k,tablet,new,West,67,True,129,2,0,True,True,True,111,2,0,10.0,18,0
user_008345,43,50k-75k,desktop,returning,Midwest,34,False,0,0,0,True,True,True,89,1,0,8.924731569481668,-89,-1
user_008346,52,<30k,desktop,new,West,64,True,139,4,0,True,False,False,0,0,0,,139,4
user_008347,56,100k-150k,desktop,returning,West,73,True,91,1,0,False,True,True,76,1,0,7.159382848645666,15,0
user_008348,49,30k-50k,mobile,new,South,58,True,108,2,0,False,False,True,121,1,1,7.546219998451657,-13,1
user_008349,61,50k-75k,mobile,returning,West,43,True,49,2,0,True,False,True,42,2,0,6.927374210352934,7,0
user_008350,39,75k-100k,desktop,new,East,52,True,102,2,0,True,True,True,44,1,0,9.043843903491283,58,1
user_008351,75,30k-50k,mobile,returning,East,5,True,101,5,0,True,False,True,83,7,0,7.616821524409129,18,-2
user_008352,31,<30k,mobile,returning,East,30,True,39,3,0,True,True,True,55,4,0,6.083860352047944,-16,-1
user_008353,27,30k-50k,mobile,returning,East,68,True,107,6,0,False,True,True,112,5,0,9.228301319473047,-5,1
user_008354,45,30k-50k,mobile,returning,South,53,True,115,2,0,True,True,True,83,2,0,8.526189038149417,32,0
user_008355,47,75k-100k,desktop,new,East,35,True,151,1,0,True,True,True,135,1,0,8.658533741417445,16,0
user_008356,54,30k-50k,desktop,returning,South,30,True,91,2,0,True,True,True,106,1,0,7.466681776616451,-15,1
user_008357,23,75k-100k,mobile,returning,East,65,True,122,4,1,True,True,True,76,5,0,7.355949746241339,46,-1
user_008358,32,50k-75k,desktop,returning,Midwest,70,True,230,3,1,True,True,True,163,2,0,6.975718920724665,67,1
user_008359,51,30k-50k,desktop,returning,West,57,True,103,3,0,True,True,True,75,4,0,7.693406067318394,28,-1
user_008360,44,100k-150k,desktop,new,Midwest,86,True,71,3,0,True,True,True,56,1,0,10.0,15,2
user_008361,37,<30k,desktop,returning,Midwest,38,False,0,0,0,True,False,True,95,1,0,7.94043078641647,-95,-1
user_008362,62,75k-100k,desktop,new,Midwest,55,True,111,5,0,False,True,True,44,3,0,7.63163173201935,67,2
user_008363,39,30k-50k,mobile,returning,East,32,True,101,3,0,False,False,True,137,1,0,6.822425185468132,-36,2
user_008364,37,30k-50k,tablet,returning,Midwest,46,True,64,2,0,True,True,True,52,4,0,7.822617482829383,12,-2
user_008365,38,50k-75k,mobile,returning,South,57,True,104,5,0,False,True,True,103,5,0,8.054299054601232,1,0
user_008366,47,30k-50k,desktop,returning,Midwest,47,False,0,0,0,True,True,True,97,2,0,7.606002145257848,-97,-2
user_008367,58,<30k,desktop,returning,East,29,True,93,3,0,True,False,True,88,4,0,8.471238783909094,5,-1
user_008368,37,50k-75k,mobile,returning,South,53,True,113,2,0,False,True,True,73,1,0,9.12537072848455,40,1
user_008369,38,75k-100k,mobile,new,East,49,True,151,3,0,False,False,True,174,7,0,9.18830260057192,-23,-4
user_008370,36,75k-100k,desktop,returning,West,54,False,0,0,0,False,True,True,79,1,0,7.657084766872207,-79,-1
user_008371,80,30k-50k,desktop,returning,West,72,False,0,0,0,True,True,True,83,2,0,7.118966598222198,-83,-2
user_008372,40,50k-75k,mobile,returning,West,62,True,183,1,0,True,True,True,171,1,0,7.794223744466574,12,0
user_008373,26,50k-75k,desktop,returning,East,72,True,36,1,0,False,True,True,47,1,0,7.454330416315188,-11,0
user_008374,56,>150k,desktop,returning,East,39,True,115,3,0,False,False,True,123,2,0,5.730235680342708,-8,1
user_008375,32,50k-75k,mobile,returning,West,61,True,123,3,0,False,True,True,80,6,0,8.654122687923719,43,-3
user_008376,39,30k-50k,desktop,returning,West,53,True,84,3,0,False,False,True,83,8,1,7.704428611722324,1,-5
user_008377,35,<30k,mobile,new,East,49,True,117,1,0,True,True,True,85,1,0,9.311183044369733,32,0
user_008378,25,75k-100k,mobile,returning,South,71,False,0,0,0,False,True,True,79,1,0,7.4823225652858625,-79,-1
user_008379,47,30k-50k,desktop,returning,East,58,True,143,1,0,False,False,True,151,1,0,5.042990392120121,-8,0
user_008380,25,100k-150k,mobile,new,East,90,True,83,3,0,True,True,True,68,4,0,6.400027386701518,15,-1
user_008381,35,50k-75k,desktop,new,Midwest,9,True,133,1,0,True,True,True,135,1,0,8.54913820539991,-2,0
user_008382,75,<30k,desktop,new,South,46,True,158,1,0,False,False,True,155,1,0,6.718867267520199,3,0
user_008383,33,100k-150k,mobile,returning,East,94,True,30,6,0,True,True,True,35,5,0,8.741363243002285,-5,1
user_008384,60,30k-50k,mobile,returning,East,13,True,113,8,1,True,True,True,93,8,0,7.4219515817706885,20,0
user_008385,55,100k-150k,mobile,returning,West,74,True,30,3,1,False,True,True,20,4,0,10.0,10,-1
user_008386,44,50k-75k,desktop,new,Midwest,62,True,132,3,0,False,True,True,106,2,0,6.790115968871817,26,1
user_008387,43,50k-75k,desktop,returning,East,67,True,78,1,0,False,True,True,95,1,0,8.655723557152186,-17,0
user_008388,28,75k-100k,mobile,new,South,46,False,0,0,0,False,False,True,120,1,0,6.618029171086382,-120,-1
user_008389,60,75k-100k,desktop,new,South,35,True,113,2,0,False,False,True,104,2,0,8.179605060013134,9,0
user_008390,24,50k-75k,mobile,returning,West,79,False,0,0,0,True,True,False,0,0,0,,0,0
user_008391,45,<30k,mobile,returning,East,61,True,100,3,0,True,True,True,109,5,0,10.0,-9,-2
user_008392,44,75k-100k,desktop,new,East,66,True,85,1,0,True,True,True,66,1,0,8.40538958790601,19,0
user_008393,44,50k-75k,desktop,returning,East,42,True,82,2,0,True,True,True,63,2,0,7.78588230116339,19,0
user_008394,32,30k-50k,mobile,returning,South,77,True,39,3,0,False,True,True,20,3,0,8.733329325093054,19,0
user_008395,59,50k-75k,mobile,returning,West,31,True,141,5,0,False,False,True,145,5,0,7.089112191486392,-4,0
user_008396,45,50k-75k,desktop,returning,West,54,True,113,1,0,True,True,True,51,2,0,9.344076891040384,62,-1
user_008397,56,75k-100k,desktop,returning,West,53,True,82,3,0,True,False,True,51,2,0,6.995320558775397,31,1
user_008398,21,100k-150k,mobile,returning,Midwest,90,True,51,4,0,True,True,True,63,2,1,7.277955788204489,-12,2
user_008399,68,75k-100k,desktop,new,East,27,True,145,1,0,False,True,True,100,1,0,8.08747313259127,45,0
user_008400,33,75k-100k,desktop,returning,East,58,True,96,4,0,False,True,True,85,2,0,7.255653476743661,11,2
user_008401,47,<30k,desktop,returning,East,50,False,0,0,0,False,True,True,72,1,0,8.931474730230287,-72,-1
user_008402,34,30k-50k,mobile,returning,Midwest,47,True,74,1,0,False,False,True,52,1,0,6.489020776931559,22,0
user_008403,41,100k-150k,mobile,returning,West,20,True,127,2,0,False,False,True,121,2,0,6.796791743426641,6,0
user_008404,55,50k-75k,mobile,new,Midwest,22,True,133,3,0,False,False,True,110,2,0,6.482926289245995,23,1
user_008405,21,100k-150k,desktop,new,Midwest,90,True,145,3,0,False,True,False,0,0,0,,145,3
user_008406,50,50k-75k,mobile,returning,South,54,True,122,3,0,True,True,True,124,2,0,9.24242267593395,-2,1
user_008407,40,50k-75k,tablet,returning,East,54,True,98,5,0,False,True,True,58,5,0,7.909100191337101,40,0
user_008408,38,30k-50k,desktop,returning,West,82,True,121,3,0,True,False,True,119,2,0,7.642352558261799,2,1
user_008409,58,75k-100k,mobile,returning,South,26,True,116,6,0,False,False,True,122,3,0,6.995726732199999,-6,3
user_008410,42,100k-150k,desktop,returning,South,28,True,123,2,0,False,True,True,102,2,0,7.792033919567138,21,0
user_008411,67,<30k,mobile,returning,Midwest,5,False,0,0,0,False,False,True,129,1,0,9.11508868201216,-129,-1
user_008412,47,30k-50k,desktop,new,West,46,False,0,0,0,False,False,True,128,2,0,8.738398915765446,-128,-2
user_008413,58,100k-150k,mobile,returning,Midwest,44,True,30,1,0,False,True,True,37,1,0,9.579416125369024,-7,0
user_008414,34,30k-50k,mobile,returning,Midwest,57,False,0,0,0,False,True,True,82,1,0,9.555948557844129,-82,-1
user_008415,44,100k-150k,mobile,returning,South,96,True,35,4,0,True,True,True,65,2,0,6.885697399736643,-30,2
user_008416,62,50k-75k,desktop,returning,South,38,True,108,1,0,False,False,True,93,1,0,7.007866796321359,15,0
user_008417,46,<30k,mobile,returning,East,55,False,0,0,0,False,True,True,115,1,0,8.51633883389625,-115,-1
user_008418,47,50k-75k,desktop,returning,Midwest,74,True,59,1,0,False,False,False,0,0,0,,59,1
user_008419,48,100k-150k,desktop,new,South,72,True,57,5,0,True,True,True,28,3,0,6.419010917717995,29,2
user_008420,49,50k-75k,desktop,new,West,78,True,30,1,0,False,False,True,55,2,0,8.773807931141288,-25,-1
user_008421,80,<30k,mobile,new,South,23,True,160,4,1,True,False,True,187,1,0,8.584104124215516,-27,3
user_008422,63,30k-50k,desktop,returning,South,29,True,85,2,0,True,False,True,72,1,0,8.141633646653965,13,1
user_008423,53,30k-50k,mobile,returning,West,36,True,96,1,0,False,True,True,89,4,0,6.090619120590635,7,-3
user_008424,48,50k-75k,desktop,new,South,11,True,183,1,0,False,False,True,180,2,1,7.734939564174011,3,-1
user_008425,39,<30k,desktop,returning,Midwest,11,True,141,1,0,True,True,True,116,1,0,7.523165133895494,25,0
user_008426,18,50k-75k,mobile,returning,East,69,True,130,1,0,True,True,True,105,1,0,7.538435675549687,25,0
user_008427,31,30k-50k,desktop,new,East,86,True,77,1,0,False,True,True,78,2,0,7.567437516252728,-1,-1
user_008428,31,50k-75k,desktop,returning,South,49,True,81,3,0,False,True,True,68,3,0,7.242172057203775,13,0
user_008429,45,100k-150k,mobile,returning,South,55,True,42,3,0,False,False,True,42,4,0,5.781728316511587,0,-1
user_008430,45,75k-100k,desktop,returning,East,47,True,128,2,1,True,True,True,75,1,0,6.129627421796903,53,1
user_008431,59,50k-75k,desktop,new,South,48,True,100,3,0,False,False,True,139,6,0,7.630395032525221,-39,-3
user_008432,56,50k-75k,mobile,returning,South,27,True,171,9,0,True,True,True,150,12,0,7.339646284690445,21,-3
user_008433,50,50k-75k,desktop,new,South,50,False,0,0,0,False,False,True,158,1,0,7.846670164437967,-158,-1
user_008434,25,75k-100k,mobile,returning,East,54,True,94,4,0,False,True,True,110,5,0,8.180670488890323,-16,-1
user_008435,28,30k-50k,desktop,returning,West,95,True,86,3,0,True,True,True,32,2,1,8.001631742411902,54,1
user_008436,52,30k-50k,desktop,returning,Midwest,26,True,100,3,0,False,False,True,101,1,0,5.272610131973947,-1,2
user_008437,43,30k-50k,mobile,returning,South,38,True,119,3,0,True,True,True,120,1,0,10.0,-1,2
user_008438,49,30k-50k,mobile,returning,West,59,True,106,1,0,True,True,True,102,2,0,8.611730545650914,4,-1
user_008439,41,<30k,desktop,returning,South,46,True,90,3,0,True,True,True,117,5,0,10.0,-27,-2
user_008440,57,30k-50k,mobile,returning,East,24,True,173,3,0,False,False,True,185,5,1,6.594161349396437,-12,-2
user_008441,50,<30k,desktop,returning,East,0,False,0,0,0,False,False,True,98,1,0,8.106961854980517,-98,-1
user_008442,31,75k-100k,desktop,returning,South,88,True,30,1,0,True,True,True,20,3,0,8.687841554018753,10,-2
user_008443,51,<30k,mobile,returning,Midwest,37,True,114,5,1,True,True,True,71,3,0,6.534973795143592,43,2
user_008444,57,50k-75k,desktop,returning,East,34,False,0,0,0,True,False,True,140,2,0,5.671810400180982,-140,-2
user_008445,44,50k-75k,desktop,returning,Midwest,45,True,72,3,0,False,True,True,51,2,0,7.584201506623857,21,1
user_008446,73,50k-75k,desktop,returning,East,14,True,146,2,0,True,False,True,117,1,0,6.724327234950528,29,1
user_008447,71,50k-75k,tablet,returning,West,31,False,0,0,0,False,False,True,93,1,0,7.384663371491872,-93,-1
user_008448,75,50k-75k,mobile,new,West,46,True,130,1,0,False,False,True,131,1,0,8.10697900818895,-1,0
user_008449,36,30k-50k,mobile,returning,South,20,True,177,1,0,True,True,True,133,5,0,8.115448813936666,44,-4
user_008450,53,<30k,mobile,returning,East,42,True,120,2,1,False,True,True,132,1,0,8.389085691051305,-12,1
user_008451,38,75k-100k,desktop,returning,West,64,True,48,2,0,True,True,True,57,4,0,6.65571527565302,-9,-2
user_008452,34,<30k,mobile,new,Midwest,61,True,181,5,0,False,True,True,166,1,0,9.530056803450389,15,4
user_008453,49,30k-50k,mobile,new,Midwest,54,False,0,0,0,False,False,False,0,0,0,,0,0
user_008454,40,100k-150k,desktop,returning,South,86,True,64,2,0,True,True,True,42,3,1,7.72872480711027,22,-1
user_008455,78,30k-50k,mobile,returning,West,48,True,128,2,0,True,False,True,116,1,0,6.766283569436702,12,1
user_008456,25,75k-100k,mobile,new,Midwest,62,True,78,2,0,True,True,True,71,2,0,8.699887658098879,7,0
user_008457,63,>150k,desktop,returning,Midwest,60,True,61,3,0,False,False,False,0,0,0,,61,3
user_008458,18,75k-100k,mobile,returning,East,44,True,66,4,0,True,True,True,50,2,0,9.5062504825588,16,2
user_008459,43,30k-50k,desktop,returning,Midwest,26,True,196,1,0,True,True,True,179,1,0,8.261130459491925,17,0
user_008460,21,75k-100k,mobile,returning,Midwest,46,False,0,0,0,False,True,True,79,1,0,8.558317533077593,-79,-1
user_008461,30,<30k,desktop,returning,Midwest,41,True,71,3,1,False,True,True,61,4,0,9.728572653140192,10,-1
user_008462,45,30k-50k,mobile,returning,West,60,True,44,4,1,True,True,True,22,5,0,7.886603668945938,22,-1
user_008463,44,<30k,desktop,returning,South,35,True,95,5,0,False,False,True,113,4,0,7.74297938838107,-18,1
user_008464,47,30k-50k,desktop,new,East,42,True,139,2,0,False,False,False,0,0,0,,139,2
user_008465,23,50k-75k,tablet,returning,East,96,True,32,3,1,False,False,True,45,5,0,6.895185491122874,-13,-2
user_008466,48,<30k,desktop,returning,East,32,False,0,0,0,False,False,True,135,2,0,5.012105893948649,-135,-2
user_008467,66,50k-75k,mobile,returning,West,46,True,35,1,0,False,True,True,42,1,0,5.915109374462922,-7,0
user_008468,40,100k-150k,desktop,returning,West,72,True,53,1,0,True,True,True,72,1,0,9.154250838754832,-19,0
user_008469,50,100k-150k,mobile,new,West,58,True,105,1,0,False,True,True,61,1,0,7.877399235604596,44,0
user_008470,36,<30k,desktop,returning,Midwest,46,False,0,0,0,True,True,True,97,1,0,5.673902639730382,-97,-1
user_008471,42,<30k,desktop,returning,East,59,True,70,2,0,False,True,True,78,1,0,10.0,-8,1
user_008472,40,30k-50k,desktop,new,East,44,True,125,2,0,False,False,True,89,5,0,8.079364648182306,36,-3
user_008473,72,100k-150k,mobile,new,South,69,True,128,4,1,False,True,True,121,4,0,6.606625579580142,7,0
user_008474,52,100k-150k,desktop,new,East,70,True,56,2,1,True,True,False,0,0,0,,56,2
user_008475,53,30k-50k,mobile,new,Midwest,40,True,146,3,0,False,False,True,149,3,0,6.521130287294393,-3,0
user_008476,53,>150k,desktop,returning,East,79,True,111,4,0,True,True,True,52,3,0,7.466080989066488,59,1
user_008477,49,30k-50k,mobile,returning,South,58,True,84,6,0,False,True,False,0,0,0,,84,6
user_008478,66,75k-100k,mobile,returning,Midwest,30,True,131,8,1,True,True,True,138,7,0,7.18736839695993,-7,1
user_008479,41,50k-75k,desktop,new,East,23,True,125,4,0,True,False,False,0,0,0,,125,4
user_008480,41,100k-150k,desktop,returning,South,51,True,81,3,0,True,True,True,93,4,0,7.676267056449702,-12,-1
user_008481,58,75k-100k,mobile,returning,East,38,True,101,4,0,True,True,True,100,3,0,7.018747661250884,1,1
user_008482,49,>150k,desktop,returning,Midwest,90,True,86,5,2,True,False,True,86,7,0,8.260048669335678,0,-2
user_008483,18,75k-100k,desktop,returning,West,62,False,0,0,0,True,True,True,80,1,0,6.233475246276885,-80,-1
user_008484,59,75k-100k,mobile,returning,Midwest,63,True,163,2,0,False,True,True,136,1,0,5.5275850263928215,27,1
user_008485,35,50k-75k,desktop,returning,South,51,True,86,5,0,True,True,True,57,3,0,6.440240240091036,29,2
user_008486,40,75k-100k,mobile,returning,East,54,True,117,4,0,False,True,False,0,0,0,,117,4
user_008487,59,75k-100k,mobile,returning,East,55,True,79,3,0,False,True,True,86,1,0,7.697436574281744,-7,2
user_008488,59,30k-50k,desktop,returning,East,36,True,95,7,0,True,True,True,39,4,0,9.843364466748815,56,3
user_008489,27,<30k,mobile,returning,West,95,True,63,3,0,True,True,True,46,1,0,8.37610614991241,17,2
user_008490,38,30k-50k,desktop,returning,East,37,True,88,5,0,False,True,True,79,2,0,8.186567360387818,9,3
user_008491,50,>150k,mobile,new,South,69,True,108,1,0,True,True,True,91,1,0,9.516878744051256,17,0
user_008492,36,30k-50k,mobile,new,Midwest,43,False,0,0,0,True,False,True,131,2,1,7.083267647905067,-131,-2
user_008493,37,30k-50k,desktop,returning,Midwest,93,False,0,0,0,True,True,True,121,2,0,8.300918059590513,-121,-2
user_008494,42,100k-150k,mobile,returning,South,51,True,76,1,0,False,False,True,91,1,0,5.856279561731837,-15,0
user_008495,23,>150k,mobile,returning,Midwest,54,True,62,4,0,False,True,True,20,4,0,6.40606104539142,42,0
user_008496,31,<30k,mobile,returning,South,32,True,90,4,0,False,True,True,69,2,0,9.581027897460807,21,2
user_008497,39,50k-75k,mobile,returning,West,70,True,38,1,0,True,False,True,20,1,0,5.259367122780189,18,0
user_008498,59,100k-150k,desktop,returning,South,24,True,139,4,1,False,False,True,139,4,0,6.687406490479068,0,0
user_008499,52,75k-100k,desktop,returning,East,21,True,148,6,0,True,True,True,143,3,0,8.238099833179772,5,3
user_008500,47,<30k,desktop,returning,East,31,True,48,3,0,True,False,True,38,6,0,6.621507144617202,10,-3
user_008501,70,<30k,desktop,new,Midwest,5,False,0,0,0,False,False,False,0,0,0,,0,0
user_008502,40,<30k,mobile,new,East,37,True,70,7,0,False,True,True,50,6,0,7.849245627448911,20,1
user_008503,18,30k-50k,desktop,returning,South,54,True,102,2,0,False,False,True,105,1,0,5.463605305004696,-3,1
user_008504,18,75k-100k,mobile,returning,South,36,False,0,0,0,True,False,True,117,1,0,7.076921137792222,-117,-1
user_008505,44,75k-100k,desktop,returning,West,62,True,71,2,0,False,True,True,20,2,0,5.455462923395543,51,0
user_008506,61,30k-50k,tablet,returning,East,20,True,120,3,0,False,False,True,113,4,0,8.680066388908912,7,-1
user_008507,56,30k-50k,mobile,returning,Midwest,44,False,0,0,0,True,False,True,119,1,0,8.669318914349343,-119,-1
user_008508,53,75k-100k,desktop,returning,South,49,True,84,1,0,True,True,True,80,1,0,8.442003116426179,4,0
user_008509,64,<30k,mobile,new,West,33,True,142,1,0,False,False,True,125,2,0,7.050885605582614,17,-1
user_008510,51,<30k,mobile,new,West,42,True,66,3,0,False,False,True,27,1,0,4.301218839935761,39,2
user_008511,29,75k-100k,desktop,new,East,56,True,77,2,0,True,True,True,27,1,0,8.21625736858899,50,1
user_008512,39,75k-100k,mobile,returning,Midwest,36,False,0,0,0,True,True,True,84,1,0,8.24171182826201,-84,-1
user_008513,44,>150k,desktop,returning,South,41,True,118,4,0,False,False,True,119,3,0,5.798857868718953,-1,1
user_008514,48,50k-75k,mobile,new,South,44,True,77,1,0,True,False,True,96,1,0,6.455035931575774,-19,0
user_008515,30,30k-50k,desktop,returning,South,55,True,57,3,0,False,True,True,45,5,0,9.616236636544192,12,-2
user_008516,44,30k-50k,desktop,returning,Midwest,41,True,82,2,0,False,True,True,72,1,0,6.888898908998866,10,1
user_008517,37,30k-50k,desktop,returning,East,52,False,0,0,0,False,True,True,102,1,0,9.750382200008582,-102,-1
user_008518,30,75k-100k,mobile,returning,Midwest,43,True,91,3,0,False,True,True,75,1,0,7.844210838074622,16,2
user_008519,78,<30k,mobile,returning,East,18,True,174,2,1,False,False,True,190,3,0,7.776153803404771,-16,-1
user_008520,48,50k-75k,mobile,new,Midwest,47,True,113,3,0,False,False,True,106,1,0,7.89783348605706,7,2
user_008521,43,<30k,mobile,returning,Midwest,43,True,123,2,0,False,False,False,0,0,0,,123,2
user_008522,45,50k-75k,mobile,new,East,44,True,120,3,1,False,False,False,0,0,0,,120,3
user_008523,46,100k-150k,mobile,new,South,43,True,88,3,0,False,True,False,0,0,0,,88,3
user_008524,57,100k-150k,mobile,returning,Midwest,39,True,115,3,0,True,True,True,95,1,0,9.144095696679797,20,2
user_008525,36,75k-100k,desktop,returning,East,46,True,91,9,0,True,True,True,29,7,0,7.828211273759214,62,2
user_008526,58,30k-50k,mobile,new,West,27,False,0,0,0,False,False,True,155,3,0,7.207657200464288,-155,-3
user_008527,56,30k-50k,desktop,returning,South,32,True,101,4,0,True,False,True,87,5,0,6.201545223040552,14,-1
user_008528,18,75k-100k,mobile,returning,Midwest,53,True,99,1,0,False,False,True,89,1,0,7.8482683104593045,10,0
user_008529,45,75k-100k,mobile,returning,East,50,True,103,6,0,True,True,True,64,5,0,10.0,39,1
user_008530,60,75k-100k,desktop,returning,Midwest,27,True,130,4,0,True,False,True,134,3,0,6.160055506939013,-4,1
user_008531,34,<30k,mobile,new,Midwest,50,False,0,0,0,False,True,True,118,1,0,7.652518709653168,-118,-1
user_008532,62,>150k,mobile,new,West,69,False,0,0,0,False,True,True,83,1,0,8.127170892872247,-83,-1
user_008533,66,100k-150k,mobile,returning,Midwest,57,True,98,2,0,False,True,True,78,4,0,9.121502690374657,20,-2
user_008534,18,75k-100k,mobile,new,Midwest,52,False,0,0,0,False,False,False,0,0,0,,0,0
user_008535,27,50k-75k,mobile,returning,East,78,True,30,3,0,False,True,True,27,4,0,6.52882657982006,3,-1
user_008536,51,75k-100k,desktop,returning,East,62,True,118,5,0,False,False,True,127,6,0,6.39159753094088,-9,-1
user_008537,27,50k-75k,tablet,returning,Midwest,74,False,0,0,0,False,False,True,96,2,0,7.568546080009061,-96,-2
user_008538,22,50k-75k,mobile,returning,West,59,True,78,4,0,True,True,True,35,3,0,6.873797302798793,43,1
user_008539,51,30k-50k,mobile,returning,East,55,True,94,4,0,True,True,True,84,2,1,9.310716137506523,10,2
user_008540,48,30k-50k,mobile,returning,East,66,True,45,5,0,True,True,True,20,2,0,6.8270028039150805,25,3
user_008541,41,75k-100k,desktop,new,Midwest,39,True,148,6,1,False,True,True,135,6,0,6.366011590460395,13,0
user_008542,36,30k-50k,desktop,returning,West,66,True,67,4,0,True,True,True,37,3,0,8.023575260298946,30,1
user_008543,34,30k-50k,desktop,new,West,66,False,0,0,0,False,True,True,106,1,0,7.992476522932417,-106,-1
user_008544,59,50k-75k,mobile,returning,East,39,True,30,2,0,True,True,True,25,1,0,8.786959735997943,5,1
user_008545,51,30k-50k,desktop,returning,West,76,True,82,3,1,True,True,True,65,3,0,8.303849750438733,17,0
user_008546,36,<30k,mobile,new,South,56,True,119,2,0,True,False,True,136,1,0,6.043882617357726,-17,1
user_008547,31,30k-50k,mobile,returning,East,63,True,85,2,0,True,True,True,42,1,0,7.559051004909057,43,1
user_008548,68,75k-100k,mobile,returning,Midwest,7,False,0,0,0,True,False,True,97,1,0,7.088124991805271,-97,-1
user_008549,37,30k-50k,mobile,returning,Midwest,34,True,80,2,0,False,False,True,55,1,0,8.263792558613265,25,1
user_008550,49,<30k,mobile,returning,South,2,True,137,6,0,False,False,True,153,3,0,5.331937189010158,-16,3
user_008551,42,<30k,mobile,returning,South,22,True,145,2,0,False,True,True,120,1,0,6.071637231679823,25,1
user_008552,18,>150k,desktop,new,East,72,True,67,2,0,True,True,True,47,1,0,7.357409238209861,20,1
user_008553,20,50k-75k,mobile,returning,West,97,False,0,0,0,True,True,True,113,1,0,10.0,-113,-1
user_008554,43,30k-50k,desktop,returning,South,32,True,63,7,0,True,False,True,74,8,0,8.045918718033986,-11,-1
user_008555,62,75k-100k,desktop,returning,South,19,True,85,3,0,True,True,True,51,3,0,6.92794388095598,34,0
user_008556,52,<30k,desktop,returning,East,55,False,0,0,0,True,True,True,94,1,0,6.908391962352533,-94,-1
user_008557,43,50k-75k,desktop,new,South,26,True,96,5,0,False,False,True,106,5,1,6.947174906306182,-10,0
user_008558,43,30k-50k,mobile,returning,West,63,True,139,4,0,True,True,True,114,3,0,8.155378706676794,25,1
user_008559,51,30k-50k,desktop,returning,Midwest,36,True,121,5,1,True,True,True,91,6,0,8.691834972406538,30,-1
user_008560,54,50k-75k,tablet,returning,South,68,True,149,1,0,True,True,True,111,1,0,9.283134873349287,38,0
user_008561,62,75k-100k,desktop,new,East,20,True,183,4,0,True,False,True,154,6,0,5.553370981939366,29,-2
user_008562,54,50k-75k,desktop,returning,East,30,True,98,4,0,True,True,True,77,7,0,7.670263749119071,21,-3
user_008563,32,30k-50k,mobile,returning,South,69,True,41,2,0,False,False,False,0,0,0,,41,2
user_008564,36,100k-150k,desktop,new,Midwest,71,True,72,4,0,True,True,True,26,5,0,8.027796885211798,46,-1
user_008565,41,50k-75k,mobile,returning,East,56,True,170,2,0,True,False,True,172,1,0,6.913269142304391,-2,1
user_008566,26,<30k,desktop,returning,East,56,True,124,2,0,False,True,True,87,1,0,7.1719584270594074,37,1
user_008567,54,30k-50k,desktop,returning,East,61,True,52,3,0,False,False,True,57,1,0,7.276754930866465,-5,2
user_008568,25,30k-50k,mobile,returning,East,85,True,91,3,0,True,True,True,82,1,0,8.551350981997622,9,2
user_008569,46,<30k,mobile,returning,East,54,True,78,1,0,False,True,True,55,1,0,7.02543938678354,23,0
user_008570,35,75k-100k,desktop,returning,South,62,True,98,1,0,True,False,True,87,1,0,7.078520307744302,11,0
user_008571,54,<30k,tablet,returning,Midwest,55,True,84,4,0,False,True,True,34,1,0,9.05193412900527,50,3
user_008572,58,50k-75k,tablet,returning,South,28,True,115,2,1,True,False,True,91,2,0,7.007502761949331,24,0
user_008573,63,75k-100k,desktop,new,Midwest,11,True,137,3,1,True,True,True,141,4,0,7.057693508646848,-4,-1
user_008574,45,50k-75k,mobile,returning,East,73,True,73,1,0,True,True,True,57,1,0,10.0,16,0
user_008575,65,50k-75k,desktop,returning,South,14,True,81,4,1,True,True,True,81,2,0,8.523269851345058,0,2
user_008576,42,30k-50k,desktop,returning,Midwest,53,True,85,3,0,True,True,True,67,2,0,8.895780414809717,18,1
user_008577,69,50k-75k,desktop,returning,Midwest,47,False,0,0,0,False,True,True,123,1,0,7.987524454897501,-123,-1
user_008578,50,50k-75k,mobile,returning,South,52,True,73,4,0,True,True,True,48,3,0,7.493232226153625,25,1
user_008579,18,50k-75k,desktop,returning,Midwest,73,True,67,2,1,True,True,True,58,1,0,7.648542944372364,9,1
user_008580,18,50k-75k,desktop,returning,West,57,True,142,1,0,True,True,True,104,1,0,6.435299277179168,38,0
user_008581,33,50k-75k,tablet,returning,South,69,False,0,0,0,True,True,True,82,2,0,8.284585745134402,-82,-2
user_008582,56,75k-100k,desktop,returning,West,33,True,139,4,0,True,False,True,135,5,0,7.641410186468317,4,-1
user_008583,46,50k-75k,desktop,returning,West,88,True,63,3,0,True,True,True,77,2,0,7.261940827583057,-14,1
user_008584,66,30k-50k,mobile,new,West,51,True,140,5,1,False,False,False,0,0,0,,140,5
user_008585,34,30k-50k,desktop,returning,Midwest,74,True,94,4,0,True,True,True,100,2,0,8.193026260335802,-6,2
user_008586,46,<30k,mobile,returning,Midwest,41,True,66,2,1,False,False,True,66,3,0,6.745630993963474,0,-1
user_008587,29,50k-75k,desktop,new,South,59,True,148,5,0,False,True,True,153,2,0,8.488163133168822,-5,3
user_008588,33,30k-50k,tablet,returning,West,59,True,55,1,0,True,True,True,54,1,0,8.51363206940849,1,0
user_008589,40,<30k,mobile,returning,South,45,True,77,3,0,False,False,True,76,4,0,8.330320146529585,1,-1
user_008590,51,30k-50k,mobile,returning,South,60,True,92,8,0,True,False,True,92,9,0,7.685438768990157,0,-1
user_008591,47,<30k,mobile,returning,South,52,True,67,3,0,False,False,True,74,1,0,7.720010715425209,-7,2
user_008592,32,50k-75k,desktop,returning,West,98,True,73,1,1,True,True,True,48,1,0,7.140081627574352,25,0
user_008593,48,50k-75k,mobile,returning,West,71,True,64,1,0,True,True,True,51,1,0,6.635201506982658,13,0
user_008594,36,>150k,mobile,returning,South,55,True,78,4,1,False,True,True,52,5,0,7.472764425557632,26,-1
user_008595,43,75k-100k,mobile,new,South,69,True,100,4,0,True,True,True,86,5,0,9.156746805698416,14,-1
user_008596,38,<30k,mobile,new,East,39,False,0,0,0,True,False,True,122,1,1,9.484594601643101,-122,-1
user_008597,47,100k-150k,desktop,new,Midwest,54,True,172,2,0,False,False,True,203,1,0,9.222573421926704,-31,1
user_008598,54,75k-100k,tablet,new,West,72,True,106,3,0,True,True,True,130,2,0,7.8706673575533275,-24,1
user_008599,34,>150k,mobile,returning,West,100,True,69,2,0,False,True,True,32,1,1,8.298610951576139,37,1
user_008600,29,30k-50k,desktop,returning,South,44,True,58,2,0,False,False,True,63,3,0,10.0,-5,-1
user_008601,67,30k-50k,desktop,new,South,55,True,93,4,0,True,True,True,73,4,0,8.731974353685775,20,0
user_008602,42,100k-150k,desktop,new,East,45,False,0,0,0,False,False,True,137,1,0,9.23637846904022,-137,-1
user_008603,54,<30k,desktop,new,South,39,False,0,0,0,False,False,True,114,3,0,6.814139414380861,-114,-3
user_008604,38,<30k,desktop,returning,West,29,True,135,4,1,False,False,True,99,3,0,7.094747348929699,36,1
user_008605,63,<30k,desktop,new,East,32,True,141,2,0,True,False,False,0,0,0,,141,2
user_008606,47,30k-50k,desktop,new,Midwest,30,False,0,0,0,False,True,True,66,3,0,7.279155182339984,-66,-3
user_008607,42,<30k,mobile,new,East,15,False,0,0,0,False,False,False,0,0,0,,0,0
user_008608,25,50k-75k,desktop,returning,East,58,True,94,2,0,False,True,True,89,2,0,8.811878426710079,5,0
user_008609,49,75k-100k,desktop,returning,West,67,True,74,1,0,True,True,True,25,1,1,10.0,49,0
user_008610,37,<30k,desktop,new,East,36,False,0,0,0,False,False,True,100,1,0,6.800542467286539,-100,-1
user_008611,64,75k-100k,desktop,new,West,40,False,0,0,0,True,True,True,113,1,0,9.459449040093723,-113,-1
user_008612,43,<30k,desktop,returning,Midwest,32,True,112,4,0,True,True,True,58,4,0,8.077571911646283,54,0
user_008613,47,<30k,mobile,returning,West,22,True,160,5,1,True,False,False,0,0,0,,160,5
user_008614,57,100k-150k,mobile,returning,Midwest,51,True,89,5,0,False,True,True,66,5,0,9.79758003309534,23,0
user_008615,39,<30k,desktop,returning,South,21,True,131,5,0,True,True,True,83,3,0,7.0183538027715064,48,2
user_008616,46,<30k,desktop,returning,East,40,False,0,0,0,False,True,True,72,1,1,8.557964351722061,-72,-1
user_008617,37,100k-150k,desktop,returning,South,75,True,30,1,0,False,True,True,20,2,0,8.374585579881545,10,-1
user_008618,56,75k-100k,mobile,returning,South,20,True,117,6,0,False,False,True,108,7,0,6.224090323434807,9,-1
user_008619,34,50k-75k,desktop,new,Midwest,37,True,123,4,0,False,True,True,119,8,0,7.792337947258863,4,-4
user_008620,34,>150k,mobile,new,West,93,True,92,2,0,False,True,True,47,1,0,8.101186387295872,45,1
user_008621,55,>150k,desktop,returning,South,64,True,121,2,0,True,True,True,104,1,0,9.227387342095692,17,1
user_008622,55,100k-150k,mobile,returning,East,42,True,126,4,0,True,True,True,101,5,0,6.639280985594045,25,-1
user_008623,18,30k-50k,desktop,returning,West,72,False,0,0,0,False,True,True,96,1,0,9.396550390028532,-96,-1
user_008624,18,100k-150k,desktop,new,East,96,True,111,3,0,True,True,True,65,2,1,10.0,46,1
user_008625,34,75k-100k,mobile,returning,West,72,False,0,0,0,False,False,True,110,1,0,7.625250287632138,-110,-1
user_008626,23,30k-50k,desktop,returning,South,72,True,56,1,0,True,True,True,20,2,1,6.9614830543266075,36,-1
user_008627,20,30k-50k,mobile,returning,East,79,True,74,3,0,True,True,True,42,1,0,8.699125452926381,32,2
user_008628,48,75k-100k,tablet,new,East,45,True,60,1,0,False,False,True,23,1,0,6.685580975835347,37,0
user_008629,57,30k-50k,desktop,returning,West,52,True,96,5,1,False,True,True,87,3,0,8.647864627783568,9,2
user_008630,42,50k-75k,desktop,new,South,41,True,68,4,0,False,False,True,48,6,0,6.2415647262147385,20,-2
user_008631,36,30k-50k,mobile,returning,East,50,True,79,1,1,True,True,True,48,1,1,7.596751215836372,31,0
user_008632,25,30k-50k,desktop,returning,East,67,True,92,4,0,True,True,True,63,3,1,9.14454207688426,29,1
user_008633,21,100k-150k,tablet,new,South,100,True,81,2,0,True,True,True,60,1,0,7.925396021494698,21,1
user_008634,18,75k-100k,desktop,returning,East,63,True,65,3,0,True,True,True,73,1,0,10.0,-8,2
user_008635,33,30k-50k,desktop,returning,West,80,True,30,2,0,True,True,True,28,1,0,8.031414969858435,2,1
user_008636,38,75k-100k,desktop,new,West,47,True,48,2,0,False,False,True,37,2,1,5.620732891507071,11,0
user_008637,49,100k-150k,mobile,returning,South,61,True,164,5,0,False,False,True,137,5,0,7.8136881575288175,27,0
user_008638,49,<30k,mobile,returning,Midwest,36,True,87,3,1,False,False,True,71,3,0,4.466495032635854,16,0
user_008639,37,75k-100k,mobile,returning,West,32,True,104,3,0,False,True,True,93,1,0,7.075444434304125,11,2
user_008640,56,30k-50k,desktop,new,Midwest,43,True,82,1,0,True,False,True,67,1,1,5.0093195096528325,15,0
user_008641,47,75k-100k,mobile,returning,East,51,False,0,0,0,True,True,True,89,2,0,7.6376175989043595,-89,-2
user_008642,56,<30k,desktop,returning,Midwest,16,False,0,0,0,True,True,True,107,1,0,5.856221260844725,-107,-1
user_008643,39,<30k,mobile,returning,South,54,True,83,1,1,True,False,True,83,1,0,6.955577068848387,0,0
user_008644,33,<30k,mobile,returning,Midwest,53,True,35,3,0,False,False,True,47,3,0,8.050187638447307,-12,0
user_008645,45,100k-150k,mobile,returning,East,83,True,106,2,0,True,True,True,117,3,0,6.829372486575421,-11,-1
user_008646,63,50k-75k,desktop,returning,East,32,False,0,0,0,False,False,True,135,1,1,8.588456353309299,-135,-1
user_008647,60,100k-150k,mobile,returning,West,66,True,86,2,0,True,True,True,61,1,0,8.485872940028221,25,1
user_008648,31,30k-50k,mobile,returning,South,82,True,81,3,1,False,True,True,104,4,0,8.619198513355144,-23,-1
user_008649,56,30k-50k,desktop,returning,Midwest,59,True,76,3,0,False,True,True,75,2,0,9.8087352466421,1,1
user_008650,23,75k-100k,desktop,returning,West,100,False,0,0,0,False,False,True,85,1,0,7.531305986859543,-85,-1
user_008651,40,30k-50k,desktop,returning,South,36,False,0,0,0,False,True,True,82,1,0,7.325864009931964,-82,-1
user_008652,37,<30k,desktop,returning,Midwest,36,False,0,0,0,True,False,True,131,1,0,5.795940768547321,-131,-1
user_008653,59,50k-75k,desktop,new,South,15,True,150,2,0,False,False,True,181,2,1,7.726112799829124,-31,0
user_008654,24,50k-75k,tablet,new,West,100,True,66,4,0,True,True,True,45,3,0,8.036224070819173,21,1
user_008655,43,75k-100k,desktop,returning,West,78,True,30,3,0,True,True,True,50,3,0,5.585114165515238,-20,0
user_008656,60,50k-75k,mobile,returning,South,19,True,148,5,0,False,False,True,144,7,1,9.530179917714017,4,-2
user_008657,68,50k-75k,desktop,new,East,28,False,0,0,0,False,False,False,0,0,0,,0,0
user_008658,54,30k-50k,mobile,returning,West,48,True,75,1,1,False,False,True,75,1,0,8.286370314831425,0,0
user_008659,43,100k-150k,desktop,returning,West,76,True,77,2,0,True,True,True,66,2,0,9.918536455189361,11,0
user_008660,45,50k-75k,mobile,returning,East,70,True,105,3,0,False,True,True,46,5,0,8.544392679192253,59,-2
user_008661,47,50k-75k,desktop,returning,East,48,True,109,5,2,True,True,True,88,8,0,7.929694080879734,21,-3
user_008662,44,30k-50k,tablet,returning,Midwest,40,True,57,1,0,True,False,True,78,1,0,8.36719448651702,-21,0
user_008663,41,50k-75k,mobile,new,East,43,True,166,1,1,False,True,True,137,1,0,7.573939692249954,29,0
user_008664,64,<30k,desktop,returning,South,11,False,0,0,0,True,False,True,127,1,0,9.070476304708047,-127,-1
user_008665,40,50k-75k,desktop,returning,South,36,True,66,4,0,False,False,True,71,4,0,8.61307272988105,-5,0
user_008666,32,50k-75k,desktop,returning,East,74,True,76,2,0,True,True,True,61,1,0,7.401630416720958,15,1
user_008667,48,<30k,desktop,returning,Midwest,32,True,53,3,0,False,False,True,67,2,0,10.0,-14,1
user_008668,56,100k-150k,desktop,returning,East,49,True,124,1,0,False,True,True,101,2,0,8.31808019065588,23,-1
user_008669,48,50k-75k,desktop,new,West,42,True,128,1,0,False,False,True,114,2,0,7.755713342644639,14,-1
user_008670,55,30k-50k,mobile,returning,Midwest,52,True,76,1,1,False,True,True,85,1,0,10.0,-9,0
user_008671,26,50k-75k,mobile,returning,West,100,True,86,2,0,True,True,True,46,1,0,8.546894282506724,40,1
user_008672,46,50k-75k,mobile,new,East,49,True,147,6,0,False,False,True,158,5,0,6.191081580464845,-11,1
user_008673,61,100k-150k,desktop,returning,South,20,True,141,3,0,False,False,True,146,4,0,6.795321695249766,-5,-1
user_008674,35,30k-50k,desktop,new,South,46,True,136,4,0,False,True,True,114,3,0,7.405153400606059,22,1
user_008675,30,100k-150k,desktop,returning,South,100,True,40,1,0,True,False,True,38,3,1,6.741841795200008,2,-2
user_008676,24,<30k,mobile,new,East,64,False,0,0,0,True,True,True,63,1,0,9.119923962748654,-63,-1
user_008677,27,30k-50k,desktop,new,West,76,True,115,3,0,False,True,True,127,1,0,9.329142615372977,-12,2
user_008678,68,>150k,desktop,returning,West,42,True,30,5,0,False,False,True,20,9,0,5.696825839772833,10,-4
user_008679,24,>150k,desktop,returning,West,100,True,72,1,1,True,True,True,61,1,0,8.557047293380123,11,0
user_008680,42,30k-50k,desktop,new,Midwest,54,False,0,0,0,False,True,True,93,1,0,6.699886796773575,-93,-1
user_008681,66,30k-50k,mobile,returning,Midwest,8,True,159,5,0,True,True,True,136,3,0,7.3561016190536765,23,2
user_008682,45,75k-100k,mobile,returning,South,38,True,97,2,0,False,False,True,79,1,0,7.386967517441776,18,1
user_008683,18,75k-100k,desktop,returning,South,80,True,30,1,0,True,True,True,20,1,0,8.784070426631711,10,0
user_008684,36,75k-100k,desktop,returning,South,39,True,30,8,0,True,True,True,45,3,0,7.5473739319838975,-15,5
user_008685,75,50k-75k,mobile,returning,West,36,True,79,2,0,True,True,True,63,1,0,6.653359033325298,16,1
user_008686,69,50k-75k,mobile,returning,South,42,True,73,4,0,False,False,True,72,5,0,5.785693038736875,1,-1
user_008687,67,50k-75k,mobile,new,South,15,True,170,2,0,True,False,False,0,0,0,,170,2
user_008688,53,30k-50k,desktop,new,Midwest,61,True,136,2,0,False,True,True,95,2,0,8.749548945347152,41,0
user_008689,57,75k-100k,desktop,returning,West,30,True,67,5,0,False,False,True,43,4,0,6.721541898095966,24,1
user_008690,31,100k-150k,desktop,returning,Midwest,84,True,132,2,0,True,True,True,105,4,0,7.172082845976584,27,-2
user_008691,52,50k-75k,mobile,returning,East,50,True,44,2,0,True,True,True,33,2,0,7.692341071488513,11,0
user_008692,50,100k-150k,desktop,new,West,66,True,138,1,0,True,True,True,113,1,0,8.459457949066406,25,0
user_008693,67,50k-75k,mobile,returning,West,53,True,114,2,0,True,False,False,0,0,0,,114,2
user_008694,45,75k-100k,tablet,returning,East,28,True,124,7,0,True,True,True,156,5,0,8.965009331018912,-32,2
user_008695,66,100k-150k,desktop,returning,East,77,True,130,2,0,True,False,True,137,1,0,5.34291652502995,-7,1
user_008696,46,50k-75k,mobile,new,East,48,False,0,0,0,False,False,True,145,3,0,6.834659580156816,-145,-3
user_008697,29,75k-100k,desktop,new,Midwest,95,True,79,2,0,False,True,True,71,2,0,10.0,8,0
user_008698,42,75k-100k,desktop,returning,East,24,True,145,4,1,False,False,True,143,2,0,6.790021242819284,2,2
user_008699,48,100k-150k,desktop,new,South,41,True,145,4,1,False,True,True,108,4,0,8.452251791570168,37,0
user_008700,57,100k-150k,desktop,returning,East,42,True,96,3,0,True,True,True,92,3,0,6.682774604670316,4,0
user_008701,18,100k-150k,desktop,new,South,85,False,0,0,0,False,True,True,112,1,0,8.68696293082089,-112,-1
user_008702,44,<30k,mobile,returning,East,35,False,0,0,0,False,False,False,0,0,0,,0,0
user_008703,48,30k-50k,desktop,returning,East,42,True,44,1,0,True,False,True,84,2,0,3.2430290292840582,-40,-1
user_008704,65,75k-100k,mobile,new,South,41,True,147,3,0,False,False,True,150,1,0,7.102084615088142,-3,2
user_008705,27,100k-150k,desktop,returning,South,100,True,64,1,0,False,True,True,32,1,0,7.652182984542232,32,0
user_008706,48,50k-75k,desktop,new,West,58,True,85,1,0,False,False,True,71,1,1,6.485089048327816,14,0
user_008707,33,75k-100k,mobile,new,Midwest,67,True,119,2,0,True,False,False,0,0,0,,119,2
user_008708,55,>150k,desktop,returning,South,30,True,159,3,2,True,False,True,158,7,0,7.309740478694671,1,-4
user_008709,62,50k-75k,tablet,new,South,33,False,0,0,0,True,False,True,93,1,0,8.398113166728738,-93,-1
user_008710,58,100k-150k,mobile,new,West,58,True,83,5,1,True,True,True,20,5,0,9.010396600699105,63,0
user_008711,60,<30k,desktop,returning,South,27,True,127,9,0,True,False,False,0,0,0,,127,9
user_008712,18,30k-50k,mobile,new,East,58,True,123,3,0,False,True,False,0,0,0,,123,3
user_008713,55,<30k,mobile,new,South,1,True,128,2,0,True,False,True,122,5,0,7.332183858165012,6,-3
user_008714,34,75k-100k,mobile,new,South,46,True,158,3,0,False,True,True,112,1,0,5.448113946460763,46,2
user_008715,41,30k-50k,mobile,returning,West,49,True,80,2,0,False,False,True,81,2,1,7.752842144833135,-1,0
user_008716,52,<30k,mobile,new,South,40,False,0,0,0,True,True,False,0,0,0,,0,0
user_008717,26,100k-150k,desktop,new,South,81,True,137,2,0,True,True,True,124,1,0,7.732987493328226,13,1
user_008718,63,75k-100k,mobile,new,West,40,False,0,0,0,False,True,True,100,1,0,7.716169816007145,-100,-1
user_008719,44,30k-50k,desktop,new,East,50,True,178,4,0,True,True,True,165,3,0,6.383332998278098,13,1
user_008720,46,>150k,desktop,new,East,83,True,127,3,0,False,False,True,137,4,0,9.173211845321028,-10,-1
user_008721,64,50k-75k,mobile,returning,West,54,False,0,0,0,False,True,True,124,1,0,9.488695913121052,-124,-1
user_008722,42,75k-100k,desktop,new,West,73,True,99,4,0,True,True,True,80,1,0,8.05709990505198,19,3
user_008723,53,75k-100k,mobile,new,West,77,True,152,1,0,False,True,True,96,1,0,7.627676850609067,56,0
user_008724,40,75k-100k,desktop,new,West,40,True,139,2,0,False,False,True,133,5,0,7.72261925959918,6,-3
user_008725,48,100k-150k,desktop,returning,Midwest,72,True,42,3,0,True,True,True,42,1,0,6.013377202739512,0,2
user_008726,34,30k-50k,desktop,returning,Midwest,41,True,71,1,0,False,False,False,0,0,0,,71,1
user_008727,35,50k-75k,mobile,returning,West,59,True,90,4,0,False,False,True,119,4,0,9.70794867942418,-29,0
user_008728,54,100k-150k,mobile,returning,West,60,True,66,3,0,False,True,False,0,0,0,,66,3
user_008729,50,<30k,desktop,new,East,42,True,139,2,0,True,False,True,170,3,0,6.100130321406403,-31,-1
user_008730,49,50k-75k,desktop,returning,East,63,True,77,2,1,False,True,True,80,3,0,5.465193351191241,-3,-1
user_008731,78,<30k,desktop,new,East,15,True,135,1,0,True,True,True,95,1,1,8.348448308393131,40,0
user_008732,46,75k-100k,mobile,returning,West,57,True,101,2,1,False,False,True,138,1,0,6.607266553611623,-37,1
user_008733,59,75k-100k,mobile,new,East,24,True,193,5,0,False,True,True,132,1,1,10.0,61,4
user_008734,44,<30k,desktop,returning,South,37,True,122,4,0,False,True,True,80,3,1,8.113015984452895,42,1
user_008735,58,75k-100k,desktop,new,West,33,True,120,5,0,True,False,True,94,4,0,5.696058130218843,26,1
user_008736,57,100k-150k,desktop,returning,East,47,True,62,4,0,False,False,True,71,2,0,8.195799281217436,-9,2
user_008737,71,100k-150k,mobile,new,South,18,False,0,0,0,False,False,False,0,0,0,,0,0
user_008738,36,50k-75k,mobile,new,West,49,True,115,3,0,True,False,True,106,3,0,6.3144303315382295,9,0
user_008739,41,<30k,mobile,returning,South,33,False,0,0,0,False,True,True,80,2,0,8.760064827164936,-80,-2
user_008740,41,50k-75k,desktop,new,East,57,True,110,1,0,True,False,True,84,2,0,9.217945335810771,26,-1
user_008741,56,>150k,desktop,returning,Midwest,31,True,120,1,0,False,False,True,80,1,0,7.561748748595992,40,0
user_008742,18,30k-50k,desktop,new,East,100,False,0,0,0,False,True,True,130,1,0,7.2348327719436645,-130,-1
user_008743,73,30k-50k,desktop,returning,East,35,True,119,3,0,False,False,True,121,3,0,6.504802156496791,-2,0
user_008744,57,100k-150k,desktop,returning,East,33,True,86,1,0,False,False,True,36,1,1,6.815668437916978,50,0
user_008745,35,30k-50k,desktop,returning,Midwest,46,True,139,1,0,True,True,True,105,2,0,7.352101016298692,34,-1
user_008746,61,75k-100k,desktop,returning,East,35,True,122,4,0,True,False,True,109,2,0,8.385990096517506,13,2
user_008747,58,30k-50k,mobile,new,South,17,False,0,0,0,False,False,False,0,0,0,,0,0
user_008748,23,50k-75k,mobile,returning,East,75,True,30,3,0,True,True,True,20,1,0,5.722979192545978,10,2
user_008749,58,30k-50k,desktop,new,East,46,True,106,5,0,False,False,True,108,4,0,5.270998132686082,-2,1
user_008750,55,30k-50k,desktop,new,East,46,True,87,4,0,False,True,True,65,1,0,8.25054955159902,22,3
user_008751,62,>150k,desktop,returning,East,70,True,70,3,0,True,True,True,22,4,0,10.0,48,-1
user_008752,38,100k-150k,desktop,returning,East,72,True,108,3,0,False,False,True,137,2,0,9.330661403739084,-29,1
user_008753,54,30k-50k,mobile,new,South,45,True,144,6,0,False,False,False,0,0,0,,144,6
user_008754,28,30k-50k,mobile,new,West,87,True,93,1,0,False,False,True,87,3,0,6.6231491623520995,6,-2
user_008755,72,50k-75k,desktop,new,West,50,False,0,0,0,False,False,True,100,1,0,6.427420774505756,-100,-1
user_008756,59,100k-150k,desktop,returning,West,53,True,30,1,0,True,True,True,20,1,0,7.958527920160408,10,0
user_008757,33,100k-150k,desktop,returning,West,87,True,71,1,0,True,True,True,34,1,1,7.078064748773977,37,0
user_008758,44,<30k,desktop,new,East,44,True,128,3,0,False,False,False,0,0,0,,128,3
user_008759,35,<30k,desktop,returning,East,52,True,96,2,0,True,True,True,35,4,0,8.061347433656175,61,-2
user_008760,58,75k-100k,mobile,returning,East,54,True,97,2,0,False,False,True,106,2,0,7.712294914051391,-9,0
user_008761,80,100k-150k,mobile,returning,West,27,True,146,1,0,True,False,True,133,1,0,7.348163442537949,13,0
user_008762,63,<30k,mobile,returning,East,4,True,148,7,0,False,False,True,160,7,0,6.293407505767018,-12,0
user_008763,23,30k-50k,mobile,returning,West,76,True,97,1,1,True,True,False,0,0,0,,97,1
user_008764,29,50k-75k,mobile,returning,West,94,True,97,3,0,True,True,True,73,1,0,8.011181206779584,24,2
user_008765,45,50k-75k,mobile,returning,West,72,True,67,2,0,True,True,True,68,5,0,8.233902549657541,-1,-3
user_008766,43,<30k,mobile,new,East,24,False,0,0,0,False,False,True,108,1,0,6.004731461242389,-108,-1
user_008767,57,30k-50k,desktop,returning,South,18,False,0,0,0,True,False,False,0,0,0,,0,0
user_008768,80,50k-75k,mobile,returning,West,36,True,85,9,0,False,False,True,83,7,0,5.539767415760227,2,2
user_008769,47,<30k,desktop,new,Midwest,40,False,0,0,0,False,True,True,105,1,0,8.257985888403002,-105,-1
user_008770,34,100k-150k,mobile,returning,Midwest,85,True,91,5,0,False,True,True,71,3,0,9.744870486742192,20,2
user_008771,52,75k-100k,mobile,new,East,51,True,123,2,1,False,True,True,122,3,0,9.446573372499955,1,-1
user_008772,24,75k-100k,desktop,new,West,87,True,42,6,0,False,True,True,52,6,0,9.786911709199742,-10,0
user_008773,37,75k-100k,mobile,new,South,60,True,82,1,0,False,False,True,58,1,0,6.471311693676059,24,0
user_008774,39,30k-50k,tablet,returning,South,23,True,154,3,0,True,True,True,125,1,0,6.141834051300784,29,2
user_008775,53,<30k,mobile,new,East,44,True,138,4,0,False,False,False,0,0,0,,138,4
user_008776,36,30k-50k,mobile,new,South,74,True,122,2,1,True,False,False,0,0,0,,122,2
user_008777,34,100k-150k,mobile,new,Midwest,92,False,0,0,0,True,True,False,0,0,0,,0,0
user_008778,51,30k-50k,desktop,new,Midwest,85,True,67,1,0,True,True,True,46,1,0,7.454813791980198,21,0
user_008779,60,100k-150k,desktop,new,East,40,False,0,0,0,False,False,True,107,1,0,7.520014312145569,-107,-1
user_008780,50,75k-100k,desktop,returning,East,41,False,0,0,0,True,True,True,99,2,0,6.841333348784103,-99,-2
user_008781,45,<30k,desktop,returning,Midwest,55,True,83,2,0,False,True,True,80,5,0,7.84254381785628,3,-3
user_008782,42,100k-150k,desktop,returning,East,69,True,109,3,0,True,True,True,97,1,0,8.222634944834985,12,2
user_008783,50,75k-100k,mobile,new,South,33,False,0,0,0,False,False,True,130,1,0,8.541530191376703,-130,-1
user_008784,38,50k-75k,desktop,returning,West,59,True,76,1,1,True,True,True,34,1,0,7.674407574895504,42,0
user_008785,30,50k-75k,desktop,new,South,63,True,141,1,0,True,True,True,81,1,0,8.108657194354274,60,0
user_008786,51,>150k,tablet,returning,Midwest,52,True,121,2,0,False,True,True,102,1,0,8.086862081869281,19,1
user_008787,47,30k-50k,mobile,returning,Midwest,48,True,69,5,0,False,False,True,94,5,1,7.068455934425745,-25,0
user_008788,43,50k-75k,desktop,returning,East,24,True,83,2,0,False,False,True,81,2,0,7.135543134546085,2,0
user_008789,49,>150k,desktop,returning,West,87,True,67,2,1,True,True,True,88,3,0,8.813938203054397,-21,-1
user_008790,64,50k-75k,mobile,returning,East,64,True,69,3,0,False,False,True,68,2,0,8.060391340213526,1,1
user_008791,29,75k-100k,desktop,returning,West,88,True,75,4,0,True,True,True,57,2,0,8.163352252491373,18,2
user_008792,36,50k-75k,desktop,returning,Midwest,49,True,54,1,0,False,False,True,35,1,0,7.3073424046948325,19,0
user_008793,45,50k-75k,mobile,returning,Midwest,24,True,111,3,0,True,False,True,108,5,0,6.178095745224909,3,-2
user_008794,66,100k-150k,desktop,returning,South,36,True,92,8,0,False,False,True,93,8,0,7.418086404491039,-1,0
user_008795,24,<30k,mobile,new,West,71,True,52,2,0,False,True,False,0,0,0,,52,2
user_008796,42,>150k,desktop,returning,South,67,True,124,2,0,True,False,True,144,1,0,6.862412219958191,-20,1
user_008797,18,50k-75k,mobile,returning,South,64,True,76,3,0,False,True,True,48,4,0,9.145512791067011,28,-1
user_008798,46,50k-75k,mobile,returning,East,54,True,100,2,1,False,True,True,97,5,0,7.805688346161261,3,-3
user_008799,41,100k-150k,mobile,returning,East,76,True,30,3,0,True,True,True,41,2,0,7.105912304138083,-11,1
user_008800,57,75k-100k,mobile,returning,South,37,True,70,6,0,False,True,True,78,5,1,9.747952755013097,-8,1
user_008801,37,50k-75k,desktop,returning,West,74,False,0,0,0,True,True,True,116,1,0,8.89847321186058,-116,-1
user_008802,40,50k-75k,desktop,returning,Midwest,57,True,32,1,0,False,True,True,30,1,0,8.191232743571641,2,0
user_008803,23,50k-75k,mobile,returning,West,96,True,64,2,0,True,True,True,66,2,0,6.394470719167198,-2,0
user_008804,37,100k-150k,mobile,new,East,57,True,139,1,1,False,True,True,113,2,0,9.022596247693016,26,-1
user_008805,70,75k-100k,desktop,new,West,41,True,124,3,1,False,False,True,98,4,0,6.380461144058609,26,-1
user_008806,21,50k-75k,mobile,returning,South,57,True,127,2,0,False,True,True,109,2,0,9.444268611576877,18,0
user_008807,38,50k-75k,desktop,new,Midwest,53,False,0,0,0,False,False,False,0,0,0,,0,0
user_008808,50,100k-150k,desktop,returning,South,51,True,122,3,0,True,True,True,75,1,0,7.115598041628452,47,2
user_008809,48,100k-150k,desktop,new,East,47,False,0,0,0,False,False,True,148,1,0,6.976275325437922,-148,-1
user_008810,44,75k-100k,desktop,returning,West,59,True,93,4,0,False,False,True,120,7,0,8.40991574937016,-27,-3
user_008811,46,100k-150k,desktop,returning,West,48,True,82,4,0,False,False,True,79,3,1,7.27775833084374,3,1
user_008812,25,75k-100k,tablet,returning,West,69,True,134,2,0,True,True,True,125,1,0,5.162129162488923,9,1
user_008813,46,30k-50k,desktop,new,East,56,True,127,2,0,False,False,True,124,2,0,8.577328356916539,3,0
user_008814,34,30k-50k,mobile,returning,South,92,True,83,2,0,True,True,True,38,3,0,7.040794149414202,45,-1
user_008815,39,75k-100k,desktop,new,South,60,True,128,1,0,False,True,True,104,1,0,9.518118118082503,24,0
user_008816,44,30k-50k,desktop,new,West,69,True,98,3,0,True,True,True,70,3,0,10.0,28,0
user_008817,34,50k-75k,mobile,returning,Midwest,44,True,109,4,0,False,False,True,99,3,0,5.559940737821704,10,1
user_008818,45,30k-50k,mobile,returning,West,52,True,36,3,0,True,True,True,20,4,0,7.287467524940578,16,-1
user_008819,31,50k-75k,mobile,returning,West,73,True,31,3,0,True,True,False,0,0,0,,31,3
user_008820,49,30k-50k,mobile,returning,West,49,False,0,0,0,False,True,True,106,1,0,9.217944126798107,-106,-1
user_008821,45,50k-75k,mobile,new,Midwest,35,False,0,0,0,False,False,True,127,1,0,7.439525673165216,-127,-1
user_008822,68,50k-75k,desktop,returning,Midwest,9,True,171,2,0,False,False,True,185,4,0,6.527491232999287,-14,-2
user_008823,60,75k-100k,mobile,returning,South,20,True,102,3,0,False,True,True,95,4,0,8.812050223838787,7,-1
user_008824,47,50k-75k,desktop,returning,East,54,True,89,3,0,False,True,True,66,2,0,9.034357138212343,23,1
user_008825,50,50k-75k,desktop,returning,East,44,True,39,4,0,False,False,True,30,2,0,7.709325008053584,9,2
user_008826,55,100k-150k,tablet,new,East,90,True,91,1,1,True,True,False,0,0,0,,91,1
user_008827,22,75k-100k,mobile,new,West,63,True,53,1,1,False,True,True,62,1,0,9.536997898321694,-9,0
user_008828,28,100k-150k,mobile,returning,South,80,True,79,3,1,True,True,True,61,3,0,8.465898520580753,18,0
user_008829,71,30k-50k,desktop,new,South,38,True,140,3,0,False,False,True,142,1,0,8.707053734441653,-2,2
user_008830,39,50k-75k,tablet,returning,Midwest,56,False,0,0,0,True,False,True,117,2,0,4.900421822635835,-117,-2
user_008831,66,30k-50k,mobile,returning,South,35,True,67,3,0,True,True,True,30,3,0,7.2471053513876145,37,0
user_008832,69,75k-100k,desktop,new,Midwest,37,True,116,6,0,False,False,True,90,4,0,3.7529796174167593,26,2
user_008833,39,50k-75k,tablet,returning,Midwest,60,True,74,2,0,True,True,True,58,1,0,9.437834815569449,16,1
user_008834,60,30k-50k,desktop,returning,West,54,True,100,8,0,False,False,True,107,9,1,6.470146184730896,-7,-1
user_008835,43,50k-75k,desktop,new,South,69,False,0,0,0,False,True,True,84,1,0,7.570077667052641,-84,-1
user_008836,45,75k-100k,mobile,new,West,47,True,139,1,0,False,True,True,110,1,1,9.037233351068751,29,0
user_008837,30,75k-100k,mobile,returning,West,100,True,75,2,0,True,True,True,41,4,0,9.507079858677969,34,-2
user_008838,30,30k-50k,desktop,returning,East,64,True,87,1,0,False,False,True,71,1,2,8.421762146917587,16,0
user_008839,42,50k-75k,desktop,returning,West,60,True,141,1,0,True,True,True,88,1,0,8.12649871379705,53,0
user_008840,43,100k-150k,desktop,returning,South,57,True,112,3,0,True,True,False,0,0,0,,112,3
user_008841,50,30k-50k,desktop,returning,East,43,True,75,4,0,True,True,True,59,3,0,7.621107911538449,16,1
user_008842,44,<30k,mobile,new,West,30,True,86,6,0,False,True,False,0,0,0,,86,6
user_008843,52,50k-75k,desktop,returning,South,16,True,110,1,0,False,False,True,146,2,0,8.122535231813323,-36,-1
user_008844,27,<30k,desktop,returning,Midwest,29,True,124,3,0,False,True,True,86,6,0,8.660732849950255,38,-3
user_008845,62,100k-150k,mobile,returning,West,62,True,96,3,0,True,True,True,36,2,0,8.734947582439716,60,1
user_008846,39,<30k,desktop,returning,East,49,True,168,4,0,True,False,True,126,2,0,6.229316166607669,42,2
user_008847,73,100k-150k,mobile,returning,Midwest,6,False,0,0,0,True,False,False,0,0,0,,0,0
user_008848,51,30k-50k,mobile,returning,South,48,True,94,5,0,True,True,False,0,0,0,,94,5
user_008849,58,100k-150k,desktop,returning,West,72,False,0,0,0,False,True,True,102,1,0,7.88415784595722,-102,-1
user_008850,45,30k-50k,desktop,new,East,43,True,145,1,0,False,False,True,128,1,0,8.455943323957273,17,0
user_008851,37,50k-75k,desktop,returning,South,49,True,93,1,0,True,True,True,59,3,1,7.479805848090194,34,-2
user_008852,34,50k-75k,desktop,returning,Midwest,48,True,78,3,0,True,True,True,89,1,0,6.525887153879844,-11,2
user_008853,18,>150k,desktop,new,East,77,True,98,1,0,True,True,True,81,1,0,7.5239056188246645,17,0
user_008854,50,50k-75k,desktop,returning,South,55,False,0,0,0,True,True,True,135,1,0,7.659656614876542,-135,-1
user_008855,43,<30k,mobile,returning,South,46,True,105,3,0,False,True,True,66,2,0,8.300012380493957,39,1
user_008856,42,30k-50k,mobile,returning,East,62,True,101,3,0,True,True,True,100,2,0,9.383952843126117,1,1
user_008857,39,>150k,mobile,new,East,78,True,125,3,0,True,True,True,107,1,0,7.679084547177403,18,2
user_008858,18,100k-150k,mobile,returning,East,81,True,74,3,1,False,True,True,55,1,0,9.285878697698964,19,2
user_008859,33,30k-50k,mobile,new,South,84,True,84,3,0,False,True,True,65,1,0,8.269500043395734,19,2
user_008860,19,>150k,tablet,returning,Midwest,68,True,101,1,0,False,True,True,119,1,0,7.61223987124099,-18,0
user_008861,28,<30k,desktop,returning,Midwest,58,False,0,0,0,True,True,True,81,1,0,8.945453573260668,-81,-1
user_008862,48,75k-100k,mobile,returning,East,33,True,40,5,0,False,True,True,47,6,0,9.0083618520015,-7,-1
user_008863,42,100k-150k,mobile,returning,East,52,True,111,1,0,True,True,True,105,2,0,8.486205571450537,6,-1
user_008864,49,50k-75k,mobile,returning,West,71,True,43,7,0,True,True,True,26,5,0,8.999502145625197,17,2
user_008865,53,<30k,desktop,returning,West,27,True,182,5,0,True,False,True,173,4,0,7.822765585941436,9,1
user_008866,18,<30k,mobile,returning,South,47,True,94,2,0,False,False,False,0,0,0,,94,2
user_008867,37,100k-150k,mobile,new,South,62,True,107,2,1,True,True,True,98,3,0,6.956849467372498,9,-1
user_008868,52,75k-100k,desktop,new,East,32,True,165,3,0,False,True,True,165,1,0,7.2641552853145495,0,2
user_008869,45,75k-100k,mobile,returning,Midwest,37,True,84,2,1,False,False,True,44,2,1,6.868618821892446,40,0
user_008870,47,75k-100k,mobile,returning,East,42,True,79,2,0,False,False,True,86,2,0,6.382857121987147,-7,0
user_008871,61,75k-100k,tablet,new,East,33,True,142,5,0,False,False,True,143,3,0,6.824595629802492,-1,2
user_008872,40,50k-75k,desktop,new,East,31,True,59,4,0,True,True,True,57,2,1,5.294680077066635,2,2
user_008873,67,<30k,desktop,returning,South,0,False,0,0,0,False,False,True,110,1,1,8.239834965208782,-110,-1
user_008874,48,30k-50k,desktop,new,Midwest,7,False,0,0,0,True,True,True,106,1,0,8.487792422183746,-106,-1
user_008875,71,50k-75k,mobile,returning,South,0,False,0,0,0,True,True,True,85,2,0,9.09755034758156,-85,-2
user_008876,37,<30k,desktop,returning,East,47,True,102,4,0,False,False,True,108,3,0,6.047880342607886,-6,1
user_008877,18,30k-50k,desktop,returning,West,86,True,82,1,0,False,True,True,50,1,0,8.397437794631537,32,0
user_008878,53,75k-100k,desktop,returning,East,62,True,70,3,0,False,False,True,71,3,1,6.934366342054203,-1,0
user_008879,35,100k-150k,desktop,returning,East,84,True,74,2,0,False,False,True,55,2,0,6.483128308410232,19,0
user_008880,57,<30k,desktop,returning,West,39,True,87,4,1,False,True,True,38,1,0,5.124133549140909,49,3
user_008881,25,100k-150k,desktop,new,Midwest,87,False,0,0,0,True,True,True,104,1,0,7.012495980684362,-104,-1
user_008882,61,100k-150k,mobile,returning,West,56,True,124,1,0,True,True,True,93,1,0,8.233428164012228,31,0
user_008883,70,30k-50k,mobile,new,East,26,False,0,0,0,False,False,True,159,2,0,5.7388320384348095,-159,-2
user_008884,53,30k-50k,desktop,returning,South,47,True,96,3,0,True,True,True,96,2,0,7.412847175368444,0,1
user_008885,42,>150k,desktop,new,South,68,True,84,5,0,False,True,True,74,5,0,8.732511076207338,10,0
user_008886,19,30k-50k,mobile,new,East,97,False,0,0,0,False,True,False,0,0,0,,0,0
user_008887,59,50k-75k,desktop,new,South,45,False,0,0,0,True,False,True,107,3,0,9.010936839777232,-107,-3
user_008888,54,50k-75k,tablet,new,West,71,False,0,0,0,False,False,False,0,0,0,,0,0
user_008889,18,30k-50k,desktop,returning,East,77,True,30,1,0,True,True,True,35,1,0,7.144830395443163,-5,0
user_008890,56,50k-75k,desktop,new,Midwest,33,False,0,0,0,False,False,True,129,2,0,7.718270219115443,-129,-2
user_008891,39,30k-50k,desktop,returning,West,57,True,129,3,0,True,True,True,106,3,0,6.59184103543342,23,0
user_008892,35,30k-50k,mobile,returning,West,59,True,31,4,0,True,True,True,51,2,0,7.8011331029388975,-20,2
user_008893,64,50k-75k,mobile,new,Midwest,17,False,0,0,0,False,False,True,121,1,0,7.231342537218712,-121,-1
user_008894,60,50k-75k,desktop,new,West,47,True,99,4,0,False,False,True,138,1,0,7.1146638508342,-39,3
user_008895,51,100k-150k,desktop,returning,Midwest,39,True,96,2,0,True,True,True,78,6,0,8.140959559738691,18,-4
user_008896,34,50k-75k,mobile,returning,South,54,True,73,1,0,True,True,True,57,2,0,5.53914402536953,16,-1
user_008897,45,100k-150k,mobile,returning,East,65,True,61,6,0,True,True,True,21,6,0,7.54857224288474,40,0
user_008898,71,50k-75k,desktop,returning,East,34,True,65,6,1,False,False,True,95,10,1,6.147526475984547,-30,-4
user_008899,36,50k-75k,tablet,new,East,75,True,86,1,0,False,True,True,41,1,0,7.530915203103222,45,0
user_008900,63,30k-50k,mobile,returning,East,17,True,139,6,0,True,True,True,131,2,0,10.0,8,4
user_008901,26,75k-100k,desktop,returning,West,100,True,94,4,1,True,False,True,102,4,0,7.00382796190647,-8,0
user_008902,30,50k-75k,mobile,new,South,64,False,0,0,0,True,True,True,102,1,0,8.766960627022156,-102,-1
user_008903,41,<30k,mobile,returning,Midwest,18,True,162,7,1,False,False,False,0,0,0,,162,7
user_008904,35,<30k,mobile,returning,Midwest,43,False,0,0,0,False,False,False,0,0,0,,0,0
user_008905,27,30k-50k,mobile,returning,East,72,True,111,7,0,True,True,False,0,0,0,,111,7
user_008906,67,50k-75k,desktop,returning,West,37,True,72,1,0,True,True,True,79,1,0,6.170336060769417,-7,0
user_008907,46,<30k,desktop,returning,East,33,False,0,0,0,True,True,True,86,1,0,7.276372399602021,-86,-1
user_008908,51,<30k,mobile,new,West,60,True,99,8,0,False,False,True,100,7,0,6.113574634089776,-1,1
user_008909,47,30k-50k,desktop,returning,East,46,True,92,6,1,False,False,True,84,9,1,7.750734647749258,8,-3
user_008910,35,50k-75k,mobile,new,West,66,True,121,2,1,True,True,True,93,1,0,7.698566087462621,28,1
user_008911,33,50k-75k,mobile,returning,East,73,True,54,1,0,True,True,True,43,1,0,8.473454275579634,11,0
user_008912,30,30k-50k,mobile,returning,West,84,True,30,6,0,True,True,False,0,0,0,,30,6
user_008913,55,100k-150k,mobile,new,West,70,True,185,3,0,True,True,False,0,0,0,,185,3
user_008914,41,<30k,desktop,returning,South,27,True,138,6,0,True,False,True,145,6,1,8.516639634229035,-7,0
user_008915,37,75k-100k,mobile,returning,South,61,True,132,3,0,True,True,True,74,1,1,8.439489789954038,58,2
user_008916,53,50k-75k,mobile,returning,Midwest,49,True,88,3,0,True,True,True,74,2,0,6.680559408531583,14,1
user_008917,38,30k-50k,desktop,returning,West,25,True,123,3,1,False,False,True,122,3,0,6.7535382902488585,1,0
user_008918,33,50k-75k,mobile,returning,West,79,True,76,2,0,True,True,True,60,1,0,7.3850933259317575,16,1
user_008919,53,50k-75k,desktop,returning,West,87,True,30,2,0,True,False,True,20,1,0,6.975964062798756,10,1
user_008920,74,30k-50k,mobile,returning,East,48,True,61,1,0,True,True,True,51,1,0,7.778689904343226,10,0
user_008921,80,30k-50k,desktop,returning,East,33,True,130,2,0,False,False,True,140,1,0,6.431733402848846,-10,1
user_008922,56,30k-50k,mobile,returning,East,29,True,115,2,1,True,False,True,97,1,1,5.619816194919392,18,1
user_008923,58,30k-50k,desktop,new,West,6,True,166,5,1,False,False,True,169,8,0,3.9056099989941884,-3,-3
user_008924,24,75k-100k,mobile,new,Midwest,56,True,107,2,1,False,True,True,69,1,0,6.599087555720535,38,1
user_008925,54,100k-150k,desktop,new,Midwest,70,True,99,2,0,True,True,False,0,0,0,,99,2
user_008926,73,50k-75k,desktop,returning,Midwest,42,True,123,5,0,True,True,True,92,2,0,9.8069723880996,31,3
user_008927,36,30k-50k,mobile,returning,South,63,False,0,0,0,True,True,True,85,2,0,10.0,-85,-2
user_008928,54,30k-50k,mobile,returning,East,65,True,130,1,0,False,True,True,104,1,0,6.928333608063444,26,0
user_008929,35,75k-100k,desktop,returning,Midwest,25,False,0,0,0,True,True,True,92,1,0,10.0,-92,-1
user_008930,51,100k-150k,mobile,returning,East,66,True,82,1,0,False,True,True,80,1,0,9.74218271024342,2,0
user_008931,26,100k-150k,mobile,new,South,84,True,71,3,0,False,True,True,41,1,0,8.418275865425153,30,2
user_008932,19,75k-100k,mobile,new,Midwest,51,False,0,0,0,False,True,True,112,1,0,6.989190429851135,-112,-1
user_008933,64,75k-100k,desktop,returning,East,50,True,84,2,0,True,False,True,76,2,0,9.060131790811111,8,0
user_008934,43,75k-100k,mobile,new,Midwest,29,True,168,3,1,True,False,True,179,4,0,7.138073231080915,-11,-1
user_008935,30,30k-50k,mobile,returning,South,72,True,93,2,0,False,True,True,73,1,0,9.867346268123043,20,1
user_008936,37,100k-150k,desktop,new,East,47,True,180,2,0,True,True,True,126,3,0,9.614952433279303,54,-1
user_008937,62,100k-150k,desktop,returning,West,36,True,120,5,0,False,True,True,97,4,0,7.033264846385809,23,1
user_008938,61,50k-75k,mobile,returning,West,53,True,69,5,0,True,True,True,53,1,0,9.228251949691728,16,4
user_008939,34,75k-100k,desktop,returning,East,28,True,143,3,0,False,True,False,0,0,0,,143,3
user_008940,47,50k-75k,mobile,new,East,68,True,125,7,0,False,True,True,89,7,0,8.189972861834068,36,0
user_008941,55,100k-150k,desktop,new,West,76,True,79,6,0,True,True,True,87,5,0,8.16051047403598,-8,1
user_008942,37,100k-150k,desktop,returning,East,52,True,119,3,0,False,True,True,111,3,0,6.0798079032372465,8,0
user_008943,48,50k-75k,mobile,returning,East,44,True,66,2,1,False,False,True,71,6,0,7.545528808739697,-5,-4
user_008944,54,75k-100k,mobile,returning,East,53,False,0,0,0,True,True,True,106,1,0,6.979521285294148,-106,-1
user_008945,57,30k-50k,desktop,returning,West,50,True,104,2,0,True,False,True,102,1,0,7.660081550418003,2,1
user_008946,78,75k-100k,desktop,new,West,64,True,106,1,0,True,True,True,91,1,0,8.292405909838578,15,0
user_008947,26,100k-150k,desktop,new,West,99,True,98,1,0,False,True,True,111,1,0,8.80828085118838,-13,0
user_008948,54,100k-150k,desktop,returning,East,100,True,30,2,0,True,True,True,43,3,0,6.935781556365997,-13,-1
user_008949,57,>150k,desktop,returning,Midwest,31,True,37,8,0,False,False,True,20,7,0,7.451711310917392,17,1
user_008950,52,>150k,mobile,returning,East,52,True,96,3,0,False,False,True,114,3,0,7.713967012924592,-18,0
user_008951,32,<30k,desktop,returning,West,76,True,120,3,1,False,True,True,112,4,0,7.485983870712554,8,-1
user_008952,36,30k-50k,tablet,new,South,23,True,130,1,0,True,True,True,55,1,0,6.295096672853784,75,0
user_008953,40,100k-150k,mobile,new,East,66,True,142,2,0,True,False,False,0,0,0,,142,2
user_008954,42,50k-75k,mobile,new,East,54,True,136,5,0,False,True,True,135,2,0,6.495718061230391,1,3
user_008955,18,50k-75k,mobile,new,East,65,True,122,6,1,True,True,True,83,3,0,7.3005764980670484,39,3
user_008956,44,75k-100k,desktop,new,Midwest,28,True,154,4,0,True,False,True,110,5,1,6.3764959123028575,44,-1
user_008957,28,<30k,desktop,new,East,71,True,83,3,0,False,True,True,88,1,0,7.890869268825116,-5,2
user_008958,60,50k-75k,mobile,new,South,21,False,0,0,0,False,True,True,85,1,0,8.638814061547365,-85,-1
user_008959,33,30k-50k,mobile,new,East,69,True,109,6,0,False,True,True,93,7,0,10.0,16,-1
user_008960,42,100k-150k,desktop,returning,South,53,True,99,5,0,False,True,True,81,5,0,5.723424551289538,18,0
user_008961,34,<30k,mobile,new,East,58,True,75,1,0,True,False,True,98,2,0,7.2024779348881145,-23,-1
user_008962,29,30k-50k,mobile,new,Midwest,84,False,0,0,0,False,True,True,113,1,1,9.638348276505369,-113,-1
user_008963,56,75k-100k,mobile,returning,West,31,True,93,7,0,True,False,True,120,8,0,5.360969756020215,-27,-1
user_008964,70,>150k,desktop,new,West,54,True,103,3,0,False,True,True,64,5,0,7.350187371376204,39,-2
user_008965,76,30k-50k,desktop,returning,South,47,True,89,4,1,True,False,True,53,4,1,7.675528095979681,36,0
user_008966,46,30k-50k,desktop,returning,South,40,True,84,3,2,False,False,True,71,1,0,7.466023147971709,13,2
user_008967,31,>150k,desktop,new,South,77,True,86,5,0,False,True,True,69,6,0,6.908169890598739,17,-1
user_008968,57,<30k,desktop,returning,South,27,True,153,2,1,True,False,False,0,0,0,,153,2
user_008969,20,50k-75k,mobile,returning,Midwest,72,False,0,0,0,False,True,False,0,0,0,,0,0
user_008970,69,50k-75k,mobile,new,South,31,True,107,3,1,False,True,True,78,3,0,8.00028307286742,29,0
user_008971,27,30k-50k,desktop,returning,West,56,True,88,1,0,False,True,True,75,1,0,7.683615530420546,13,0
user_008972,26,50k-75k,desktop,returning,Midwest,64,False,0,0,0,True,True,True,71,1,0,8.479595791248268,-71,-1
user_008973,31,100k-150k,mobile,returning,West,90,True,32,2,0,True,True,True,68,1,0,8.937473105681196,-36,1
user_008974,60,75k-100k,mobile,returning,South,33,True,108,1,0,False,True,True,80,1,0,7.570579464209675,28,0
user_008975,47,30k-50k,desktop,new,West,75,True,106,5,0,True,True,True,112,3,0,8.71866508494075,-6,2
user_008976,39,75k-100k,desktop,returning,West,62,True,96,4,1,True,True,True,111,1,0,8.393432304587371,-15,3
user_008977,59,30k-50k,desktop,returning,South,22,True,88,5,1,False,False,True,92,4,0,7.295768946454981,-4,1
user_008978,36,>150k,mobile,new,West,73,True,82,2,1,True,True,True,67,1,0,8.728914205704744,15,1
user_008979,40,50k-75k,desktop,returning,South,44,True,49,5,0,False,True,True,55,6,0,7.875319834946993,-6,-1
user_008980,30,50k-75k,desktop,new,West,95,True,47,1,0,False,True,True,44,1,0,10.0,3,0
user_008981,42,75k-100k,mobile,returning,Midwest,34,True,104,8,0,False,False,True,100,10,0,6.442163228947267,4,-2
user_008982,66,30k-50k,desktop,returning,South,15,False,0,0,0,False,False,True,160,1,0,6.382129965067788,-160,-1
user_008983,18,<30k,mobile,new,South,68,True,122,1,0,True,False,True,117,1,0,7.907480531648832,5,0
user_008984,67,100k-150k,desktop,returning,South,46,True,102,2,0,False,True,True,43,1,0,6.26084914290783,59,1
user_008985,47,50k-75k,mobile,returning,South,2,True,122,2,0,True,False,True,127,3,1,6.7230661657092305,-5,-1
user_008986,52,50k-75k,tablet,returning,West,80,False,0,0,0,True,True,False,0,0,0,,0,0
user_008987,50,<30k,mobile,new,South,61,False,0,0,0,True,True,True,122,3,0,10.0,-122,-3
user_008988,39,>150k,desktop,returning,South,43,True,75,1,0,True,True,False,0,0,0,,75,1
user_008989,18,100k-150k,mobile,returning,Midwest,69,True,131,1,0,True,True,True,94,1,0,7.297439017182439,37,0
user_008990,18,<30k,mobile,returning,South,79,False,0,0,0,True,True,False,0,0,0,,0,0
user_008991,60,30k-50k,mobile,returning,West,33,True,138,5,0,False,False,True,124,10,0,6.571384781753716,14,-5
user_008992,56,50k-75k,mobile,returning,Midwest,22,True,139,5,0,True,False,True,170,1,1,8.748155623208788,-31,4
user_008993,30,30k-50k,desktop,returning,South,60,True,127,4,0,False,False,True,142,3,0,8.703460193401819,-15,1
user_008994,58,50k-75k,desktop,returning,Midwest,6,False,0,0,0,True,False,False,0,0,0,,0,0
user_008995,36,100k-150k,mobile,new,East,30,True,61,2,0,False,False,True,60,2,0,5.779742871876228,1,0
user_008996,25,<30k,mobile,returning,East,49,False,0,0,0,False,True,True,109,1,0,7.1281406295336796,-109,-1
user_008997,61,75k-100k,mobile,returning,West,50,True,67,2,1,False,False,False,0,0,0,,67,2
user_008998,45,30k-50k,desktop,new,Midwest,39,True,136,4,0,False,False,True,147,3,1,7.365145330653681,-11,1
user_008999,53,50k-75k,mobile,returning,Midwest,79,True,84,4,0,False,False,True,90,1,1,8.9009293009164,-6,3
user_009000,51,75k-100k,desktop,returning,South,48,True,37,3,0,True,True,True,59,2,0,6.85727173742379,-22,1
user_009001,51,100k-150k,mobile,returning,East,43,True,124,2,0,False,True,True,106,1,0,8.803939883286999,18,1
user_009002,55,>150k,mobile,new,Midwest,68,True,150,3,0,True,True,True,121,3,0,9.694696287768908,29,0
user_009003,30,100k-150k,mobile,returning,Midwest,96,True,58,2,0,True,True,True,54,3,0,8.932909276852826,4,-1
user_009004,48,30k-50k,mobile,returning,South,44,True,76,5,0,True,True,True,67,4,0,7.649167360969008,9,1
user_009005,53,100k-150k,desktop,new,West,73,False,0,0,0,True,True,True,97,1,0,7.9106968145362675,-97,-1
user_009006,56,<30k,desktop,new,East,40,False,0,0,0,True,True,True,115,1,0,8.289797065658046,-115,-1
user_009007,57,75k-100k,desktop,new,East,35,True,87,2,0,True,False,True,74,3,0,8.393581943790752,13,-1
user_009008,48,100k-150k,desktop,new,South,69,False,0,0,0,True,False,True,131,1,1,8.413298161818851,-131,-1
user_009009,25,30k-50k,desktop,returning,South,47,True,123,1,0,True,True,True,112,2,0,7.746906461153773,11,-1
user_009010,41,75k-100k,desktop,returning,East,51,True,99,2,0,True,True,True,92,1,0,9.212897397441717,7,1
user_009011,56,<30k,desktop,new,South,34,True,112,6,0,False,False,True,96,3,1,8.926342766445398,16,3
user_009012,46,100k-150k,mobile,new,East,87,True,93,6,0,False,True,True,59,5,0,10.0,34,1
user_009013,52,30k-50k,mobile,returning,Midwest,45,True,62,2,1,True,False,True,59,1,0,8.309360111269784,3,1
user_009014,42,100k-150k,mobile,returning,East,67,True,86,5,1,False,True,True,66,3,0,7.110170938282204,20,2
user_009015,79,50k-75k,desktop,returning,South,41,True,89,1,0,False,False,True,86,3,0,5.992440546125421,3,-2
user_009016,32,100k-150k,desktop,returning,South,55,True,102,4,1,False,True,True,82,3,0,8.074019710389441,20,1
user_009017,43,75k-100k,mobile,new,East,58,True,189,2,0,False,False,True,190,3,0,7.815042135773875,-1,-1
user_009018,45,<30k,mobile,new,South,44,False,0,0,0,False,False,True,157,1,0,7.011730269189139,-157,-1
user_009019,56,75k-100k,desktop,new,East,39,True,77,4,0,True,True,True,66,7,0,7.099017874627717,11,-3
user_009020,39,75k-100k,mobile,returning,Midwest,61,True,63,5,1,True,True,True,47,6,0,7.7406919802956695,16,-1
user_009021,21,<30k,mobile,returning,West,95,False,0,0,0,True,True,True,102,1,0,9.337130863168396,-102,-1
user_009022,48,50k-75k,mobile,new,West,52,False,0,0,0,False,True,True,132,1,0,7.590102098688445,-132,-1
user_009023,44,<30k,mobile,returning,West,63,False,0,0,0,False,True,False,0,0,0,,0,0
user_009024,56,>150k,mobile,new,Midwest,17,True,142,2,0,False,False,True,134,3,0,6.550746840093065,8,-1
user_009025,18,50k-75k,desktop,returning,West,79,False,0,0,0,True,True,False,0,0,0,,0,0
user_009026,45,75k-100k,mobile,returning,East,31,False,0,0,0,False,True,True,98,2,0,6.530207786556335,-98,-2
user_009027,43,75k-100k,desktop,returning,East,49,True,132,2,0,False,False,True,115,1,0,6.724144195317343,17,1
user_009028,28,75k-100k,desktop,new,Midwest,53,True,68,2,0,False,True,True,25,1,0,8.298538264856049,43,1
user_009029,35,75k-100k,desktop,returning,South,42,True,64,3,0,True,True,True,55,5,0,7.272797367168433,9,-2
user_009030,54,75k-100k,mobile,returning,East,79,True,78,2,0,True,True,True,43,1,0,6.924779732198261,35,1
user_009031,41,100k-150k,desktop,new,East,79,True,74,3,0,False,True,True,76,1,0,8.319178902844595,-2,2
user_009032,38,50k-75k,mobile,returning,East,57,True,122,2,0,False,True,True,138,1,0,5.652518989722782,-16,1
user_009033,68,50k-75k,mobile,returning,South,22,True,144,7,0,True,True,True,126,5,0,5.774069722972608,18,2
user_009034,39,>150k,mobile,returning,East,58,True,101,1,0,True,True,True,60,1,0,7.017865053813591,41,0
user_009035,40,100k-150k,desktop,new,South,49,True,170,3,0,False,False,True,169,1,0,6.90660898391222,1,2
user_009036,36,75k-100k,tablet,returning,South,40,True,125,4,0,False,False,True,127,4,0,4.942842984332,-2,0
user_009037,73,75k-100k,desktop,new,East,37,True,175,4,0,False,True,True,111,2,0,6.944745554709109,64,2
user_009038,56,75k-100k,mobile,returning,West,63,True,83,4,0,False,False,True,30,2,0,8.0647936329575,53,2
user_009039,55,75k-100k,mobile,returning,South,51,True,82,4,0,False,False,False,0,0,0,,82,4
user_009040,34,30k-50k,mobile,returning,East,49,True,76,3,0,True,True,True,92,3,0,6.631124025801837,-16,0
user_009041,34,75k-100k,desktop,new,South,100,True,116,2,0,False,True,True,89,3,0,8.020937217117607,27,-1
user_009042,67,>150k,mobile,returning,South,35,True,68,5,0,True,False,True,57,8,1,7.605875886171904,11,-3
user_009043,30,100k-150k,mobile,new,East,82,True,55,1,0,True,True,True,31,1,0,8.493510398673681,24,0
user_009044,64,30k-50k,desktop,returning,East,25,True,139,3,0,False,False,True,155,5,0,6.59184375819722,-16,-2
user_009045,40,50k-75k,desktop,new,West,57,True,156,2,0,False,True,True,130,1,0,9.21621796500402,26,1
user_009046,36,50k-75k,mobile,new,South,73,True,69,2,1,False,False,True,87,1,0,6.846690773308521,-18,1
user_009047,38,>150k,desktop,new,Midwest,66,True,120,1,0,True,True,True,117,1,0,8.492900770722672,3,0
user_009048,36,<30k,mobile,new,South,42,False,0,0,0,True,False,True,123,1,0,7.571374759127506,-123,-1
user_009049,32,50k-75k,mobile,new,East,83,True,72,4,0,True,True,True,22,6,0,8.925580561809213,50,-2
user_009050,48,100k-150k,mobile,returning,South,49,True,30,4,0,False,True,True,20,2,0,7.835151725822829,10,2
user_009051,28,50k-75k,mobile,new,Midwest,45,True,113,2,0,False,False,True,109,2,1,6.678571601753309,4,0
user_009052,40,75k-100k,desktop,new,Midwest,45,True,121,4,0,False,False,True,158,5,1,6.69247740301207,-37,-1
user_009053,38,100k-150k,mobile,new,Midwest,79,True,31,6,0,True,True,True,21,5,0,9.0129185813529,10,1
user_009054,50,75k-100k,tablet,returning,Midwest,48,True,129,4,0,False,False,True,114,3,0,6.3769618997285304,15,1
user_009055,68,100k-150k,desktop,returning,West,64,True,137,2,1,False,True,True,131,1,0,6.533086295208405,6,1
user_009056,48,100k-150k,desktop,new,Midwest,47,True,65,6,0,False,True,True,54,3,0,8.516421605852422,11,3
user_009057,56,50k-75k,desktop,returning,West,28,True,110,3,0,True,False,True,93,4,0,6.342496585759837,17,-1
user_009058,32,50k-75k,desktop,new,South,73,True,137,2,0,False,True,True,138,3,0,8.26614246556508,-1,-1
user_009059,40,75k-100k,mobile,returning,West,64,False,0,0,0,False,True,True,59,1,1,8.326770652053067,-59,-1
user_009060,48,100k-150k,mobile,new,Midwest,76,True,103,4,0,True,False,True,132,3,0,7.492152938442752,-29,1
user_009061,73,30k-50k,desktop,returning,West,54,False,0,0,0,True,True,True,110,1,0,6.69375082825587,-110,-1
user_009062,39,75k-100k,desktop,returning,South,46,True,129,2,0,True,True,True,109,2,0,7.949235569954608,20,0
user_009063,54,75k-100k,tablet,new,Midwest,63,True,105,2,0,False,False,True,152,3,0,6.106351357761018,-47,-1
user_009064,40,100k-150k,desktop,returning,West,81,True,93,3,0,True,True,True,71,2,0,7.073168825437169,22,1
user_009065,34,>150k,mobile,new,East,100,True,93,8,0,False,True,True,68,5,0,7.722762353323091,25,3
user_009066,63,50k-75k,desktop,returning,South,12,True,95,4,1,False,False,True,116,5,1,5.963524731859419,-21,-1
user_009067,34,75k-100k,desktop,new,East,79,False,0,0,0,True,False,False,0,0,0,,0,0
user_009068,52,30k-50k,mobile,returning,South,35,True,30,7,0,True,True,True,51,2,0,6.672846926243535,-21,5
user_009069,49,50k-75k,desktop,returning,East,62,True,100,3,0,True,True,True,73,2,0,9.470305731062465,27,1
user_009070,44,30k-50k,mobile,returning,West,86,True,61,5,1,True,True,True,53,1,0,7.844800117301211,8,4
user_009071,75,<30k,desktop,returning,West,35,True,99,7,0,False,False,True,109,7,0,8.283382436339826,-10,0
user_009072,52,50k-75k,mobile,new,Midwest,33,False,0,0,0,False,True,True,90,2,0,10.0,-90,-2
user_009073,20,50k-75k,desktop,returning,South,78,True,30,2,0,False,True,True,20,2,0,9.926121641979737,10,0
user_009074,55,50k-75k,desktop,returning,West,95,True,74,3,0,True,True,True,43,2,0,7.116894846784863,31,1
user_009075,45,50k-75k,desktop,new,South,50,True,110,2,0,True,False,True,149,1,0,7.9561056604726526,-39,1
user_009076,18,30k-50k,mobile,new,Midwest,54,True,172,3,0,False,True,True,119,2,1,6.27742637506337,53,1
user_009077,49,50k-75k,desktop,new,East,74,True,87,2,1,False,True,True,49,1,0,8.084819927700558,38,1
user_009078,66,75k-100k,tablet,returning,West,50,True,77,4,0,False,False,True,75,5,0,6.112227250032726,2,-1
user_009079,18,75k-100k,mobile,new,Midwest,43,False,0,0,0,False,False,True,126,1,0,8.12962165959522,-126,-1
user_009080,42,100k-150k,mobile,returning,South,95,True,52,3,1,True,True,True,35,1,0,8.30878115573727,17,2
user_009081,37,<30k,desktop,returning,South,68,True,80,3,0,False,True,True,72,3,0,9.398744239425373,8,0
user_009082,27,30k-50k,desktop,new,South,39,True,109,4,0,True,True,True,86,5,0,5.9287363724343765,23,-1
user_009083,58,30k-50k,desktop,returning,East,57,True,38,3,0,False,False,True,27,3,0,9.30678034565634,11,0
user_009084,35,50k-75k,mobile,returning,West,84,True,77,2,1,False,True,True,78,1,0,6.993724874501572,-1,1
user_009085,54,75k-100k,desktop,new,South,43,True,166,1,0,True,True,True,130,1,0,7.200432046541956,36,0
user_009086,45,30k-50k,desktop,returning,East,79,True,82,1,0,False,True,True,65,1,0,10.0,17,0
user_009087,55,50k-75k,mobile,returning,West,65,True,30,5,0,False,True,True,20,4,0,6.804782530635519,10,1
user_009088,57,<30k,mobile,new,South,28,True,188,6,0,False,False,False,0,0,0,,188,6
user_009089,27,50k-75k,tablet,returning,South,55,False,0,0,0,False,True,True,76,4,0,7.8228694568824055,-76,-4
user_009090,45,30k-50k,mobile,new,East,32,True,120,5,0,True,True,True,135,2,0,6.638737138006318,-15,3
user_009091,38,<30k,mobile,returning,East,28,True,125,7,0,True,False,True,115,6,0,7.472466983536329,10,1
user_009092,42,75k-100k,mobile,returning,South,19,True,138,1,0,False,True,True,123,1,0,8.971821500984454,15,0
user_009093,37,<30k,mobile,new,East,56,True,182,2,0,False,False,True,200,1,0,5.8593178147796445,-18,1
user_009094,57,50k-75k,mobile,new,East,39,True,90,2,0,False,False,True,112,5,0,7.632732839104915,-22,-3
user_009095,39,50k-75k,desktop,returning,East,43,True,106,3,0,True,False,True,94,1,0,8.046502192498798,12,2
user_009096,58,<30k,desktop,returning,South,10,False,0,0,0,False,False,True,104,2,0,7.8546236393602324,-104,-2
user_009097,52,30k-50k,mobile,returning,South,5,False,0,0,0,False,False,True,102,1,0,7.830753139896248,-102,-1
user_009098,70,50k-75k,desktop,new,East,34,True,167,8,1,False,False,False,0,0,0,,167,8
user_009099,71,<30k,desktop,returning,East,31,False,0,0,0,True,False,False,0,0,0,,0,0
user_009100,49,50k-75k,mobile,returning,South,41,True,121,1,0,False,False,True,114,1,0,5.206589271441716,7,0
user_009101,32,50k-75k,mobile,returning,South,44,True,132,6,1,False,False,True,147,8,0,8.746911131982108,-15,-2
user_009102,52,100k-150k,desktop,new,South,40,True,106,3,0,False,False,True,115,4,0,5.803120181668779,-9,-1
user_009103,52,50k-75k,desktop,new,East,39,False,0,0,0,False,True,True,105,1,0,8.621655378865116,-105,-1
user_009104,64,75k-100k,desktop,returning,West,30,True,65,3,0,False,False,True,56,5,0,7.18071333702469,9,-2
user_009105,58,<30k,mobile,returning,East,31,False,0,0,0,False,False,True,126,1,0,7.039587628285693,-126,-1
user_009106,49,>150k,mobile,new,Midwest,40,True,89,2,1,True,False,True,99,2,0,6.059516826646317,-10,0
user_009107,51,50k-75k,desktop,returning,South,19,False,0,0,0,False,False,True,133,2,0,7.29299152104207,-133,-2
user_009108,57,30k-50k,mobile,new,Midwest,15,True,168,5,0,True,True,True,125,2,1,8.455103299522897,43,3
user_009109,52,30k-50k,desktop,returning,East,31,True,128,5,0,False,True,False,0,0,0,,128,5
user_009110,18,30k-50k,mobile,returning,South,52,True,129,3,0,True,True,True,135,3,0,9.128355707995551,-6,0
user_009111,65,30k-50k,mobile,new,South,24,True,182,2,0,False,False,True,160,1,0,8.188388608507594,22,1
user_009112,55,75k-100k,desktop,new,West,85,True,78,2,0,True,True,True,81,1,0,8.223366650022589,-3,1
user_009113,49,75k-100k,desktop,returning,South,5,True,78,2,0,True,True,True,53,4,0,7.932718232945375,25,-2
user_009114,50,50k-75k,mobile,returning,South,25,True,88,3,0,False,False,True,50,4,1,7.507228473361263,38,-1
user_009115,68,50k-75k,mobile,returning,South,10,True,132,3,1,True,False,True,137,3,0,8.20709439772173,-5,0
user_009116,21,50k-75k,mobile,new,South,51,True,122,1,0,False,True,True,92,1,0,9.257091790383106,30,0
user_009117,70,>150k,mobile,new,South,19,True,158,5,1,True,False,True,160,3,1,5.095085441620473,-2,2
user_009118,44,<30k,desktop,new,West,31,True,123,4,0,True,False,False,0,0,0,,123,4
user_009119,76,100k-150k,mobile,new,East,50,True,134,3,0,True,True,True,89,1,0,9.577280185271777,45,2
user_009120,47,100k-150k,desktop,new,East,54,True,107,3,0,True,True,True,107,2,0,8.459284393760964,0,1
user_009121,60,<30k,mobile,new,South,2,False,0,0,0,True,True,True,74,1,0,9.501921482706225,-74,-1
user_009122,51,75k-100k,desktop,returning,East,60,True,43,1,0,False,True,True,36,1,1,6.102686307624769,7,0
user_009123,36,50k-75k,tablet,returning,South,35,True,99,1,0,True,True,True,72,1,0,7.565048211734744,27,0
user_009124,61,100k-150k,mobile,returning,Midwest,41,True,126,4,1,True,True,True,114,3,0,8.416487720521227,12,1
user_009125,52,50k-75k,desktop,returning,West,48,True,142,1,0,False,True,True,132,1,0,9.290654837786143,10,0
user_009126,41,<30k,mobile,returning,Midwest,43,True,75,2,0,False,True,True,47,1,0,10.0,28,1
user_009127,38,75k-100k,mobile,new,South,37,True,107,2,0,False,True,True,91,1,0,7.443835160099494,16,1
user_009128,43,100k-150k,desktop,returning,West,61,True,112,1,0,True,True,True,83,1,0,10.0,29,0
user_009129,35,50k-75k,mobile,new,Midwest,48,True,116,1,0,False,False,True,129,1,0,7.270662764281423,-13,0
user_009130,18,100k-150k,mobile,returning,South,75,True,30,3,0,False,True,True,20,2,0,7.866823932872322,10,1
user_009131,21,30k-50k,desktop,new,Midwest,71,True,108,2,0,False,False,True,73,4,0,7.395001910323942,35,-2
user_009132,57,>150k,desktop,new,East,45,True,128,3,0,False,True,False,0,0,0,,128,3
user_009133,30,30k-50k,tablet,new,West,86,True,144,2,0,True,False,True,186,1,0,6.874471641048381,-42,1
user_009134,40,100k-150k,mobile,returning,South,77,True,30,6,0,True,True,True,35,3,0,8.012925480054045,-5,3
user_009135,50,50k-75k,desktop,returning,West,58,True,69,1,0,True,True,True,78,1,1,6.87271563289394,-9,0
user_009136,48,50k-75k,mobile,returning,South,43,True,92,3,0,True,True,True,42,1,0,8.727867710499773,50,2
user_009137,41,30k-50k,desktop,new,West,80,True,63,2,0,True,True,True,48,1,0,7.966489283599956,15,1
user_009138,43,50k-75k,mobile,returning,East,26,True,186,4,0,False,False,True,196,9,0,6.4507018990845255,-10,-5
user_009139,80,<30k,desktop,returning,Midwest,2,True,91,1,0,False,False,True,86,1,0,6.688761988460891,5,0
user_009140,59,<30k,desktop,returning,East,5,False,0,0,0,False,False,False,0,0,0,,0,0
user_009141,46,50k-75k,mobile,returning,Midwest,16,True,85,5,0,False,False,True,74,4,0,7.6831824602010395,11,1
user_009142,55,30k-50k,mobile,returning,Midwest,33,True,98,8,0,True,True,True,65,5,0,6.285196474572798,33,3
user_009143,71,75k-100k,desktop,returning,South,59,True,91,1,0,False,False,True,122,1,1,6.974285126112437,-31,0
user_009144,50,30k-50k,desktop,returning,Midwest,34,True,101,5,0,False,False,False,0,0,0,,101,5
user_009145,61,30k-50k,mobile,returning,South,47,True,141,4,0,False,True,True,88,3,0,7.600998099404664,53,1
user_009146,42,50k-75k,desktop,new,West,82,True,93,2,0,False,True,True,90,2,0,8.429637136961516,3,0
user_009147,53,30k-50k,desktop,new,East,39,False,0,0,0,True,False,False,0,0,0,,0,0
user_009148,34,30k-50k,mobile,returning,Midwest,62,True,121,5,0,False,True,True,90,3,0,7.790478379589562,31,2
user_009149,37,100k-150k,mobile,returning,South,56,True,135,3,1,True,True,True,101,1,0,6.552155751373075,34,2
user_009150,52,30k-50k,mobile,returning,East,54,True,99,2,0,True,True,True,86,1,0,10.0,13,1
user_009151,50,50k-75k,desktop,new,East,39,True,138,5,0,False,False,True,168,4,1,7.248917663850755,-30,1
user_009152,30,100k-150k,desktop,new,West,79,False,0,0,0,False,True,True,94,1,1,6.088307228449593,-94,-1
user_009153,46,<30k,mobile,new,West,47,True,119,2,0,False,True,True,114,3,0,6.410611142492051,5,-1
user_009154,29,75k-100k,desktop,returning,East,81,True,91,3,1,True,True,True,64,2,0,8.54501619148322,27,1
user_009155,51,75k-100k,desktop,returning,Midwest,72,True,93,2,0,True,True,True,103,5,0,7.139904823259925,-10,-3
user_009156,42,75k-100k,desktop,new,West,59,True,156,2,0,True,True,True,125,1,0,7.835599224234148,31,1
user_009157,39,100k-150k,mobile,new,East,83,True,103,2,0,False,True,True,92,2,0,9.461854183332468,11,0
user_009158,54,30k-50k,desktop,returning,South,58,True,109,1,0,True,True,True,71,1,0,5.511295768632416,38,0
user_009159,59,<30k,mobile,returning,East,11,True,160,3,0,True,False,True,183,2,0,7.9631884464335805,-23,1
user_009160,34,50k-75k,desktop,new,West,85,True,86,1,0,True,True,True,100,2,0,8.719106137596023,-14,-1
user_009161,39,50k-75k,desktop,returning,South,58,True,51,3,2,False,False,True,77,2,0,7.7570187302157665,-26,1
user_009162,43,100k-150k,desktop,returning,West,67,True,96,6,1,True,True,True,99,3,0,9.372854736394329,-3,3
user_009163,30,100k-150k,mobile,returning,West,100,True,30,3,1,False,True,True,20,1,0,9.553751827874661,10,2
user_009164,62,100k-150k,desktop,new,South,22,False,0,0,0,False,False,False,0,0,0,,0,0
user_009165,44,30k-50k,mobile,returning,East,33,True,99,3,0,True,True,True,85,8,1,7.6553571449102105,14,-5
user_009166,43,50k-75k,mobile,new,West,56,True,124,4,0,False,True,True,64,3,0,7.949413306422524,60,1
user_009167,26,<30k,desktop,new,West,64,True,124,3,0,False,False,True,113,2,0,7.909160422044197,11,1
user_009168,36,<30k,desktop,returning,West,49,True,80,4,0,False,False,True,101,6,1,6.998613090154478,-21,-2
user_009169,39,50k-75k,mobile,returning,Midwest,45,True,105,4,0,True,True,True,90,3,0,10.0,15,1
user_009170,59,100k-150k,mobile,new,East,38,False,0,0,0,False,False,True,123,1,0,7.386448757149405,-123,-1
user_009171,25,<30k,desktop,returning,Midwest,33,True,52,2,1,False,True,True,53,1,0,7.430652538002732,-1,1
user_009172,58,<30k,desktop,returning,East,21,True,130,3,1,False,False,True,135,3,0,5.700425567667617,-5,0
user_009173,55,30k-50k,mobile,returning,West,73,True,75,6,0,False,True,True,42,6,0,9.25821759000308,33,0
user_009174,35,100k-150k,mobile,returning,West,71,True,62,1,1,False,True,True,69,2,0,7.348835920155545,-7,-1
user_009175,45,<30k,tablet,returning,East,25,True,116,5,1,True,False,True,93,3,0,8.409767393801388,23,2
user_009176,39,30k-50k,mobile,returning,South,1,False,0,0,0,False,False,True,109,2,0,7.602633193373689,-109,-2
user_009177,24,75k-100k,mobile,returning,South,67,True,74,1,0,True,True,True,69,1,0,10.0,5,0
user_009178,50,50k-75k,mobile,returning,East,47,True,57,3,0,True,True,True,64,2,0,10.0,-7,1
user_009179,48,50k-75k,desktop,returning,East,45,True,101,3,0,True,False,True,122,4,0,5.957791195327246,-21,-1
user_009180,53,75k-100k,mobile,new,South,48,True,151,3,0,True,True,True,119,1,0,9.224592230991988,32,2
user_009181,32,30k-50k,mobile,new,South,65,True,146,1,0,False,False,True,148,1,0,6.475494906752945,-2,0
user_009182,35,75k-100k,mobile,returning,West,82,True,72,6,0,True,True,True,70,5,0,9.975890709394525,2,1
user_009183,65,30k-50k,desktop,returning,East,53,True,88,1,0,True,True,True,66,1,0,7.173512508376011,22,0
user_009184,61,<30k,desktop,returning,West,43,True,95,1,1,False,False,True,73,1,0,6.573805449695235,22,0
user_009185,59,100k-150k,mobile,returning,South,11,True,151,3,0,True,False,True,159,3,0,8.06668279063843,-8,0
user_009186,23,30k-50k,mobile,returning,West,65,False,0,0,0,True,True,True,90,3,0,7.990496385830707,-90,-3
user_009187,26,30k-50k,desktop,returning,West,91,False,0,0,0,True,True,True,154,2,0,7.626171193729384,-154,-2
user_009188,28,<30k,desktop,returning,West,76,False,0,0,0,False,True,True,100,1,0,8.215857007599404,-100,-1
user_009189,57,100k-150k,mobile,returning,West,61,True,69,4,0,True,True,True,59,2,0,10.0,10,2
user_009190,54,30k-50k,mobile,returning,West,83,True,52,4,0,True,True,True,20,2,0,10.0,32,2
user_009191,63,30k-50k,desktop,new,South,19,True,153,3,0,False,False,True,151,8,0,7.367341921118919,2,-5
user_009192,43,30k-50k,desktop,new,East,36,False,0,0,0,True,True,True,112,3,0,7.77982079962289,-112,-3
user_009193,41,50k-75k,mobile,returning,West,81,False,0,0,0,True,True,False,0,0,0,,0,0
user_009194,38,30k-50k,mobile,returning,East,44,True,104,3,1,True,True,True,81,2,0,8.328818023985864,23,1
user_009195,23,30k-50k,desktop,new,South,50,True,99,1,0,True,False,True,150,1,0,5.607373822505813,-51,0
user_009196,18,50k-75k,desktop,returning,South,60,False,0,0,0,True,True,True,96,1,0,8.008750708403603,-96,-1
user_009197,49,30k-50k,desktop,returning,East,46,True,93,2,1,False,True,True,77,1,0,8.163006820829196,16,1
user_009198,18,75k-100k,mobile,returning,East,55,True,99,2,0,True,True,False,0,0,0,,99,2
user_009199,43,75k-100k,mobile,returning,East,37,True,106,3,0,True,True,True,72,3,0,10.0,34,0
user_009200,27,30k-50k,mobile,returning,South,79,True,30,2,0,True,True,True,20,1,0,9.241782212187253,10,1
user_009201,46,50k-75k,mobile,new,West,42,True,115,1,0,True,True,True,95,1,0,8.670153925193484,20,0
user_009202,44,75k-100k,desktop,returning,West,64,True,77,3,0,True,False,True,104,3,0,8.875038937081344,-27,0
user_009203,34,30k-50k,desktop,returning,East,57,True,111,3,0,True,False,True,132,8,0,7.753097342045155,-21,-5
user_009204,35,>150k,mobile,returning,East,56,True,97,5,0,False,True,True,44,7,0,9.336632333806977,53,-2
user_009205,49,50k-75k,mobile,returning,West,64,True,126,1,0,True,False,True,120,1,0,8.25499214552302,6,0
user_009206,31,30k-50k,desktop,returning,Midwest,34,True,71,3,0,True,True,True,37,1,0,6.102541195378913,34,2
user_009207,33,75k-100k,mobile,new,West,77,True,71,5,0,False,True,True,61,3,0,8.500930236261718,10,2
user_009208,61,30k-50k,mobile,new,West,45,False,0,0,0,False,False,False,0,0,0,,0,0
user_009209,28,30k-50k,mobile,new,South,66,False,0,0,0,False,True,True,119,2,0,10.0,-119,-2
user_009210,50,75k-100k,mobile,new,East,32,False,0,0,0,False,True,True,80,2,0,7.888716442119627,-80,-2
user_009211,18,50k-75k,desktop,returning,East,85,False,0,0,0,False,True,True,93,1,0,8.599175840655132,-93,-1
user_009212,36,<30k,desktop,returning,East,38,True,103,6,0,True,True,True,94,3,0,10.0,9,3
user_009213,45,100k-150k,desktop,returning,West,30,True,88,1,0,True,True,True,22,1,0,7.152810033251707,66,0
user_009214,67,100k-150k,desktop,returning,South,43,False,0,0,0,False,False,True,121,1,0,7.92983526153021,-121,-1
user_009215,18,<30k,mobile,new,South,60,False,0,0,0,False,False,False,0,0,0,,0,0
user_009216,40,30k-50k,desktop,new,West,60,True,137,2,1,True,True,True,148,1,0,7.510535957627513,-11,1
user_009217,35,50k-75k,mobile,returning,Midwest,50,True,77,2,0,False,True,True,87,1,0,8.760776026951346,-10,1
user_009218,23,30k-50k,tablet,returning,East,72,True,86,3,0,True,True,True,87,4,0,8.855727712887338,-1,-1
user_009219,23,50k-75k,mobile,new,East,93,False,0,0,0,False,True,False,0,0,0,,0,0
user_009220,45,75k-100k,desktop,returning,West,81,True,79,1,0,False,False,True,50,2,0,6.197994481048992,29,-1
user_009221,32,>150k,desktop,returning,Midwest,78,True,80,1,0,False,True,True,49,1,0,8.03890618148282,31,0
user_009222,59,50k-75k,desktop,returning,Midwest,44,True,105,3,0,True,True,True,66,4,0,8.658144567933121,39,-1
user_009223,60,75k-100k,desktop,returning,East,32,True,83,3,0,True,True,True,61,5,0,7.691346037163956,22,-2
user_009224,57,50k-75k,desktop,returning,South,23,True,112,2,1,False,False,True,126,4,0,7.444370551109024,-14,-2
user_009225,55,100k-150k,mobile,new,South,59,True,125,1,0,True,False,True,97,2,0,6.150931214200632,28,-1
user_009226,63,50k-75k,mobile,returning,South,11,True,166,5,0,False,False,True,203,5,0,7.4319825893258855,-37,0
user_009227,48,50k-75k,desktop,new,East,34,False,0,0,0,False,True,True,86,1,0,8.64011315902068,-86,-1
user_009228,18,50k-75k,mobile,returning,East,67,True,35,3,0,False,True,True,20,3,0,7.467055272620034,15,0
user_009229,41,50k-75k,mobile,returning,East,51,True,30,2,0,False,True,True,30,2,0,6.291640791856217,0,0
user_009230,43,50k-75k,desktop,returning,West,35,False,0,0,0,True,True,True,81,1,0,7.126555092722799,-81,-1
user_009231,47,50k-75k,mobile,returning,Midwest,70,True,79,2,0,True,True,True,49,1,0,6.586421719388058,30,1
user_009232,48,100k-150k,desktop,new,East,92,False,0,0,0,False,True,True,124,1,0,7.799527581057311,-124,-1
user_009233,32,75k-100k,desktop,new,East,73,True,109,3,0,True,True,True,89,1,0,9.473674132048233,20,2
user_009234,22,100k-150k,mobile,returning,South,78,True,52,4,0,True,True,True,66,3,0,7.950306461829721,-14,1
user_009235,53,30k-50k,mobile,returning,East,37,True,129,5,0,True,False,True,146,8,0,6.3332339005912806,-17,-3
user_009236,18,30k-50k,desktop,returning,East,68,True,117,3,0,False,False,True,122,2,0,5.794221444577963,-5,1
user_009237,53,100k-150k,mobile,new,East,54,True,91,3,0,False,True,True,74,1,0,7.747424778235768,17,2
user_009238,53,50k-75k,mobile,returning,West,33,True,121,2,0,True,True,True,90,4,0,7.919544264015925,31,-2
user_009239,78,100k-150k,mobile,new,South,29,True,131,3,0,False,True,True,99,3,0,8.116849930429211,32,0
user_009240,72,30k-50k,mobile,returning,East,47,True,62,2,0,False,True,True,56,1,0,5.1111062861539445,6,1
user_009241,61,50k-75k,mobile,new,South,41,False,0,0,0,False,False,True,101,3,1,7.5223796652918065,-101,-3
user_009242,22,100k-150k,desktop,returning,Midwest,83,True,59,2,0,False,True,True,88,1,0,8.669044503023315,-29,1
user_009243,64,30k-50k,desktop,new,West,40,True,122,2,0,True,False,False,0,0,0,,122,2
user_009244,69,50k-75k,desktop,returning,South,41,False,0,0,0,False,False,False,0,0,0,,0,0
user_009245,30,30k-50k,mobile,returning,West,78,True,58,5,0,True,True,True,73,7,0,6.837093833335285,-15,-2
user_009246,21,<30k,desktop,returning,Midwest,29,False,0,0,0,True,False,True,138,2,0,8.608868416520696,-138,-2
user_009247,44,30k-50k,mobile,returning,West,34,True,125,3,0,True,True,True,94,2,0,8.912860859639204,31,1
user_009248,51,50k-75k,desktop,returning,East,49,True,102,4,0,False,False,True,110,6,0,5.907380643004978,-8,-2
user_009249,27,100k-150k,mobile,new,West,100,True,143,3,0,True,True,True,109,3,1,8.942020014119178,34,0
user_009250,53,50k-75k,desktop,returning,East,43,True,30,3,0,True,True,True,20,2,0,8.168755441223357,10,1
user_009251,25,50k-75k,desktop,new,South,64,True,113,3,0,False,True,True,85,1,0,6.245010758186527,28,2
user_009252,62,50k-75k,desktop,returning,West,49,True,125,2,0,False,False,True,118,3,0,6.260749238260629,7,-1
user_009253,44,<30k,mobile,new,West,48,True,136,3,1,False,True,True,110,3,0,10.0,26,0
user_009254,52,75k-100k,desktop,returning,East,73,True,96,3,0,True,True,True,55,4,0,7.374848453839228,41,-1
user_009255,60,100k-150k,desktop,new,Midwest,57,True,164,7,0,False,False,True,152,12,0,7.974350136015229,12,-5
user_009256,55,75k-100k,mobile,returning,Midwest,28,True,102,3,0,False,False,True,87,4,0,7.335325329418704,15,-1
user_009257,70,100k-150k,mobile,new,South,31,True,144,5,0,True,True,True,99,7,0,8.403309523750725,45,-2
user_009258,31,>150k,mobile,returning,East,92,False,0,0,0,True,True,True,99,1,0,10.0,-99,-1
user_009259,18,50k-75k,desktop,new,West,95,False,0,0,0,True,True,False,0,0,0,,0,0
user_009260,38,30k-50k,desktop,returning,East,58,False,0,0,0,False,True,True,108,1,0,10.0,-108,-1
user_009261,56,30k-50k,desktop,returning,Midwest,34,True,54,7,0,True,True,True,20,11,0,8.781262713676815,34,-4
user_009262,47,75k-100k,mobile,returning,Midwest,28,True,107,8,1,True,True,True,64,6,0,9.050781098085395,43,2
user_009263,44,50k-75k,mobile,returning,Midwest,51,True,133,3,0,True,True,True,137,5,1,7.899357498259754,-4,-2
user_009264,40,50k-75k,mobile,returning,West,55,True,83,6,0,True,True,True,74,6,0,7.271079793377716,9,0
user_009265,26,75k-100k,desktop,returning,East,68,True,103,3,0,False,True,True,81,2,0,7.975560106525122,22,1
user_009266,55,75k-100k,mobile,returning,West,76,True,102,1,0,False,True,True,46,3,1,7.139692406288708,56,-2
user_009267,48,75k-100k,mobile,returning,Midwest,36,True,71,6,2,True,True,True,29,7,1,8.465116471619137,42,-1
user_009268,55,30k-50k,mobile,new,East,53,True,90,1,0,True,False,True,33,1,0,7.119025411021949,57,0
user_009269,45,100k-150k,mobile,new,East,58,True,161,4,0,False,False,False,0,0,0,,161,4
user_009270,30,50k-75k,desktop,returning,East,98,True,66,4,0,True,True,True,37,3,0,7.793475664620425,29,1
user_009271,36,50k-75k,desktop,returning,South,77,True,30,2,0,False,True,True,20,5,0,9.698026839769666,10,-3
user_009272,77,50k-75k,desktop,new,Midwest,31,True,93,1,0,True,False,True,86,1,0,5.765140134085484,7,0
user_009273,73,30k-50k,desktop,returning,West,36,True,87,5,0,True,True,True,91,5,0,7.887726954401192,-4,0
user_009274,30,100k-150k,mobile,new,West,99,True,61,4,0,True,True,True,44,3,0,10.0,17,1
user_009275,59,50k-75k,desktop,returning,East,30,True,83,2,0,False,True,True,85,1,0,8.829562142850653,-2,1
user_009276,56,75k-100k,desktop,returning,East,19,True,117,6,2,False,True,True,106,6,0,6.115974114898907,11,0
user_009277,48,50k-75k,desktop,returning,South,50,False,0,0,0,True,False,True,109,1,0,5.782387785376795,-109,-1
user_009278,60,75k-100k,desktop,returning,South,36,True,94,2,0,False,False,True,99,1,0,6.820842571672237,-5,1
user_009279,18,50k-75k,desktop,returning,Midwest,53,True,129,2,0,False,True,True,124,2,0,8.593804962166008,5,0
user_009280,28,30k-50k,mobile,new,East,73,True,82,3,0,True,True,False,0,0,0,,82,3
user_009281,42,50k-75k,desktop,returning,West,36,True,71,2,0,True,True,True,59,1,1,8.493671796961598,12,1
user_009282,42,30k-50k,mobile,returning,South,39,True,101,4,1,True,True,True,53,4,0,7.101497805766202,48,0
user_009283,22,50k-75k,mobile,returning,East,60,True,134,1,0,False,True,True,102,1,0,8.037277514866274,32,0
user_009284,55,30k-50k,desktop,returning,South,70,True,63,1,1,False,True,True,50,1,1,9.314227943663491,13,0
user_009285,27,30k-50k,desktop,returning,West,77,True,52,3,0,True,True,True,20,2,0,8.592524417088967,32,1
user_009286,33,100k-150k,desktop,returning,West,87,True,76,5,0,False,True,True,69,4,1,8.153242353971653,7,1
user_009287,47,<30k,mobile,returning,South,48,True,76,1,0,True,True,False,0,0,0,,76,1
user_009288,63,30k-50k,mobile,returning,South,57,True,154,2,0,False,True,True,124,1,0,7.374494877548889,30,1
user_009289,45,<30k,mobile,returning,Midwest,44,True,91,8,0,True,True,True,44,11,0,8.826880999960697,47,-3
user_009290,34,75k-100k,mobile,returning,East,45,True,97,3,1,False,True,True,92,4,0,8.404944274670584,5,-1
user_009291,26,50k-75k,mobile,new,Midwest,57,True,113,1,2,True,True,True,89,1,0,8.94788935167507,24,0
user_009292,55,75k-100k,desktop,returning,Midwest,38,True,117,2,0,True,True,True,78,3,0,8.263304162001708,39,-1
user_009293,47,30k-50k,desktop,new,Midwest,63,False,0,0,0,True,True,True,120,1,0,9.57258225665814,-120,-1
user_009294,48,50k-75k,tablet,new,East,59,True,137,1,0,True,False,True,153,2,0,9.396348661324886,-16,-1
user_009295,31,50k-75k,desktop,new,West,61,True,123,1,0,True,False,True,137,1,0,7.431171845054145,-14,0
user_009296,37,50k-75k,mobile,returning,West,43,True,44,4,0,False,True,True,41,2,0,8.204609574177194,3,2
user_009297,48,50k-75k,mobile,returning,East,46,False,0,0,0,False,False,False,0,0,0,,0,0
user_009298,66,30k-50k,tablet,returning,Midwest,30,False,0,0,0,False,False,True,100,1,0,7.669564037065916,-100,-1
user_009299,37,100k-150k,desktop,new,West,67,True,150,4,0,False,True,True,80,1,0,6.729452073671347,70,3
user_009300,41,30k-50k,desktop,returning,Midwest,76,True,59,3,0,False,False,True,49,3,0,7.069250478750452,10,0
user_009301,42,75k-100k,mobile,returning,Midwest,45,True,40,1,1,True,True,True,42,1,1,6.772023488154178,-2,0
user_009302,37,100k-150k,mobile,new,South,59,False,0,0,0,False,True,True,115,2,0,7.165944486637113,-115,-2
user_009303,48,75k-100k,mobile,returning,South,32,False,0,0,0,True,False,True,99,2,0,7.346019592766087,-99,-2
user_009304,31,50k-75k,desktop,new,Midwest,58,True,152,1,0,False,False,True,129,1,0,7.057941730307729,23,0
user_009305,43,50k-75k,mobile,returning,South,24,True,145,6,1,False,True,True,152,2,0,8.056249627374457,-7,4
user_009306,58,50k-75k,mobile,new,South,8,True,175,3,0,False,False,True,167,7,0,7.648278518121926,8,-4
user_009307,43,<30k,desktop,new,West,56,True,75,3,0,False,True,True,53,1,1,8.452552550936783,22,2
user_009308,54,75k-100k,desktop,new,South,70,True,109,1,0,True,True,True,89,1,0,7.1888920114360975,20,0
user_009309,63,100k-150k,mobile,new,West,78,True,128,5,0,True,True,True,92,2,0,8.184196793800316,36,3
user_009310,25,100k-150k,mobile,new,South,90,True,94,3,0,False,True,True,92,7,0,7.112183451302089,2,-4
user_009311,49,75k-100k,desktop,returning,East,32,True,80,1,0,False,True,True,79,1,0,8.52303600015147,1,0
user_009312,48,75k-100k,desktop,returning,West,55,True,90,1,0,True,True,True,72,1,0,7.435788739913943,18,0
user_009313,30,50k-75k,desktop,new,West,45,True,93,5,0,False,True,True,90,7,0,7.580824674602856,3,-2
user_009314,48,100k-150k,mobile,returning,West,89,True,30,2,0,False,True,True,30,1,0,8.591708565559978,0,1
user_009315,70,50k-75k,desktop,new,West,24,True,135,6,1,True,False,False,0,0,0,,135,6
user_009316,51,<30k,mobile,new,Midwest,16,True,114,5,0,True,False,True,124,7,0,5.919602942710319,-10,-2
user_009317,22,50k-75k,desktop,new,East,58,True,118,4,0,False,True,True,97,5,0,9.045726107248951,21,-1
user_009318,52,75k-100k,desktop,new,Midwest,36,False,0,0,0,False,True,True,97,1,0,7.688950684734719,-97,-1
user_009319,61,30k-50k,mobile,returning,East,42,True,93,3,0,False,True,True,29,3,0,9.398335549143015,64,0
user_009320,53,75k-100k,desktop,returning,South,70,True,92,1,0,True,True,True,91,1,0,8.905072739698918,1,0
user_009321,56,30k-50k,mobile,returning,South,49,False,0,0,0,False,True,True,74,1,0,8.950463311986883,-74,-1
user_009322,63,>150k,tablet,returning,West,58,True,118,3,0,True,False,True,107,2,0,5.397429778011417,11,1
user_009323,45,50k-75k,mobile,returning,Midwest,52,True,92,2,0,False,True,True,91,1,0,6.847341607115989,1,1
user_009324,66,>150k,mobile,returning,East,61,True,84,3,0,True,True,True,54,1,0,7.431816792214421,30,2
user_009325,57,>150k,mobile,returning,South,50,True,110,1,0,False,False,True,109,1,0,6.228518483053074,1,0
user_009326,37,75k-100k,desktop,new,East,71,True,101,4,0,True,True,True,70,1,0,9.341056686710932,31,3
user_009327,72,50k-75k,tablet,returning,West,4,True,157,2,2,False,False,True,136,1,0,6.450761715548104,21,1
user_009328,48,>150k,desktop,returning,East,75,True,83,3,0,False,True,True,63,2,0,6.704969274305577,20,1
user_009329,32,50k-75k,desktop,new,South,88,True,147,4,0,True,True,True,142,1,0,8.639881538502712,5,3
user_009330,61,30k-50k,mobile,returning,East,31,True,30,3,0,False,False,True,29,3,0,4.652472100273088,1,0
user_009331,22,>150k,mobile,new,South,76,True,64,2,0,False,True,True,80,2,0,6.438218939819847,-16,0
user_009332,32,30k-50k,mobile,new,South,62,True,147,2,0,True,True,False,0,0,0,,147,2
user_009333,47,30k-50k,mobile,returning,Midwest,44,True,104,3,1,True,True,True,75,6,0,8.247908501800374,29,-3
user_009334,18,75k-100k,desktop,new,East,96,False,0,0,0,False,True,True,106,1,0,9.296779737590759,-106,-1
user_009335,48,30k-50k,tablet,returning,West,73,True,76,3,0,False,False,True,94,5,0,7.949333948122953,-18,-2
user_009336,44,<30k,mobile,new,West,30,True,89,3,0,False,False,False,0,0,0,,89,3
user_009337,27,50k-75k,mobile,returning,East,65,True,62,1,1,True,True,True,37,1,0,7.081840443781908,25,0
user_009338,22,75k-100k,mobile,returning,South,34,True,42,4,0,True,True,True,23,3,0,7.002733644078553,19,1
user_009339,66,<30k,desktop,returning,East,0,False,0,0,0,True,False,True,116,2,0,8.974378476266295,-116,-2
user_009340,27,<30k,tablet,returning,West,47,True,84,4,0,True,True,True,53,6,0,8.82630023362498,31,-2
user_009341,61,30k-50k,desktop,new,East,24,True,158,8,0,False,False,True,177,8,0,5.436177229390786,-19,0
user_009342,44,30k-50k,mobile,returning,East,63,False,0,0,0,True,True,True,102,1,0,7.590267041458965,-102,-1
user_009343,37,30k-50k,tablet,new,South,76,True,83,6,0,True,True,True,66,6,0,8.440350396043808,17,0
user_009344,25,50k-75k,desktop,returning,East,57,True,76,1,0,False,False,True,80,2,0,6.821947778065255,-4,-1
user_009345,25,50k-75k,mobile,new,East,67,False,0,0,0,False,True,True,74,2,0,5.45321327454086,-74,-2
user_009346,54,<30k,mobile,new,East,29,False,0,0,0,False,True,True,113,1,0,8.683409026755728,-113,-1
user_009347,25,30k-50k,mobile,returning,East,74,True,41,1,0,False,True,True,51,1,0,7.979933951466688,-10,0
user_009348,30,100k-150k,mobile,returning,Midwest,99,True,77,1,0,False,True,True,94,1,0,7.734021404288401,-17,0
user_009349,55,100k-150k,desktop,new,West,81,True,89,6,0,True,False,True,62,3,0,8.849218374345485,27,3
user_009350,37,75k-100k,mobile,new,Midwest,26,True,118,6,2,False,False,True,122,4,1,7.302028580272149,-4,2
user_009351,74,75k-100k,mobile,returning,East,28,True,101,2,1,False,False,True,106,2,2,6.1719512166520625,-5,0
user_009352,56,75k-100k,desktop,new,South,32,True,79,5,0,True,True,True,76,5,1,9.487279658106557,3,0
user_009353,41,>150k,desktop,returning,East,62,True,93,4,0,True,True,True,58,1,0,8.453959397204104,35,3
user_009354,52,50k-75k,desktop,returning,East,54,True,54,2,0,True,False,True,45,2,0,8.12840928979168,9,0
user_009355,56,50k-75k,mobile,returning,Midwest,48,True,87,2,1,False,False,True,92,1,0,6.297013374291621,-5,1
user_009356,49,<30k,mobile,new,East,56,True,57,3,0,False,True,True,50,3,0,8.589261536872803,7,0
user_009357,43,<30k,mobile,returning,East,33,False,0,0,0,False,True,True,110,1,0,9.428465515909448,-110,-1
user_009358,77,50k-75k,desktop,returning,East,28,True,114,2,1,False,False,True,127,3,1,6.5564719955333235,-13,-1
user_009359,52,30k-50k,mobile,new,West,43,True,130,2,0,False,True,True,140,1,0,8.533957013245562,-10,1
user_009360,21,30k-50k,mobile,returning,Midwest,88,True,31,4,1,True,True,False,0,0,0,,31,4
user_009361,32,>150k,mobile,returning,West,89,True,70,1,0,True,True,True,30,1,0,8.142572491780303,40,0
user_009362,42,75k-100k,mobile,returning,Midwest,48,True,95,1,2,True,True,True,75,1,0,8.393874260163614,20,0
user_009363,43,30k-50k,mobile,returning,West,74,True,124,4,2,True,True,True,106,3,0,6.5289031239849775,18,1
user_009364,53,50k-75k,tablet,returning,South,46,True,92,5,0,True,True,True,24,8,0,8.015429883042327,68,-3
user_009365,65,75k-100k,desktop,returning,South,42,True,96,2,0,True,True,True,84,3,0,7.877876522557522,12,-1
user_009366,59,50k-75k,desktop,new,Midwest,30,True,98,3,0,True,True,True,94,2,0,8.20520097188431,4,1
user_009367,28,75k-100k,desktop,new,South,73,True,114,4,0,True,True,True,98,4,0,8.573031285909208,16,0
user_009368,41,100k-150k,mobile,new,East,72,True,97,3,0,True,True,True,54,6,0,8.741916413863118,43,-3
user_009369,18,<30k,desktop,returning,Midwest,68,True,120,3,0,False,False,True,106,3,0,8.127577035471688,14,0
user_009370,42,<30k,desktop,new,South,32,True,130,4,1,True,True,True,98,7,0,7.968043757061421,32,-3
user_009371,48,50k-75k,desktop,returning,South,41,True,81,1,0,True,True,True,46,2,1,6.95270936135744,35,-1
user_009372,59,50k-75k,desktop,returning,South,35,False,0,0,0,False,False,True,105,1,0,8.255416996479822,-105,-1
user_009373,39,30k-50k,desktop,returning,Midwest,50,True,123,3,0,True,True,True,117,1,0,10.0,6,2
user_009374,53,50k-75k,desktop,returning,Midwest,69,True,112,1,0,True,True,True,32,1,0,8.524898139114622,80,0
user_009375,46,50k-75k,mobile,returning,Midwest,71,True,32,1,1,True,True,True,20,3,0,8.86339610787522,12,-2
user_009376,39,75k-100k,desktop,new,South,54,True,103,3,0,True,True,True,68,1,0,9.212542768593964,35,2
user_009377,37,75k-100k,desktop,new,East,43,True,140,4,0,False,False,True,143,3,0,6.999319855055456,-3,1
user_009378,50,30k-50k,mobile,returning,Midwest,35,True,106,2,0,False,False,True,91,1,0,8.450708429744909,15,1
user_009379,67,30k-50k,desktop,new,Midwest,9,True,168,2,0,True,False,True,182,1,0,9.168845943962094,-14,1
user_009380,24,50k-75k,mobile,returning,Midwest,60,True,67,4,0,True,True,True,34,1,1,7.30316164722937,33,3
user_009381,42,75k-100k,mobile,returning,West,61,True,105,2,0,True,True,False,0,0,0,,105,2
user_009382,42,100k-150k,desktop,returning,South,45,True,100,3,0,True,False,True,109,1,0,8.153010169076731,-9,2
user_009383,29,<30k,desktop,returning,South,91,False,0,0,0,True,True,True,118,1,1,9.11061973974825,-118,-1
user_009384,39,50k-75k,desktop,returning,South,32,True,84,5,0,True,True,True,45,6,0,8.23543555610083,39,-1
user_009385,47,75k-100k,desktop,returning,South,13,True,138,5,0,True,False,True,118,8,0,8.420088574305858,20,-3
user_009386,35,>150k,desktop,returning,West,54,True,71,3,0,False,True,True,56,1,0,8.786551207290808,15,2
user_009387,35,50k-75k,desktop,returning,West,53,False,0,0,0,True,True,True,122,1,0,7.084461161962317,-122,-1
user_009388,50,75k-100k,tablet,returning,Midwest,58,True,67,1,0,True,True,True,68,1,0,7.123994215244804,-1,0
user_009389,24,30k-50k,desktop,new,East,78,False,0,0,0,False,False,True,107,2,0,6.824938101700628,-107,-2
user_009390,25,>150k,mobile,returning,East,80,True,30,1,1,True,True,True,20,1,0,9.013648040098957,10,0
user_009391,42,75k-100k,mobile,new,Midwest,64,True,112,2,0,True,False,True,113,1,0,7.35763919086474,-1,1
user_009392,47,50k-75k,desktop,returning,Midwest,43,True,103,1,0,True,False,True,125,1,0,7.3528479095833,-22,0
user_009393,51,30k-50k,mobile,new,South,51,True,126,4,0,False,True,True,124,5,0,10.0,2,-1
user_009394,80,<30k,desktop,new,South,37,True,94,6,0,True,True,True,31,2,0,10.0,63,4
user_009395,38,50k-75k,desktop,returning,Midwest,77,True,101,1,1,False,True,False,0,0,0,,101,1
user_009396,30,75k-100k,desktop,new,West,100,True,101,3,0,True,True,True,94,4,0,9.643764198195882,7,-1
user_009397,53,30k-50k,mobile,returning,East,50,False,0,0,0,False,True,True,121,1,1,8.183523893367813,-121,-1
user_009398,19,75k-100k,desktop,new,East,67,False,0,0,0,True,False,True,120,1,0,7.044471623138696,-120,-1
user_009399,60,50k-75k,mobile,new,East,20,True,93,5,0,False,False,False,0,0,0,,93,5
user_009400,31,50k-75k,mobile,returning,West,86,True,52,5,1,True,True,True,54,7,0,8.583810692343226,-2,-2
user_009401,27,30k-50k,mobile,returning,South,50,True,115,3,0,True,True,True,90,1,0,9.7009513964969,25,2
user_009402,31,30k-50k,mobile,new,West,89,False,0,0,0,True,True,True,100,1,0,5.863729556650996,-100,-1
user_009403,41,<30k,desktop,returning,East,30,True,121,2,0,True,True,True,102,1,0,6.851328098297312,19,1
user_009404,56,30k-50k,desktop,returning,South,0,True,112,3,0,True,False,True,116,1,0,5.055558909651117,-4,2
user_009405,65,30k-50k,desktop,new,Midwest,2,True,144,3,0,False,True,True,79,3,1,6.816611769571361,65,0
user_009406,19,50k-75k,desktop,new,East,61,True,151,2,1,True,False,True,163,1,0,6.265164818529453,-12,1
user_009407,53,50k-75k,tablet,returning,East,28,True,165,5,0,True,False,True,200,6,0,7.312930652098564,-35,-1
user_009408,39,100k-150k,desktop,returning,Midwest,54,True,93,2,1,False,True,True,62,1,0,8.803055193083209,31,1
user_009409,80,100k-150k,mobile,returning,East,33,True,90,7,0,True,True,True,77,4,0,6.62335630213789,13,3
user_009410,50,75k-100k,desktop,returning,Midwest,12,True,116,6,0,False,False,True,125,6,0,9.910179097292135,-9,0
user_009411,33,<30k,mobile,returning,East,57,False,0,0,0,True,True,True,117,1,0,7.47586447399955,-117,-1
user_009412,20,30k-50k,desktop,new,West,48,True,100,1,1,True,True,False,0,0,0,,100,1
user_009413,40,100k-150k,mobile,returning,East,50,True,83,4,0,False,False,True,78,11,0,8.946171983950093,5,-7
user_009414,41,50k-75k,mobile,returning,South,40,False,0,0,0,False,True,True,126,1,0,8.841052379070575,-126,-1
user_009415,53,50k-75k,mobile,returning,South,34,False,0,0,0,True,True,True,86,1,0,6.395266164787185,-86,-1
user_009416,78,75k-100k,desktop,new,West,57,True,92,2,0,False,True,True,33,4,0,7.940668194127374,59,-2
user_009417,28,>150k,desktop,returning,South,73,True,30,2,1,False,True,True,51,1,0,6.3368273458478726,-21,1
user_009418,25,75k-100k,mobile,returning,East,91,True,45,2,0,False,True,True,27,2,0,7.239669604042584,18,0
user_009419,23,50k-75k,desktop,new,West,76,False,0,0,0,True,True,True,104,3,0,8.563720584018418,-104,-3
user_009420,33,30k-50k,desktop,returning,East,59,True,115,3,0,True,True,True,103,4,0,7.728570141831684,12,-1
user_009421,59,50k-75k,desktop,new,East,48,True,119,4,1,True,True,True,95,1,0,7.793453294421658,24,3
user_009422,39,30k-50k,mobile,returning,Midwest,28,True,89,6,1,False,False,True,120,6,0,7.336066811577721,-31,0
user_009423,50,>150k,desktop,returning,West,92,True,113,3,2,True,True,True,95,2,0,7.762869561894984,18,1
user_009424,43,30k-50k,mobile,new,South,70,True,120,4,0,False,True,True,94,2,0,5.4143078928329915,26,2
user_009425,41,50k-75k,desktop,new,East,46,True,72,1,0,True,False,True,77,1,0,6.803061089125469,-5,0
user_009426,57,>150k,mobile,returning,South,7,True,105,6,2,False,False,True,91,6,0,5.240859826000391,14,0
user_009427,43,30k-50k,mobile,returning,East,42,True,77,4,0,True,False,True,83,1,0,6.897424388571109,-6,3
user_009428,60,100k-150k,mobile,new,West,69,True,73,3,0,True,True,True,59,2,0,8.831933498749885,14,1
user_009429,34,<30k,desktop,returning,East,39,True,131,5,0,True,True,True,127,7,0,8.3340998508682,4,-2
user_009430,35,100k-150k,desktop,returning,Midwest,80,True,35,3,0,True,True,True,49,3,0,6.719701518807473,-14,0
user_009431,72,100k-150k,mobile,new,South,74,True,101,6,1,True,True,True,63,6,0,8.712135141611771,38,0
user_009432,45,50k-75k,mobile,new,Midwest,20,True,158,2,0,True,False,True,152,2,1,6.91543619664918,6,0
user_009433,36,50k-75k,desktop,new,East,57,True,105,6,0,False,False,True,97,6,0,5.808913802453634,8,0
user_009434,61,100k-150k,desktop,returning,West,76,True,62,1,0,True,True,False,0,0,0,,62,1
user_009435,62,75k-100k,mobile,new,East,17,True,161,7,1,False,False,True,145,13,0,6.799574994600744,16,-6
user_009436,40,<30k,desktop,returning,West,47,False,0,0,0,True,True,True,156,2,0,8.060166442427647,-156,-2
user_009437,60,50k-75k,desktop,returning,South,18,False,0,0,0,False,False,True,121,1,0,6.750124045922693,-121,-1
user_009438,23,75k-100k,mobile,returning,South,37,False,0,0,0,False,False,True,149,1,0,6.183270613705817,-149,-1
user_009439,39,100k-150k,desktop,returning,West,71,True,75,4,0,True,True,True,75,1,1,8.876211762625532,0,3
user_009440,36,50k-75k,desktop,returning,East,47,True,87,3,0,True,True,True,70,1,0,6.822704714155819,17,2
user_009441,50,75k-100k,desktop,returning,East,48,True,69,1,0,True,True,True,85,1,0,8.163508503322184,-16,0
user_009442,23,<30k,mobile,returning,East,63,False,0,0,0,False,True,True,83,1,0,9.406910596083469,-83,-1
user_009443,40,100k-150k,desktop,new,East,78,True,120,4,0,False,True,True,91,3,0,6.8691450984007325,29,1
user_009444,25,50k-75k,mobile,new,East,83,False,0,0,0,True,True,True,118,1,0,6.681840243204407,-118,-1
user_009445,44,>150k,mobile,returning,East,44,True,117,4,0,False,False,True,102,3,0,6.764006857696757,15,1
user_009446,25,30k-50k,desktop,returning,East,63,True,142,3,0,False,True,True,140,2,0,8.616103637076696,2,1
user_009447,40,30k-50k,mobile,new,East,59,True,126,1,0,False,False,True,122,1,0,6.509874152622985,4,0
user_009448,54,30k-50k,mobile,returning,South,33,True,105,5,0,False,False,False,0,0,0,,105,5
user_009449,72,75k-100k,tablet,returning,West,38,True,33,1,1,True,False,False,0,0,0,,33,1
user_009450,27,>150k,mobile,returning,East,50,True,125,2,0,True,True,True,83,2,1,8.111630231569128,42,0
user_009451,59,50k-75k,tablet,returning,Midwest,26,False,0,0,0,False,False,True,99,2,0,6.325807606675489,-99,-2
user_009452,33,<30k,mobile,returning,Midwest,40,False,0,0,0,False,False,True,100,1,0,6.957972767455912,-100,-1
user_009453,52,50k-75k,desktop,returning,South,50,True,137,2,1,True,True,True,102,1,0,7.099822295384578,35,1
user_009454,50,30k-50k,mobile,returning,West,59,True,79,1,0,False,True,True,48,1,0,8.866737323359434,31,0
user_009455,47,>150k,desktop,returning,South,69,True,90,3,0,False,False,True,76,1,0,5.414453178992518,14,2
user_009456,54,75k-100k,desktop,returning,South,51,True,79,3,1,False,True,True,84,3,0,6.454750305226353,-5,0
user_009457,61,<30k,desktop,new,East,30,True,73,5,0,True,True,True,36,4,0,7.653670120493466,37,1
user_009458,42,<30k,mobile,returning,South,28,True,142,3,0,True,True,True,143,2,2,7.69620408412828,-1,1
user_009459,50,<30k,desktop,returning,Midwest,63,True,111,2,0,True,True,True,97,1,0,7.741890079700274,14,1
user_009460,32,30k-50k,desktop,returning,South,58,True,71,1,0,False,True,False,0,0,0,,71,1
user_009461,38,>150k,mobile,new,South,61,True,108,3,0,True,True,True,121,3,0,10.0,-13,0
user_009462,53,100k-150k,mobile,returning,Midwest,49,True,82,2,0,False,False,True,60,3,0,7.175709725294627,22,-1
user_009463,80,50k-75k,desktop,returning,East,41,True,126,3,0,True,False,True,127,4,1,7.455300062681901,-1,-1
user_009464,53,30k-50k,mobile,returning,East,28,True,117,4,0,False,False,True,119,2,0,5.966263660097651,-2,2
user_009465,33,30k-50k,desktop,returning,West,99,True,115,3,0,False,True,False,0,0,0,,115,3
user_009466,78,>150k,tablet,returning,East,38,True,151,4,1,True,True,True,126,5,0,5.008124469608264,25,-1
user_009467,35,<30k,mobile,returning,Midwest,30,True,106,6,0,False,True,True,86,8,0,6.850585347354271,20,-2
user_009468,25,75k-100k,mobile,returning,Midwest,67,True,85,4,1,True,True,True,94,1,0,9.00306930473177,-9,3
user_009469,37,75k-100k,mobile,returning,West,33,True,100,1,0,False,False,True,123,1,0,9.412734864882532,-23,0
user_009470,56,75k-100k,desktop,new,East,23,False,0,0,0,False,False,True,114,1,0,7.420722035495744,-114,-1
user_009471,39,30k-50k,desktop,returning,South,52,True,112,3,0,True,True,True,96,3,0,8.11449537313741,16,0
user_009472,52,50k-75k,mobile,new,West,92,True,104,2,0,False,True,True,99,1,0,9.134332578497773,5,1
user_009473,32,100k-150k,desktop,returning,East,83,True,107,2,1,True,True,True,60,2,1,8.297584511783015,47,0
user_009474,57,30k-50k,desktop,new,South,46,False,0,0,0,True,False,True,126,4,0,9.302544366898836,-126,-4
user_009475,80,100k-150k,desktop,returning,West,66,False,0,0,0,True,True,True,87,1,2,8.629649707401434,-87,-1
user_009476,42,>150k,desktop,returning,East,51,True,66,1,1,False,True,True,28,1,0,7.5715189110683685,38,0
user_009477,48,<30k,mobile,new,Midwest,39,True,121,5,0,False,True,True,108,4,0,8.558741025230102,13,1
user_009478,59,30k-50k,mobile,returning,East,4,False,0,0,0,False,True,True,65,1,0,8.664921128760366,-65,-1
user_009479,29,<30k,mobile,returning,East,68,True,69,4,1,True,True,True,70,1,0,7.987210604168431,-1,3
user_009480,42,30k-50k,mobile,new,West,48,True,58,4,0,True,False,True,66,7,0,7.176081529008257,-8,-3
user_009481,31,75k-100k,mobile,new,Midwest,88,True,80,3,0,False,True,True,63,1,0,7.794754113845021,17,2
user_009482,58,30k-50k,desktop,new,Midwest,45,False,0,0,0,False,False,True,126,2,1,4.9486819850922235,-126,-2
user_009483,58,30k-50k,desktop,returning,East,19,False,0,0,0,False,True,True,127,1,0,9.028154636098357,-127,-1
user_009484,36,75k-100k,desktop,returning,West,59,True,110,4,0,True,False,True,98,5,0,6.783166612478149,12,-1
user_009485,21,<30k,mobile,returning,Midwest,54,True,65,4,0,True,True,True,59,1,0,7.972546175953077,6,3
user_009486,30,<30k,mobile,returning,Midwest,61,True,79,4,0,True,True,True,82,2,0,6.742750957874382,-3,2
user_009487,73,100k-150k,mobile,returning,West,20,True,117,5,0,True,False,True,113,8,0,6.347834188389331,4,-3
user_009488,39,75k-100k,desktop,returning,East,39,True,120,5,0,False,False,True,103,7,0,8.33142199640592,17,-2
user_009489,64,30k-50k,mobile,returning,Midwest,44,True,86,1,0,False,True,True,77,1,0,8.149296832372059,9,0
user_009490,47,50k-75k,desktop,new,South,66,False,0,0,0,False,True,True,76,1,0,8.299681672280864,-76,-1
user_009491,44,30k-50k,desktop,new,East,65,True,108,4,1,False,False,True,97,2,0,6.3060539458656715,11,2
user_009492,18,50k-75k,desktop,new,West,85,True,99,4,0,True,True,True,71,2,0,8.631229310521713,28,2
user_009493,52,100k-150k,tablet,new,Midwest,66,True,102,3,0,False,False,True,125,3,0,7.239054665576822,-23,0
user_009494,45,50k-75k,mobile,returning,South,47,True,84,6,0,False,False,True,73,5,0,8.820793267130602,11,1
user_009495,59,30k-50k,mobile,returning,East,53,True,149,5,0,True,True,True,112,6,0,8.704368698344634,37,-1
user_009496,34,100k-150k,mobile,returning,South,82,True,84,8,0,True,False,True,93,5,0,8.058055714611736,-9,3
user_009497,48,30k-50k,mobile,returning,West,57,True,83,3,1,True,False,True,37,1,0,8.336225229047068,46,2
user_009498,42,100k-150k,mobile,new,East,31,True,147,4,0,False,False,True,126,4,0,6.372943032621416,21,0
user_009499,63,<30k,mobile,returning,West,43,False,0,0,0,False,False,True,121,3,0,5.6707240309369835,-121,-3
user_009500,28,<30k,desktop,returning,East,49,True,96,4,1,False,True,False,0,0,0,,96,4
user_009501,74,>150k,mobile,returning,South,55,True,96,1,0,False,False,True,83,1,0,4.485558463457412,13,0
user_009502,55,30k-50k,desktop,new,Midwest,39,True,87,3,0,False,False,True,38,4,0,7.168094516273131,49,-1
user_009503,40,<30k,desktop,returning,East,26,True,110,2,1,True,False,True,101,2,1,7.15908465732524,9,0
user_009504,35,50k-75k,desktop,new,South,48,True,134,1,1,False,False,True,135,1,0,7.657156756214391,-1,0
user_009505,35,50k-75k,desktop,returning,East,28,True,139,2,0,False,False,True,107,1,1,8.53626215099913,32,1
user_009506,46,75k-100k,mobile,new,South,41,True,119,4,0,False,True,True,133,6,0,8.751967338660666,-14,-2
user_009507,42,30k-50k,desktop,returning,South,32,True,110,2,0,False,True,True,111,2,0,8.15844264128664,-1,0
user_009508,44,50k-75k,desktop,new,West,38,True,119,4,0,False,False,True,128,7,0,6.725619078804119,-9,-3
user_009509,30,75k-100k,desktop,new,South,90,True,84,3,0,True,True,True,91,4,0,6.567064347797163,-7,-1
user_009510,57,50k-75k,desktop,new,South,48,True,139,5,0,False,False,True,159,3,0,8.296635510895623,-20,2
user_009511,40,<30k,desktop,new,Midwest,42,False,0,0,0,False,True,False,0,0,0,,0,0
user_009512,18,100k-150k,desktop,returning,South,97,True,30,2,0,False,True,True,20,1,0,7.589679146609096,10,1
user_009513,37,75k-100k,desktop,new,West,32,True,123,6,0,False,True,True,127,4,0,5.689879171133216,-4,2
user_009514,35,100k-150k,mobile,returning,East,63,True,109,4,0,True,True,True,87,3,0,6.97791548760919,22,1
user_009515,26,50k-75k,desktop,returning,West,85,True,30,4,1,True,True,True,36,3,0,8.257128866821345,-6,1
user_009516,24,75k-100k,mobile,returning,South,64,True,86,2,1,True,True,True,112,2,1,6.978335421623729,-26,0
user_009517,59,100k-150k,mobile,returning,East,29,True,164,5,0,False,True,True,143,1,0,8.7893595352644,21,4
user_009518,60,30k-50k,desktop,returning,West,34,False,0,0,0,True,False,True,118,1,0,5.591647895136131,-118,-1
user_009519,37,100k-150k,desktop,new,East,78,True,163,2,0,False,True,True,129,3,0,8.983054530275902,34,-1
user_009520,53,50k-75k,desktop,returning,Midwest,54,True,115,6,0,False,True,True,86,6,0,5.523311063612191,29,0
user_009521,35,50k-75k,desktop,new,Midwest,40,True,146,3,0,False,True,False,0,0,0,,146,3
user_009522,54,30k-50k,desktop,new,Midwest,53,True,165,2,0,False,False,True,115,2,0,7.371333539363256,50,0
user_009523,30,100k-150k,desktop,new,West,95,True,44,4,0,True,True,True,34,4,0,8.840271852726705,10,0
user_009524,42,100k-150k,mobile,returning,Midwest,66,True,62,5,0,False,True,True,20,5,0,8.392824286735634,42,0
user_009525,18,50k-75k,desktop,returning,South,74,True,76,2,0,True,True,True,20,1,1,8.503113944767337,56,1
user_009526,68,30k-50k,mobile,new,Midwest,32,True,150,5,0,False,False,False,0,0,0,,150,5
user_009527,18,<30k,mobile,new,East,36,True,174,7,0,True,False,True,197,3,0,6.104548671685878,-23,4
user_009528,78,30k-50k,desktop,returning,West,61,True,80,1,0,True,True,True,99,1,0,8.017212001756123,-19,0
user_009529,33,<30k,mobile,new,West,56,True,64,3,0,False,True,True,30,1,0,6.661889036229766,34,2
user_009530,79,30k-50k,desktop,new,East,46,True,169,2,0,True,True,True,130,2,0,3.257907841893008,39,0
user_009531,27,75k-100k,mobile,returning,West,77,True,98,7,0,False,True,True,84,4,0,8.11004744722924,14,3
user_009532,18,75k-100k,mobile,returning,West,74,True,34,4,0,True,True,True,40,5,0,7.396324399036967,-6,-1
user_009533,34,100k-150k,mobile,returning,Midwest,57,True,75,3,0,False,True,True,63,2,0,8.557272082912602,12,1
user_009534,49,50k-75k,mobile,returning,West,65,False,0,0,0,True,True,True,124,1,0,8.638655420677392,-124,-1
user_009535,48,<30k,desktop,returning,Midwest,14,True,135,8,0,True,False,True,124,11,0,6.209342760499025,11,-3
user_009536,32,30k-50k,tablet,returning,South,68,True,78,3,0,False,False,True,76,4,0,7.309990085712652,2,-1
user_009537,50,50k-75k,desktop,returning,East,64,True,150,2,0,False,False,False,0,0,0,,150,2
user_009538,64,<30k,desktop,returning,Midwest,0,True,100,3,0,False,False,True,95,4,0,7.6589181643320945,5,-1
user_009539,29,30k-50k,desktop,returning,West,71,True,79,3,0,True,True,True,88,1,1,6.359228940597843,-9,2
user_009540,33,50k-75k,mobile,returning,Midwest,84,True,69,1,0,True,False,True,65,1,0,5.153261907434763,4,0
user_009541,18,<30k,mobile,returning,Midwest,59,True,91,4,0,True,True,True,79,1,0,7.906640262357912,12,3
user_009542,54,<30k,desktop,new,West,24,False,0,0,0,False,False,False,0,0,0,,0,0
user_009543,53,>150k,mobile,returning,Midwest,73,True,64,3,0,True,True,True,57,4,0,7.408704824491987,7,-1
user_009544,46,100k-150k,desktop,returning,Midwest,73,True,48,3,0,True,True,True,28,5,1,7.375553981764445,20,-2
user_009545,51,75k-100k,mobile,returning,Midwest,68,True,112,3,1,True,True,False,0,0,0,,112,3
user_009546,44,30k-50k,desktop,new,West,58,True,99,3,0,False,True,True,119,4,0,7.961205522305754,-20,-1
user_009547,67,75k-100k,mobile,returning,West,48,True,120,1,0,True,True,True,108,1,0,8.308994607447746,12,0
user_009548,46,<30k,mobile,returning,East,56,True,37,6,0,False,True,True,20,4,0,9.779794996438998,17,2
user_009549,34,75k-100k,desktop,returning,South,77,True,65,1,0,True,False,True,51,2,0,8.393868681089348,14,-1
user_009550,34,>150k,desktop,new,South,90,True,95,4,0,True,True,True,66,2,0,9.664635341736878,29,2
user_009551,49,75k-100k,tablet,returning,South,37,False,0,0,0,True,False,True,138,1,0,9.40321309939527,-138,-1
user_009552,56,30k-50k,mobile,returning,South,31,True,94,3,0,False,True,True,117,4,0,7.147301529291195,-23,-1
user_009553,36,75k-100k,mobile,returning,West,66,True,58,1,0,True,True,True,23,1,0,6.751101984454134,35,0
user_009554,44,>150k,mobile,returning,East,50,True,67,6,1,False,True,True,88,4,0,5.5270415549468055,-21,2
user_009555,44,<30k,desktop,returning,South,26,True,184,5,1,False,False,True,200,9,1,3.80807523435161,-16,-4
user_009556,80,75k-100k,desktop,returning,South,27,True,111,4,0,False,False,True,108,2,1,5.6754261599734965,3,2
user_009557,32,30k-50k,mobile,returning,Midwest,60,True,62,4,0,True,True,True,34,7,1,9.790418840199187,28,-3
user_009558,62,30k-50k,mobile,returning,East,6,True,86,3,0,True,False,True,40,3,0,6.130627516532137,46,0
user_009559,43,50k-75k,desktop,returning,East,69,True,142,2,0,True,True,True,112,1,0,9.423528622139328,30,1
user_009560,64,50k-75k,tablet,new,Midwest,28,False,0,0,0,False,False,False,0,0,0,,0,0
user_009561,39,50k-75k,mobile,new,South,48,True,107,4,0,False,True,True,40,2,0,5.469279072691278,67,2
user_009562,63,75k-100k,mobile,new,Midwest,28,True,226,3,1,True,False,True,278,4,0,7.486425081060162,-52,-1
user_009563,46,75k-100k,tablet,returning,East,51,True,108,2,0,True,True,True,110,1,0,7.8281506349124514,-2,1
user_009564,18,>150k,mobile,returning,West,100,True,63,3,0,False,False,True,94,4,0,7.006251720149951,-31,-1
user_009565,45,100k-150k,mobile,returning,Midwest,55,True,97,4,0,True,True,True,61,5,0,7.460475083596679,36,-1
user_009566,48,50k-75k,desktop,new,West,57,True,113,2,0,True,False,True,119,1,0,6.676966295553743,-6,1
user_009567,42,50k-75k,mobile,returning,Midwest,43,False,0,0,0,False,True,True,67,1,0,9.446282731077385,-67,-1
user_009568,48,50k-75k,desktop,returning,West,67,True,141,3,0,False,True,True,83,1,0,8.06605940289529,58,2
user_009569,46,50k-75k,mobile,returning,West,58,True,43,7,0,False,True,True,38,2,0,7.327069208363563,5,5
user_009570,32,30k-50k,desktop,new,West,100,True,98,1,0,True,True,True,86,2,0,8.16702839504037,12,-1
user_009571,46,50k-75k,mobile,returning,South,65,True,134,4,0,True,False,True,125,7,0,8.107476789598387,9,-3
user_009572,46,100k-150k,mobile,new,Midwest,45,True,75,3,1,True,True,True,61,4,0,9.1670246135435,14,-1
user_009573,80,75k-100k,mobile,new,South,37,False,0,0,0,False,False,True,145,2,0,5.99584080281595,-145,-2
user_009574,60,75k-100k,desktop,returning,South,53,True,82,1,0,False,True,True,59,1,0,8.765605080652088,23,0
user_009575,31,100k-150k,mobile,new,South,100,True,77,3,0,True,True,True,60,2,0,8.293896275548214,17,1
user_009576,54,100k-150k,desktop,new,West,84,True,32,3,0,False,True,True,20,3,0,8.530368349878037,12,0
user_009577,45,30k-50k,desktop,returning,East,55,True,84,2,0,True,True,True,48,3,0,5.839536683251364,36,-1
user_009578,37,<30k,mobile,new,South,10,True,194,4,0,False,False,True,254,1,0,8.106567326086882,-60,3
user_009579,65,75k-100k,mobile,returning,West,33,True,69,3,0,True,False,True,84,2,0,7.394581506127588,-15,1
user_009580,20,100k-150k,mobile,returning,South,98,True,69,3,0,False,True,True,63,4,0,8.282982294082036,6,-1
user_009581,58,75k-100k,desktop,new,West,27,True,167,3,0,False,False,True,159,3,0,8.812862326099326,8,0
user_009582,54,100k-150k,desktop,new,South,71,True,70,2,1,True,True,True,65,1,0,6.240185715417108,5,1
user_009583,50,75k-100k,desktop,returning,South,35,True,134,3,0,True,True,True,135,2,0,10.0,-1,1
user_009584,28,100k-150k,mobile,new,South,54,True,117,6,0,False,True,True,93,5,0,8.843467468769074,24,1
user_009585,38,50k-75k,mobile,returning,South,40,True,77,2,0,True,True,True,47,3,0,7.2457188617233275,30,-1
user_009586,46,50k-75k,mobile,new,South,46,True,118,1,0,False,False,True,130,1,0,7.260229586792137,-12,0
user_009587,58,100k-150k,desktop,returning,South,66,True,119,2,0,True,True,True,97,1,0,8.041020419269643,22,1
user_009588,35,75k-100k,mobile,returning,West,63,True,98,2,0,True,True,True,84,1,0,8.721494088199139,14,1
user_009589,30,100k-150k,tablet,returning,South,73,True,30,3,0,False,True,True,20,3,0,8.022496937410114,10,0
user_009590,34,30k-50k,mobile,returning,South,50,True,50,1,0,True,True,True,97,1,0,6.367557112809765,-47,0
user_009591,76,30k-50k,mobile,returning,South,29,True,142,1,0,True,False,True,143,2,0,6.260775321172975,-1,-1
user_009592,19,100k-150k,mobile,returning,West,97,True,55,3,0,False,False,True,38,1,0,6.37232931402901,17,2
user_009593,48,50k-75k,mobile,returning,East,51,True,117,1,1,True,True,True,58,3,0,6.66313848729475,59,-2
user_009594,42,50k-75k,mobile,returning,South,54,False,0,0,0,True,True,True,70,1,0,8.406730710406277,-70,-1
user_009595,37,75k-100k,mobile,returning,South,40,True,93,2,1,True,False,True,142,7,0,7.8539551846555185,-49,-5
user_009596,54,30k-50k,desktop,new,Midwest,41,True,133,2,0,False,False,True,95,2,0,6.985405251196215,38,0
user_009597,68,50k-75k,desktop,new,West,44,True,92,2,1,True,False,True,112,2,0,7.782673137843513,-20,0
user_009598,37,>150k,mobile,returning,East,80,True,105,6,0,False,True,True,141,5,0,5.528020073255229,-36,1
user_009599,59,<30k,desktop,returning,West,44,True,59,2,0,False,False,True,87,2,0,7.8894709528971925,-28,0
user_009600,54,<30k,desktop,returning,South,63,True,105,2,0,True,True,True,106,3,0,7.53995515146103,-1,-1
user_009601,38,<30k,desktop,returning,Midwest,61,True,135,3,1,False,False,False,0,0,0,,135,3
user_009602,26,30k-50k,desktop,returning,West,87,True,90,1,0,False,True,True,78,1,0,7.110164674631216,12,0
user_009603,62,100k-150k,mobile,returning,Midwest,61,True,72,3,0,True,True,True,33,2,0,7.974590595710904,39,1
user_009604,28,30k-50k,mobile,returning,Midwest,69,True,90,5,0,True,True,True,42,5,0,8.401026494315717,48,0
user_009605,36,<30k,mobile,returning,East,37,True,62,6,0,True,False,False,0,0,0,,62,6
user_009606,51,75k-100k,desktop,returning,Midwest,66,True,110,4,0,False,True,True,112,1,0,7.670044923437837,-2,3
user_009607,52,50k-75k,mobile,new,East,53,True,119,2,0,True,False,True,89,5,0,6.113756490975564,30,-3
user_009608,49,30k-50k,desktop,returning,Midwest,41,True,145,2,1,True,True,True,136,2,0,6.095673143684751,9,0
user_009609,18,<30k,desktop,returning,Midwest,50,False,0,0,0,False,True,True,112,1,0,8.500927053501997,-112,-1
user_009610,53,75k-100k,desktop,returning,Midwest,46,True,108,2,0,False,False,False,0,0,0,,108,2
user_009611,35,100k-150k,desktop,returning,Midwest,73,False,0,0,0,False,True,True,92,2,1,10.0,-92,-2
user_009612,31,75k-100k,mobile,returning,South,58,True,36,1,0,True,True,True,20,1,0,7.764786596688266,16,0
user_009613,53,<30k,mobile,new,East,45,True,110,3,0,False,False,True,130,1,0,8.329624613331127,-20,2
user_009614,52,<30k,desktop,new,East,19,True,155,3,0,True,False,True,180,2,0,7.543404569931006,-25,1
user_009615,71,30k-50k,mobile,new,Midwest,37,True,85,1,0,False,False,True,67,1,1,6.5958131223138565,18,0
user_009616,71,<30k,desktop,returning,West,41,False,0,0,0,True,False,True,113,2,0,8.201094218718076,-113,-2
user_009617,46,>150k,desktop,returning,South,63,True,118,3,0,True,True,True,69,3,0,9.411225436574343,49,0
user_009618,56,30k-50k,mobile,returning,East,16,False,0,0,0,True,False,True,123,2,1,7.083586433315098,-123,-2
user_009619,41,100k-150k,mobile,returning,Midwest,72,True,71,5,0,True,True,True,39,2,0,7.050263086602441,32,3
user_009620,62,30k-50k,desktop,returning,South,8,False,0,0,0,True,False,True,114,3,1,8.705831993357704,-114,-3
user_009621,33,75k-100k,desktop,returning,South,76,False,0,0,0,True,True,True,87,1,0,7.960993127416496,-87,-1
user_009622,35,50k-75k,desktop,new,South,40,True,155,6,0,False,True,True,132,7,0,8.478073509884107,23,-1
user_009623,49,<30k,desktop,new,East,18,False,0,0,0,False,False,True,132,1,1,7.812740264138254,-132,-1
user_009624,29,50k-75k,mobile,new,South,62,True,136,1,0,False,True,True,105,1,0,9.69288985507263,31,0
user_009625,23,<30k,mobile,new,Midwest,45,True,103,9,0,False,False,True,119,8,0,8.372680905469995,-16,1
user_009626,53,50k-75k,desktop,new,East,71,True,96,3,0,True,False,True,110,3,0,7.87167603914504,-14,0
user_009627,49,50k-75k,desktop,returning,Midwest,11,True,113,3,0,True,False,True,111,3,0,8.59689498517882,2,0
user_009628,50,30k-50k,tablet,new,West,57,True,110,3,0,True,True,True,119,3,1,10.0,-9,0
user_009629,64,75k-100k,desktop,returning,South,0,True,96,8,0,False,False,True,92,5,0,6.850519253750009,4,3
user_009630,41,100k-150k,mobile,returning,South,61,True,87,2,0,True,True,True,37,1,0,8.267974175762745,50,1
user_009631,54,<30k,desktop,new,South,11,True,179,2,0,False,False,True,163,1,1,7.307506450996224,16,1
user_009632,30,50k-75k,mobile,new,West,100,True,106,4,0,False,True,True,91,7,0,7.186176519460018,15,-3
user_009633,80,50k-75k,mobile,new,East,29,True,135,4,0,False,False,True,171,5,0,4.790255769921311,-36,-1
user_009634,28,30k-50k,mobile,returning,South,44,True,138,2,0,False,True,True,114,3,0,8.059958132662047,24,-1
user_009635,19,100k-150k,tablet,new,South,77,True,70,2,0,False,True,True,55,2,0,8.964233670432737,15,0
user_009636,48,75k-100k,desktop,new,West,51,True,112,4,0,False,False,True,92,1,0,7.0475480407891125,20,3
user_009637,62,30k-50k,desktop,returning,East,26,True,132,1,0,True,False,True,140,1,0,8.102393446130005,-8,0
user_009638,36,75k-100k,mobile,returning,South,44,True,93,1,0,True,False,True,68,1,0,8.890036267108306,25,0
user_009639,33,50k-75k,desktop,new,West,86,False,0,0,0,False,True,True,75,1,0,7.4588263230837315,-75,-1
user_009640,70,75k-100k,mobile,returning,East,13,True,96,7,0,False,False,True,94,12,0,8.527779646970115,2,-5
user_009641,36,>150k,desktop,returning,East,69,True,52,1,0,False,True,True,74,1,0,7.684182000258351,-22,0
user_009642,37,100k-150k,mobile,new,South,50,True,109,6,0,True,True,False,0,0,0,,109,6
user_009643,38,50k-75k,tablet,returning,West,83,True,33,3,0,True,True,True,20,1,0,8.449196908233445,13,2
user_009644,64,>150k,desktop,returning,Midwest,57,True,76,2,0,False,True,True,36,3,0,6.892362993583106,40,-1
user_009645,29,<30k,mobile,new,East,49,False,0,0,0,True,True,True,86,1,0,8.683767144961298,-86,-1
user_009646,63,100k-150k,mobile,returning,South,48,True,121,2,1,False,False,True,96,1,0,6.405605570615383,25,1
user_009647,79,30k-50k,mobile,new,West,52,True,127,4,0,False,False,True,100,7,0,5.251406983150724,27,-3
user_009648,42,30k-50k,desktop,returning,West,54,False,0,0,0,False,True,True,98,1,0,8.671110925084404,-98,-1
user_009649,50,75k-100k,desktop,returning,West,58,True,83,3,0,False,False,True,89,1,0,5.333378499794535,-6,2
user_009650,73,30k-50k,desktop,new,West,24,False,0,0,0,False,False,False,0,0,0,,0,0
user_009651,49,50k-75k,mobile,returning,West,61,True,47,2,0,False,False,True,66,2,0,7.750484543673571,-19,0
user_009652,47,50k-75k,mobile,returning,East,55,True,117,3,0,True,False,True,99,2,0,6.05359493281459,18,1
user_009653,69,50k-75k,desktop,new,East,60,True,144,2,0,False,True,True,120,1,0,9.158085984914736,24,1
user_009654,50,50k-75k,desktop,new,West,53,True,122,4,0,False,False,True,93,3,0,6.691931644807627,29,1
user_009655,25,<30k,mobile,new,Midwest,48,True,115,2,0,True,True,True,73,4,0,7.927177784957069,42,-2
user_009656,58,50k-75k,desktop,returning,West,63,False,0,0,0,False,False,True,101,1,0,7.482089667980932,-101,-1
user_009657,48,50k-75k,mobile,returning,West,64,True,67,3,0,False,True,True,57,1,0,9.405501311454968,10,2
user_009658,45,75k-100k,desktop,new,South,62,True,127,3,0,True,True,False,0,0,0,,127,3
user_009659,63,75k-100k,desktop,returning,East,27,False,0,0,0,False,False,True,99,1,1,7.2043602424248325,-99,-1
user_009660,66,75k-100k,desktop,returning,South,22,True,111,2,1,True,False,True,113,2,0,7.65394724346763,-2,0
user_009661,46,50k-75k,mobile,returning,South,60,True,130,6,0,True,True,True,125,6,1,4.57995844712165,5,0
user_009662,52,<30k,desktop,new,South,23,False,0,0,0,False,False,True,117,1,0,7.72159996596107,-117,-1
user_009663,35,30k-50k,mobile,new,East,47,True,71,4,0,False,True,False,0,0,0,,71,4
user_009664,18,30k-50k,desktop,returning,South,70,True,95,1,0,False,False,True,81,1,0,6.86421156504407,14,0
user_009665,51,>150k,tablet,new,East,71,True,149,5,1,False,False,True,155,11,1,7.240976862433896,-6,-6
user_009666,39,75k-100k,desktop,returning,South,23,True,114,5,0,True,False,True,120,3,0,6.616685996401082,-6,2
user_009667,56,50k-75k,desktop,returning,East,27,True,127,4,0,True,False,True,127,5,0,6.709107687041605,0,-1
user_009668,50,75k-100k,desktop,new,East,37,False,0,0,0,False,True,True,78,2,0,9.860670160186142,-78,-2
user_009669,47,30k-50k,desktop,new,East,34,True,163,2,0,False,False,True,185,3,0,6.980564439899902,-22,-1
user_009670,57,75k-100k,desktop,new,West,50,True,135,3,0,False,False,False,0,0,0,,135,3
user_009671,32,75k-100k,desktop,returning,East,93,True,41,3,0,True,True,True,20,2,0,8.394619807645954,21,1
user_009672,68,100k-150k,desktop,returning,West,67,True,92,1,0,False,False,True,75,2,0,9.053986905612247,17,-1
user_009673,70,30k-50k,mobile,returning,East,5,True,192,3,1,True,False,True,206,3,0,6.527620604855316,-14,0
user_009674,41,<30k,mobile,returning,East,21,True,133,4,0,False,False,True,156,2,0,9.14058304276777,-23,2
user_009675,65,30k-50k,mobile,returning,Midwest,29,True,139,5,0,True,False,True,111,4,0,7.478009461680604,28,1
user_009676,36,100k-150k,desktop,new,East,67,True,144,1,0,True,False,True,148,1,1,6.739944178153411,-4,0
user_009677,24,<30k,desktop,returning,West,66,True,124,1,0,True,True,True,112,1,0,6.23325032643952,12,0
user_009678,33,<30k,mobile,returning,South,66,True,87,5,0,True,True,True,35,1,0,8.122700632531881,52,4
user_009679,37,30k-50k,desktop,new,South,32,True,173,5,0,True,True,True,168,3,0,7.884062877794604,5,2
user_009680,59,50k-75k,mobile,returning,South,38,True,75,3,0,False,True,True,77,2,0,7.518296898288583,-2,1
user_009681,18,50k-75k,mobile,new,Midwest,92,False,0,0,0,False,False,False,0,0,0,,0,0
user_009682,52,<30k,desktop,returning,West,54,True,100,1,0,False,False,True,113,1,0,8.21019878691051,-13,0
user_009683,36,30k-50k,desktop,returning,East,59,True,133,4,0,False,False,False,0,0,0,,133,4
user_009684,38,<30k,mobile,returning,West,62,False,0,0,0,True,False,True,111,1,0,6.518104273243768,-111,-1
user_009685,51,<30k,mobile,returning,West,39,True,76,3,0,True,False,False,0,0,0,,76,3
user_009686,59,50k-75k,tablet,new,East,20,True,188,5,1,False,False,True,173,5,0,8.457410403841788,15,0
user_009687,40,<30k,desktop,returning,East,0,True,175,5,0,True,True,True,164,2,0,9.510153489372042,11,3
user_009688,39,50k-75k,mobile,returning,South,35,True,72,3,0,False,True,True,46,2,0,9.462866222401617,26,1
user_009689,59,30k-50k,desktop,new,South,31,False,0,0,0,False,True,True,90,1,0,8.404849106434092,-90,-1
user_009690,55,30k-50k,mobile,new,East,64,True,91,4,0,False,False,True,99,2,0,9.016756552012753,-8,2
user_009691,45,100k-150k,desktop,returning,East,44,True,58,1,0,False,True,True,48,1,0,7.051428850421862,10,0
user_009692,65,50k-75k,desktop,new,West,51,False,0,0,0,False,False,True,108,1,0,6.446091593629645,-108,-1
user_009693,59,>150k,mobile,returning,Midwest,61,True,71,2,0,False,True,True,61,1,0,10.0,10,1
user_009694,43,<30k,desktop,returning,South,1,True,174,2,0,False,False,True,207,1,0,7.822134977537121,-33,1
user_009695,56,<30k,mobile,new,Midwest,0,True,191,6,1,False,False,True,197,4,0,7.568012092926212,-6,2
user_009696,44,50k-75k,desktop,returning,Midwest,40,True,86,4,0,True,True,True,20,1,0,5.901710285019588,66,3
user_009697,46,75k-100k,desktop,returning,South,44,True,99,4,0,False,False,True,137,2,0,7.935394401983409,-38,2
user_009698,43,50k-75k,mobile,new,East,36,True,121,2,0,False,False,True,118,1,0,6.619334867449104,3,1
user_009699,18,<30k,desktop,returning,East,64,True,87,3,1,True,True,False,0,0,0,,87,3
user_009700,38,50k-75k,desktop,returning,West,53,True,65,1,0,False,False,True,39,1,0,7.572894373831509,26,0
user_009701,37,<30k,desktop,new,East,68,True,112,2,0,False,False,True,104,1,0,7.519832238677227,8,1
user_009702,41,100k-150k,desktop,new,West,88,True,105,1,0,False,True,True,89,1,0,7.937301141727716,16,0
user_009703,56,50k-75k,desktop,new,East,42,True,128,3,0,False,True,True,85,3,0,6.193856745969509,43,0
user_009704,52,100k-150k,desktop,returning,West,63,True,65,1,0,True,True,True,43,1,0,7.777761035066897,22,0
user_009705,62,<30k,desktop,returning,West,51,True,125,2,0,False,True,True,67,1,0,6.52637949111196,58,1
user_009706,48,75k-100k,desktop,new,South,35,True,106,4,0,True,False,True,86,3,0,7.245309450203782,20,1
user_009707,34,>150k,mobile,new,Midwest,96,True,59,3,0,False,True,True,56,2,0,9.755392081242269,3,1
user_009708,21,100k-150k,mobile,returning,East,100,True,116,4,0,True,True,True,85,5,0,10.0,31,-1
user_009709,40,30k-50k,mobile,returning,South,68,True,95,1,0,True,True,True,93,1,0,10.0,2,0
user_009710,30,30k-50k,desktop,returning,East,91,True,114,4,0,True,True,True,97,1,0,9.772285203991274,17,3
user_009711,18,<30k,mobile,returning,South,53,True,67,5,0,True,True,True,63,5,0,7.9844008611412525,4,0
user_009712,33,75k-100k,mobile,returning,Midwest,78,True,98,1,0,False,True,True,85,2,0,9.359858682275268,13,-1
user_009713,43,<30k,mobile,returning,West,13,True,82,3,0,True,True,True,64,2,1,6.137144482620605,18,1
user_009714,52,<30k,desktop,new,East,40,False,0,0,0,False,False,True,104,1,0,7.858132930495695,-104,-1
user_009715,47,30k-50k,desktop,returning,East,44,True,76,1,2,False,True,True,52,1,0,6.892130513046707,24,0
user_009716,24,30k-50k,desktop,returning,East,60,True,96,3,0,False,True,True,42,1,0,7.364110527108435,54,2
user_009717,52,50k-75k,mobile,new,South,56,False,0,0,0,False,True,True,105,1,0,7.4829420720402675,-105,-1
user_009718,49,75k-100k,desktop,new,East,44,True,145,3,0,False,True,True,105,3,0,7.107294830043311,40,0
user_009719,37,50k-75k,desktop,returning,East,49,True,38,2,0,False,True,True,51,1,0,8.661079225821885,-13,1
user_009720,61,50k-75k,desktop,new,South,52,True,87,2,0,True,False,False,0,0,0,,87,2
user_009721,40,100k-150k,mobile,returning,South,90,True,30,4,0,True,True,True,70,2,0,10.0,-40,2
user_009722,60,75k-100k,desktop,returning,West,34,True,116,6,0,False,True,False,0,0,0,,116,6
user_009723,57,50k-75k,desktop,new,Midwest,56,True,107,3,0,True,False,True,106,1,0,8.032612150288987,1,2
user_009724,39,75k-100k,desktop,returning,West,84,True,69,2,0,False,True,True,27,2,1,8.716607140757267,42,0
user_009725,49,30k-50k,desktop,returning,East,71,True,65,1,0,False,True,True,34,1,0,7.853152848033911,31,0
user_009726,35,100k-150k,mobile,returning,West,66,True,107,5,0,True,True,True,56,6,0,8.210256413972674,51,-1
user_009727,37,30k-50k,desktop,returning,West,55,True,100,1,0,True,True,True,60,1,0,7.695364314850343,40,0
user_009728,58,50k-75k,mobile,new,South,16,False,0,0,0,False,False,True,144,1,0,7.847305509382189,-144,-1
user_009729,42,100k-150k,mobile,returning,West,75,True,48,3,0,True,True,True,31,1,0,8.100586453944222,17,2
user_009730,62,100k-150k,mobile,returning,West,47,False,0,0,0,False,False,True,117,1,0,6.711158597807092,-117,-1
user_009731,53,>150k,tablet,returning,South,60,True,67,2,1,True,False,True,66,2,1,5.3834737196666875,1,0
user_009732,54,50k-75k,desktop,returning,South,49,False,0,0,0,True,False,True,148,1,2,6.3091165933897235,-148,-1
user_009733,48,30k-50k,desktop,returning,East,47,True,83,1,0,False,True,True,93,1,0,6.579065198543014,-10,0
user_009734,45,50k-75k,desktop,new,South,51,True,138,2,0,True,False,True,148,1,0,7.81372423507651,-10,1
user_009735,51,50k-75k,desktop,returning,South,44,True,42,2,0,True,True,True,63,1,0,6.439792659791633,-21,1
user_009736,39,50k-75k,desktop,new,Midwest,67,True,83,3,0,False,False,False,0,0,0,,83,3
user_009737,48,50k-75k,mobile,returning,East,72,True,37,2,0,True,True,True,28,3,0,10.0,9,-1
user_009738,46,<30k,mobile,returning,South,34,True,126,7,0,True,False,False,0,0,0,,126,7
user_009739,41,75k-100k,desktop,returning,Midwest,46,True,73,4,0,True,True,True,54,2,0,7.294749974380298,19,2
user_009740,60,50k-75k,desktop,returning,West,61,True,96,1,1,True,False,True,76,1,0,4.92865059120391,20,0
user_009741,64,75k-100k,mobile,new,East,31,True,73,4,0,False,False,True,74,5,0,7.186375063410207,-1,-1
user_009742,32,30k-50k,mobile,new,East,56,True,87,2,0,False,True,True,67,1,0,7.11527252493265,20,1
user_009743,34,30k-50k,mobile,new,East,68,False,0,0,0,True,True,False,0,0,0,,0,0
user_009744,42,50k-75k,desktop,new,South,43,True,79,2,0,False,True,True,51,1,0,6.397003477324477,28,1
user_009745,80,50k-75k,mobile,returning,Midwest,10,True,130,2,1,True,False,True,64,2,0,7.210990086316696,66,0
user_009746,40,75k-100k,mobile,new,East,40,True,177,5,0,False,True,True,135,2,0,8.928790245570402,42,3
user_009747,20,50k-75k,desktop,new,West,57,False,0,0,0,True,True,True,106,2,0,8.494143188275116,-106,-2
user_009748,38,30k-50k,mobile,returning,West,39,True,129,5,0,True,False,True,121,5,0,4.554131191393154,8,0
user_009749,39,<30k,desktop,returning,East,33,True,89,7,0,False,False,True,98,8,0,7.005997941397436,-9,-1
user_009750,59,<30k,mobile,returning,West,43,True,79,3,0,False,True,True,63,3,0,7.293313696054986,16,0
user_009751,26,30k-50k,desktop,new,South,82,False,0,0,0,True,True,False,0,0,0,,0,0
user_009752,57,75k-100k,mobile,returning,South,11,False,0,0,0,False,False,True,119,1,0,6.188367454283594,-119,-1
user_009753,37,50k-75k,mobile,returning,South,33,True,121,4,0,True,True,False,0,0,0,,121,4
user_009754,37,50k-75k,desktop,returning,South,66,False,0,0,0,True,True,True,85,1,0,8.246867739495032,-85,-1
user_009755,62,<30k,mobile,returning,South,57,False,0,0,0,False,True,True,119,1,0,7.329442621751269,-119,-1
user_009756,30,75k-100k,mobile,new,East,93,True,115,3,0,False,True,True,107,3,0,8.300121143784487,8,0
user_009757,40,50k-75k,mobile,returning,East,44,True,48,2,0,False,True,True,60,2,0,9.708006138370616,-12,0
user_009758,53,75k-100k,desktop,new,South,57,True,140,3,0,True,True,True,117,3,0,9.070775643711725,23,0
user_009759,52,75k-100k,mobile,returning,East,33,True,55,3,1,False,True,False,0,0,0,,55,3
user_009760,45,50k-75k,desktop,returning,West,68,True,71,1,0,True,True,True,70,1,0,7.147681699970708,1,0
user_009761,44,50k-75k,mobile,returning,East,44,True,118,6,0,True,True,True,83,5,0,9.420297047887772,35,1
user_009762,39,100k-150k,mobile,new,Midwest,82,True,89,2,0,False,True,True,69,2,0,5.822246173409416,20,0
user_009763,29,100k-150k,mobile,returning,East,74,True,39,2,0,True,True,True,47,1,0,7.675348478114807,-8,1
user_009764,18,30k-50k,mobile,returning,Midwest,56,True,79,1,0,False,False,False,0,0,0,,79,1
user_009765,40,50k-75k,desktop,returning,Midwest,42,True,68,2,0,True,True,True,65,1,1,5.39222463756024,3,1
user_009766,51,<30k,desktop,returning,South,38,False,0,0,0,True,True,True,80,1,0,5.967490458937624,-80,-1
user_009767,46,<30k,desktop,returning,West,80,True,66,2,0,False,False,True,60,1,0,7.78605833620314,6,1
user_009768,18,50k-75k,mobile,returning,West,97,True,85,2,1,True,True,True,46,1,2,7.769076426063685,39,1
user_009769,34,50k-75k,desktop,new,East,79,True,164,4,0,True,True,True,114,6,0,8.74798000383901,50,-2
user_009770,38,75k-100k,mobile,returning,South,36,True,81,4,0,False,False,True,91,1,0,7.992680481260226,-10,3
user_009771,55,50k-75k,desktop,returning,South,32,True,116,6,0,True,True,True,104,3,0,10.0,12,3
user_009772,33,50k-75k,mobile,returning,East,61,True,87,5,1,True,True,True,68,7,0,8.727458998196308,19,-2
user_009773,65,100k-150k,desktop,new,West,77,True,135,4,0,False,True,True,114,5,0,7.757305674483864,21,-1
user_009774,36,50k-75k,desktop,returning,South,49,True,66,2,0,True,True,True,53,1,0,8.136738984175048,13,1
user_009775,50,75k-100k,mobile,returning,East,62,False,0,0,0,True,True,True,88,2,0,6.423406128469991,-88,-2
user_009776,47,<30k,mobile,new,South,18,False,0,0,0,True,False,False,0,0,0,,0,0
user_009777,40,50k-75k,mobile,returning,South,15,False,0,0,0,False,False,True,105,1,0,8.722500819220317,-105,-1
user_009778,66,50k-75k,desktop,returning,East,27,False,0,0,0,True,False,True,114,2,0,7.250910991789098,-114,-2
user_009779,51,50k-75k,desktop,new,South,51,True,146,2,1,True,False,True,174,1,0,7.387270340542877,-28,1
user_009780,39,<30k,mobile,returning,South,12,True,161,5,0,True,False,True,166,7,0,7.1336189339647325,-5,-2
user_009781,22,30k-50k,mobile,new,West,86,False,0,0,0,False,True,True,79,1,0,7.253776008390091,-79,-1
user_009782,30,>150k,desktop,returning,South,84,True,113,3,0,False,True,True,80,2,0,8.58170811028764,33,1
user_009783,37,50k-75k,mobile,returning,Midwest,11,True,153,4,0,False,False,False,0,0,0,,153,4
user_009784,39,50k-75k,mobile,new,South,75,True,144,4,0,True,False,True,136,4,1,8.225340934884818,8,0
user_009785,21,50k-75k,mobile,returning,Midwest,100,True,87,3,0,False,True,True,61,1,0,6.740672336984296,26,2
user_009786,54,50k-75k,desktop,returning,South,24,True,115,6,1,False,False,True,82,4,0,5.261015106903998,33,2
user_009787,36,75k-100k,desktop,returning,South,31,True,65,3,0,True,False,False,0,0,0,,65,3
user_009788,41,75k-100k,mobile,returning,West,39,True,94,1,0,False,True,True,63,1,0,8.2345300846443,31,0
user_009789,42,30k-50k,desktop,new,West,66,True,135,3,1,True,False,True,136,3,0,7.142292696656323,-1,0
user_009790,42,75k-100k,mobile,new,South,38,True,146,4,0,False,True,True,85,3,0,6.973922623526642,61,1
user_009791,34,75k-100k,desktop,returning,West,87,True,49,1,0,False,True,True,32,1,0,7.685523332570864,17,0
user_009792,63,100k-150k,desktop,returning,West,53,True,127,4,1,False,True,True,121,5,0,6.789335919569192,6,-1
user_009793,55,100k-150k,mobile,returning,West,73,True,59,5,0,False,True,True,57,7,0,7.5918142438365335,2,-2
user_009794,31,100k-150k,mobile,new,West,94,True,116,3,0,False,True,True,108,2,0,7.427099539340936,8,1
user_009795,33,50k-75k,mobile,new,South,63,True,160,2,0,True,True,True,128,1,1,6.869611998671018,32,1
user_009796,42,75k-100k,tablet,returning,Midwest,56,True,56,3,0,True,True,True,61,2,0,8.01568370247121,-5,1
user_009797,45,75k-100k,mobile,returning,East,65,True,113,3,0,True,True,True,92,1,1,9.87395283558848,21,2
user_009798,33,75k-100k,mobile,returning,Midwest,70,True,122,5,0,False,False,True,154,1,0,8.326695301837821,-32,4
user_009799,39,75k-100k,mobile,returning,West,36,True,121,3,0,False,False,True,124,7,0,6.865800661286056,-3,-4
user_009800,50,75k-100k,mobile,new,West,73,True,97,3,0,True,True,True,117,5,0,8.406687626814527,-20,-2
user_009801,29,50k-75k,desktop,returning,South,69,True,105,4,0,False,True,True,80,1,0,9.952834402722841,25,3
user_009802,59,75k-100k,mobile,new,East,27,True,166,5,0,True,True,True,168,5,0,8.373471724300774,-2,0
user_009803,42,<30k,mobile,returning,East,48,True,59,6,0,True,False,True,39,5,0,7.347242761429336,20,1
user_009804,47,75k-100k,mobile,new,South,51,True,129,3,1,True,True,True,127,1,0,6.3712040362437445,2,2
user_009805,73,75k-100k,mobile,returning,East,1,True,135,2,1,True,False,True,141,1,2,5.813847228316112,-6,1
user_009806,51,30k-50k,desktop,new,Midwest,32,True,134,3,0,False,False,True,99,3,0,7.2656076039833195,35,0
user_009807,33,30k-50k,mobile,new,West,69,True,111,1,0,True,True,True,77,1,0,6.427346904772243,34,0
user_009808,49,30k-50k,mobile,returning,West,87,True,104,7,0,False,True,True,59,8,1,8.117006770820407,45,-1
user_009809,18,50k-75k,mobile,new,South,36,True,121,6,0,False,True,True,61,3,0,6.237143227781281,60,3
user_009810,59,50k-75k,mobile,returning,Midwest,21,True,154,4,0,True,False,False,0,0,0,,154,4
user_009811,55,50k-75k,desktop,returning,East,70,True,70,2,0,True,False,True,20,4,0,6.943324204818885,50,-2
user_009812,20,50k-75k,desktop,new,Midwest,77,True,75,3,0,True,True,True,44,1,0,7.142353416644066,31,2
user_009813,34,30k-50k,tablet,returning,Midwest,65,True,90,1,0,False,False,True,102,1,1,9.712292348378174,-12,0
user_009814,54,75k-100k,desktop,returning,West,54,True,119,1,0,True,True,True,89,1,0,8.829172757743814,30,0
user_009815,55,30k-50k,mobile,new,South,50,True,100,1,0,False,False,True,165,1,0,7.04808109506909,-65,0
user_009816,37,100k-150k,desktop,returning,East,79,True,39,5,0,False,True,True,57,2,0,6.220160774097399,-18,3
user_009817,53,<30k,mobile,returning,West,58,False,0,0,0,False,False,True,110,4,0,8.359054521858727,-110,-4
user_009818,25,<30k,mobile,new,East,100,True,127,3,0,False,True,True,91,3,0,8.378103715424166,36,0
user_009819,32,100k-150k,mobile,returning,East,100,True,89,2,0,True,True,True,30,3,0,7.55909488202251,59,-1
user_009820,32,50k-75k,mobile,new,East,69,True,111,2,0,True,True,True,94,1,0,6.787551569970136,17,1
user_009821,32,100k-150k,desktop,returning,West,100,True,51,5,0,True,True,True,38,3,0,7.2289564099422945,13,2
user_009822,69,75k-100k,mobile,new,East,27,True,159,4,0,True,False,True,203,1,0,6.723933786835371,-44,3
user_009823,56,<30k,mobile,new,Midwest,19,False,0,0,0,True,False,True,150,1,0,7.0632866247024015,-150,-1
user_009824,40,75k-100k,desktop,new,East,50,False,0,0,0,False,False,True,70,3,0,8.803387603520724,-70,-3
user_009825,44,100k-150k,desktop,new,South,49,True,129,2,1,False,True,True,99,2,0,6.962038666119109,30,0
user_009826,53,75k-100k,mobile,returning,West,83,True,108,2,1,True,True,True,99,2,0,7.518111855569152,9,0
user_009827,30,30k-50k,mobile,returning,East,77,True,30,5,0,False,True,True,34,6,0,9.66709858092104,-4,-1
user_009828,27,50k-75k,desktop,new,South,61,True,129,1,0,True,True,True,58,1,0,9.757263086150484,71,0
user_009829,57,30k-50k,mobile,new,Midwest,24,True,137,6,1,True,True,True,107,6,0,7.018250194113422,30,0
user_009830,37,>150k,mobile,returning,South,78,True,44,6,0,False,True,True,20,5,0,5.604959905571266,24,1
user_009831,39,75k-100k,mobile,returning,West,73,True,55,4,0,False,True,True,37,4,0,6.968660126712521,18,0
user_009832,43,>150k,desktop,returning,Midwest,63,True,79,1,1,True,True,True,71,3,0,7.326947613991765,8,-2
user_009833,34,50k-75k,desktop,returning,South,59,True,72,3,0,True,False,True,75,3,0,10.0,-3,0
user_009834,56,30k-50k,desktop,new,West,39,True,108,4,1,False,False,True,127,5,1,5.471276799911535,-19,-1
user_009835,34,<30k,mobile,returning,West,61,True,94,3,0,True,True,True,126,3,0,9.32331929507286,-32,0
user_009836,39,50k-75k,mobile,returning,West,65,True,112,6,0,True,True,True,102,4,0,9.003779763794407,10,2
user_009837,40,75k-100k,desktop,returning,Midwest,27,True,132,4,0,False,True,True,108,1,0,7.606849971174382,24,3
user_009838,78,30k-50k,tablet,returning,West,39,False,0,0,0,True,True,True,99,2,0,8.709272667097478,-99,-2
user_009839,23,<30k,desktop,new,East,80,True,83,5,0,False,False,True,81,9,0,4.8128142629317106,2,-4
user_009840,42,50k-75k,desktop,new,Midwest,47,True,97,1,1,True,False,True,91,1,0,7.709804570968025,6,0
user_009841,53,<30k,desktop,returning,South,27,True,106,6,0,True,False,True,98,2,0,5.921503251187347,8,4
user_009842,20,<30k,desktop,returning,Midwest,72,False,0,0,0,False,True,True,97,1,0,8.075786635465526,-97,-1
user_009843,40,30k-50k,desktop,returning,South,64,True,93,4,0,False,True,True,107,3,0,7.934473833132754,-14,1
user_009844,28,75k-100k,mobile,returning,East,85,True,54,1,0,True,True,True,25,1,0,8.5802268061365,29,0
user_009845,68,100k-150k,desktop,new,South,36,True,169,6,0,False,True,True,150,7,0,5.734350588924771,19,-1
user_009846,49,75k-100k,desktop,returning,South,46,True,81,6,0,False,True,True,82,9,0,7.183012928556692,-1,-3
user_009847,39,<30k,desktop,new,West,68,True,134,1,0,True,True,True,77,1,0,9.176205116279943,57,0
user_009848,49,50k-75k,mobile,new,West,39,True,135,8,0,False,False,True,120,7,0,5.416240150350617,15,1
user_009849,33,75k-100k,desktop,returning,South,60,True,92,4,0,True,True,True,109,5,0,6.972879281262349,-17,-1
user_009850,38,100k-150k,desktop,returning,East,69,True,112,1,0,True,True,True,73,1,0,6.954802728586406,39,0
user_009851,18,100k-150k,mobile,new,West,100,True,157,4,1,False,True,True,118,4,0,9.925617019582118,39,0
user_009852,30,>150k,desktop,returning,South,69,True,67,1,0,True,True,True,62,1,0,9.401229526092997,5,0
user_009853,64,75k-100k,mobile,new,South,49,False,0,0,0,False,True,True,88,2,0,8.148712782397862,-88,-2
user_009854,26,>150k,desktop,returning,East,71,True,65,3,1,True,False,True,68,6,0,5.903174071053179,-3,-3
user_009855,56,<30k,mobile,returning,Midwest,23,True,114,5,0,False,False,True,115,3,0,5.877534193175093,-1,2
user_009856,25,30k-50k,desktop,new,South,61,True,128,1,0,True,True,True,121,1,0,9.144178222408,7,0
user_009857,24,30k-50k,desktop,new,South,54,False,0,0,0,False,True,True,94,1,0,7.129971883913222,-94,-1
user_009858,18,30k-50k,mobile,returning,Midwest,36,True,62,5,0,False,False,True,69,9,0,8.443305996823483,-7,-4
user_009859,50,30k-50k,mobile,returning,Midwest,37,False,0,0,0,True,True,True,143,2,0,6.043215267894562,-143,-2
user_009860,80,75k-100k,mobile,returning,South,33,True,78,2,0,False,False,True,74,6,1,5.202898674944383,4,-4
user_009861,51,75k-100k,desktop,new,South,69,True,126,2,0,True,True,True,111,1,0,6.807894732600534,15,1
user_009862,21,50k-75k,desktop,returning,West,96,False,0,0,0,False,True,False,0,0,0,,0,0
user_009863,32,75k-100k,mobile,returning,South,64,True,96,5,0,False,False,True,103,5,0,7.6594408753136065,-7,0
user_009864,24,<30k,desktop,new,West,64,True,46,1,0,False,True,True,55,1,0,7.105297880851723,-9,0
user_009865,18,30k-50k,desktop,new,West,81,True,122,1,0,True,True,True,96,1,0,7.809763834004107,26,0
user_009866,53,<30k,desktop,returning,West,51,True,116,4,0,False,False,False,0,0,0,,116,4
user_009867,43,>150k,desktop,new,East,59,True,93,2,0,True,True,True,89,2,0,7.956138900348867,4,0
user_009868,26,100k-150k,desktop,returning,West,81,True,101,3,0,True,True,True,98,2,0,7.54050365610338,3,1
user_009869,41,50k-75k,desktop,new,East,18,False,0,0,0,True,False,True,96,1,0,7.683697923551504,-96,-1
user_009870,53,30k-50k,desktop,new,South,47,True,117,3,1,False,False,True,126,4,0,6.440572819009073,-9,-1
user_009871,58,50k-75k,mobile,returning,Midwest,0,True,124,5,0,True,False,True,42,9,0,6.096574759319216,82,-4
user_009872,41,30k-50k,desktop,returning,East,25,True,143,3,0,True,False,True,141,4,0,5.889409003497435,2,-1
user_009873,47,50k-75k,desktop,returning,West,66,True,90,2,0,False,False,True,77,3,1,8.35523178524817,13,-1
user_009874,18,100k-150k,desktop,new,Midwest,82,True,104,4,0,True,True,True,87,3,0,8.24525093165374,17,1
user_009875,52,50k-75k,desktop,returning,West,76,True,30,6,0,True,True,True,20,6,0,8.91108025388125,10,0
user_009876,31,50k-75k,desktop,new,South,51,False,0,0,0,False,True,True,115,2,0,8.302608634023258,-115,-2
user_009877,22,100k-150k,mobile,returning,East,89,True,30,2,0,False,True,False,0,0,0,,30,2
user_009878,38,75k-100k,mobile,returning,East,49,True,106,2,0,True,True,True,82,1,0,7.569808760189639,24,1
user_009879,45,>150k,desktop,returning,South,71,True,85,2,0,False,False,True,83,2,0,7.443832495820794,2,0
user_009880,41,30k-50k,desktop,new,East,57,True,123,2,0,False,False,True,105,4,0,6.0422149691873095,18,-2
user_009881,64,100k-150k,desktop,returning,East,53,True,101,2,1,True,True,True,25,4,1,7.981461947113972,76,-2
user_009882,33,<30k,desktop,returning,East,73,True,48,4,0,False,True,True,46,3,0,8.802814072775895,2,1
user_009883,52,100k-150k,desktop,returning,East,45,True,144,3,0,True,False,True,117,4,1,7.544368017544633,27,-1
user_009884,65,75k-100k,mobile,returning,South,53,True,78,4,0,False,False,True,39,4,0,7.064037409754599,39,0
user_009885,74,30k-50k,desktop,returning,East,35,False,0,0,0,False,False,False,0,0,0,,0,0
user_009886,55,30k-50k,mobile,returning,West,37,True,87,5,0,False,True,True,83,4,0,6.321423018403998,4,1
user_009887,50,75k-100k,desktop,returning,Midwest,50,True,37,3,0,False,True,True,20,3,0,7.383151727240585,17,0
user_009888,53,75k-100k,desktop,returning,West,52,True,152,4,0,False,True,True,129,1,0,6.322897562818959,23,3
user_009889,46,100k-150k,desktop,returning,East,75,True,35,5,0,True,True,True,50,6,0,10.0,-15,-1
user_009890,43,30k-50k,desktop,new,West,83,True,96,1,0,True,False,True,75,2,0,6.117409729482738,21,-1
user_009891,58,>150k,mobile,returning,South,39,True,98,4,0,False,True,True,86,1,1,9.808649995379266,12,3
user_009892,38,100k-150k,mobile,new,South,61,True,108,3,0,True,True,True,72,4,0,9.790028551036356,36,-1
user_009893,49,100k-150k,tablet,new,East,83,True,73,1,0,False,False,True,68,1,0,8.618741045099814,5,0
user_009894,33,>150k,desktop,new,Midwest,84,True,95,2,0,False,True,True,42,2,0,8.559996271865705,53,0
user_009895,50,<30k,desktop,returning,East,16,False,0,0,0,False,False,True,114,1,0,8.43361885782237,-114,-1
user_009896,64,50k-75k,desktop,new,South,2,True,149,5,0,False,True,True,105,2,0,9.02008684086434,44,3
user_009897,24,30k-50k,desktop,returning,South,79,False,0,0,0,True,True,True,108,2,0,9.77128344796311,-108,-2
user_009898,57,75k-100k,tablet,returning,South,22,True,77,3,0,False,True,True,54,4,0,6.583188915318863,23,-1
user_009899,51,75k-100k,desktop,returning,East,52,True,107,1,1,True,True,True,80,1,0,6.482785395806473,27,0
user_009900,63,50k-75k,tablet,new,West,44,False,0,0,0,False,False,True,121,1,0,8.716000143141034,-121,-1
user_009901,39,30k-50k,desktop,returning,East,47,True,106,4,0,False,False,False,0,0,0,,106,4
user_009902,46,50k-75k,desktop,new,South,65,True,136,1,0,False,True,True,95,2,0,6.651553619856478,41,-1
user_009903,48,50k-75k,mobile,returning,South,24,True,118,7,0,False,True,True,109,5,0,8.683143864671242,9,2
user_009904,35,<30k,desktop,new,Midwest,35,True,115,1,1,False,False,True,117,1,0,6.487896070152669,-2,0
user_009905,61,30k-50k,mobile,new,South,27,True,168,3,0,True,False,True,166,5,0,7.279276083592545,2,-2
user_009906,28,50k-75k,mobile,returning,West,82,True,30,6,0,True,True,True,20,3,1,8.115929071420538,10,3
user_009907,36,75k-100k,desktop,returning,East,50,True,105,1,0,True,False,True,74,1,0,9.27991064547189,31,0
user_009908,54,75k-100k,tablet,returning,South,54,True,109,1,0,False,True,True,70,1,0,5.840339643525112,39,0
user_009909,35,75k-100k,mobile,returning,West,64,True,147,5,0,True,True,True,134,3,0,7.418940503975107,13,2
user_009910,49,100k-150k,desktop,returning,South,52,True,74,3,0,False,True,True,70,3,0,7.746223503626766,4,0
user_009911,51,50k-75k,mobile,returning,South,37,True,106,7,0,False,False,True,119,7,0,4.536241392855425,-13,0
user_009912,18,<30k,desktop,returning,West,95,False,0,0,0,False,False,True,93,2,0,9.020599890966816,-93,-2
user_009913,39,75k-100k,mobile,new,East,43,True,97,2,0,True,False,True,125,4,0,9.449959081730764,-28,-2
user_009914,57,30k-50k,mobile,new,East,56,True,144,5,0,False,False,True,131,5,0,8.16918736263721,13,0
user_009915,36,50k-75k,mobile,returning,South,47,True,116,2,1,True,False,True,118,3,0,5.406866886802242,-2,-1
user_009916,41,50k-75k,desktop,returning,Midwest,46,False,0,0,0,True,False,False,0,0,0,,0,0
user_009917,39,50k-75k,desktop,returning,West,74,True,100,3,0,False,True,True,101,2,0,7.370207219165189,-1,1
user_009918,51,50k-75k,desktop,returning,Midwest,39,True,86,6,0,True,False,True,94,6,0,6.7799057983950295,-8,0
user_009919,64,100k-150k,mobile,new,Midwest,33,False,0,0,0,False,False,True,129,1,2,6.7585487157546,-129,-1
user_009920,48,30k-50k,mobile,returning,Midwest,36,True,95,6,0,False,False,True,66,8,1,6.386727090028015,29,-2
user_009921,42,75k-100k,mobile,returning,East,54,False,0,0,0,False,True,True,108,1,0,4.979145297293373,-108,-1
user_009922,51,75k-100k,desktop,returning,East,44,True,151,2,0,False,False,True,174,2,0,6.906072882414427,-23,0
user_009923,30,<30k,desktop,new,Midwest,73,False,0,0,0,True,True,True,97,1,0,7.9786402518859525,-97,-1
user_009924,49,100k-150k,desktop,returning,East,52,True,107,1,0,True,True,True,81,1,1,6.808134788702907,26,0
user_009925,40,50k-75k,mobile,returning,East,56,True,81,3,0,True,True,True,63,3,0,7.743142790354783,18,0
user_009926,29,50k-75k,tablet,returning,Midwest,43,True,104,1,0,True,True,True,107,1,0,8.479531086417484,-3,0
user_009927,43,50k-75k,desktop,new,West,58,False,0,0,0,True,True,True,99,2,0,9.342999040154254,-99,-2
user_009928,42,50k-75k,mobile,returning,West,66,True,82,1,0,True,False,True,101,1,0,6.971936749148563,-19,0
user_009929,45,<30k,desktop,returning,South,5,True,111,3,1,False,False,True,154,3,0,6.940515023644606,-43,0
user_009930,32,50k-75k,desktop,returning,East,96,True,71,3,0,True,True,True,45,4,1,6.675818472820582,26,-1
user_009931,48,75k-100k,desktop,returning,East,60,True,96,1,0,False,False,True,87,2,0,7.285063030869361,9,-1
user_009932,44,50k-75k,desktop,returning,South,52,True,104,3,0,False,True,True,89,1,0,7.725727404734705,15,2
user_009933,80,75k-100k,desktop,returning,Midwest,15,True,101,5,1,False,False,True,112,8,0,9.461340092529467,-11,-3
user_009934,69,75k-100k,desktop,new,East,19,True,192,4,0,False,False,True,201,2,0,8.390977636533476,-9,2
user_009935,18,50k-75k,mobile,new,South,52,True,80,3,0,True,True,True,54,1,0,7.2186692606957275,26,2
user_009936,57,50k-75k,mobile,returning,South,41,True,124,3,0,True,True,True,106,1,0,7.9584538155583004,18,2
user_009937,53,50k-75k,mobile,returning,West,64,True,84,3,0,True,False,True,68,1,0,7.730678763349271,16,2
user_009938,39,30k-50k,mobile,returning,West,67,True,96,3,0,True,True,True,82,2,0,6.724882893623435,14,1
user_009939,28,30k-50k,desktop,new,South,52,True,148,4,0,True,True,True,97,4,0,7.5512097751135805,51,0
user_009940,57,50k-75k,mobile,new,East,42,True,114,7,0,False,False,True,123,5,0,6.981874503980309,-9,2
user_009941,57,100k-150k,desktop,new,East,60,True,137,1,0,False,True,True,138,2,0,8.355922882738433,-1,-1
user_009942,60,100k-150k,desktop,returning,South,44,True,98,3,0,False,True,True,75,2,0,5.239275585390675,23,1
user_009943,36,<30k,mobile,returning,West,59,True,103,7,0,True,True,True,67,3,0,5.7842038524572565,36,4
user_009944,58,50k-75k,tablet,returning,East,26,True,171,1,1,False,False,False,0,0,0,,171,1
user_009945,52,50k-75k,mobile,new,Midwest,32,True,102,3,0,True,True,True,80,1,0,7.86323018952035,22,2
user_009946,56,75k-100k,mobile,returning,South,40,True,89,2,1,True,True,True,58,1,0,7.976643989134008,31,1
user_009947,18,50k-75k,mobile,returning,South,48,False,0,0,0,True,True,True,108,1,0,7.211984764486285,-108,-1
user_009948,61,>150k,mobile,new,South,75,True,109,3,0,True,True,True,68,1,0,7.283849513378127,41,2
user_009949,41,75k-100k,mobile,returning,West,50,True,75,2,0,True,True,False,0,0,0,,75,2
user_009950,35,75k-100k,mobile,new,West,53,True,141,2,0,True,False,True,141,1,0,10.0,0,1
user_009951,32,50k-75k,mobile,new,East,81,True,96,3,0,False,False,True,83,3,0,7.172060890983113,13,0
user_009952,74,50k-75k,desktop,returning,Midwest,14,True,185,3,1,False,True,True,166,3,0,7.524928026001078,19,0
user_009953,24,50k-75k,mobile,returning,South,78,True,96,6,0,True,True,True,88,9,0,6.895164235534556,8,-3
user_009954,19,100k-150k,mobile,returning,Midwest,88,True,106,1,1,False,True,True,77,1,1,8.32837316228929,29,0
user_009955,35,50k-75k,mobile,returning,West,67,True,119,5,0,True,False,True,126,10,0,6.644388392837948,-7,-5
user_009956,49,30k-50k,mobile,returning,Midwest,67,True,78,5,0,True,True,True,90,6,0,8.45068235270577,-12,-1
user_009957,57,>150k,mobile,returning,South,48,False,0,0,0,False,True,True,80,1,0,6.2739078433349045,-80,-1
user_009958,62,75k-100k,desktop,new,East,32,True,121,5,0,False,False,True,100,11,0,6.525300617762824,21,-6
user_009959,51,50k-75k,desktop,returning,South,25,True,92,3,0,False,False,True,93,2,0,8.714743768362727,-1,1
user_009960,38,50k-75k,mobile,returning,West,74,False,0,0,0,True,True,True,83,1,0,8.44895660207173,-83,-1
user_009961,54,75k-100k,mobile,new,East,64,True,132,2,0,True,False,False,0,0,0,,132,2
user_009962,34,50k-75k,desktop,returning,East,66,True,87,3,0,True,True,True,53,1,0,8.339204247142664,34,2
user_009963,34,50k-75k,desktop,returning,East,62,True,109,1,0,True,True,True,92,1,0,6.358474328503463,17,0
user_009964,65,30k-50k,desktop,returning,West,15,True,99,5,0,True,False,True,94,7,0,5.967943302413002,5,-2
user_009965,62,75k-100k,mobile,new,Midwest,30,False,0,0,0,False,False,True,162,2,0,6.841424084102267,-162,-2
user_009966,36,30k-50k,desktop,new,Midwest,40,False,0,0,0,True,False,True,177,2,0,7.4131352184572945,-177,-2
user_009967,67,75k-100k,desktop,returning,Midwest,13,True,78,3,1,False,False,True,62,1,0,7.765320449630231,16,2
user_009968,39,<30k,desktop,returning,East,30,False,0,0,0,True,True,False,0,0,0,,0,0
user_009969,23,30k-50k,mobile,returning,South,68,True,61,5,0,True,True,True,36,5,0,7.6304483853230884,25,0
user_009970,35,100k-150k,desktop,new,East,67,True,92,3,0,False,True,True,104,2,0,8.822515961148449,-12,1
user_009971,40,<30k,desktop,new,West,73,False,0,0,0,False,False,True,96,2,0,7.265071219737936,-96,-2
user_009972,62,50k-75k,desktop,returning,West,44,True,51,2,0,False,False,True,43,3,0,8.347761242929648,8,-1
user_009973,27,<30k,desktop,new,South,66,False,0,0,0,False,False,False,0,0,0,,0,0
user_009974,48,100k-150k,desktop,returning,East,37,True,86,1,0,True,False,True,90,1,0,9.546086157596463,-4,0
user_009975,43,50k-75k,desktop,new,East,49,True,159,1,0,True,False,True,143,1,0,6.21102291503512,16,0
user_009976,57,50k-75k,mobile,returning,Midwest,31,True,81,6,0,True,True,True,54,2,0,10.0,27,4
user_009977,47,30k-50k,desktop,returning,West,66,True,150,2,0,False,True,True,142,1,0,7.522826831096804,8,1
user_009978,50,100k-150k,tablet,returning,South,60,True,131,1,0,True,False,True,95,2,0,7.207930838871216,36,-1
user_009979,33,30k-50k,mobile,new,West,78,True,108,4,0,False,True,True,109,2,0,10.0,-1,2
user_009980,31,30k-50k,mobile,returning,East,69,True,138,1,0,True,True,True,87,1,0,9.74258038398778,51,0
user_009981,49,50k-75k,mobile,new,East,55,True,120,3,1,False,False,True,107,2,0,6.001999814374624,13,1
user_009982,38,>150k,desktop,new,South,65,True,68,2,0,False,True,True,59,2,0,6.685993591200344,9,0
user_009983,32,75k-100k,mobile,new,East,87,True,37,1,1,False,False,True,20,1,0,7.3683164844313715,17,0
user_009984,54,50k-75k,desktop,returning,East,55,True,89,6,0,False,True,True,67,5,0,7.468476150012926,22,1
user_009985,35,50k-75k,desktop,new,South,84,False,0,0,0,True,False,True,90,2,0,7.662355668693504,-90,-2
user_009986,35,75k-100k,desktop,returning,South,59,True,97,3,0,False,False,True,121,1,0,7.585538321651092,-24,2
user_009987,45,>150k,desktop,new,West,76,True,98,5,0,True,True,True,82,5,0,8.733957010590457,16,0
user_009988,18,30k-50k,desktop,returning,South,41,True,118,2,0,False,False,True,95,5,0,6.7172313719202315,23,-3
user_009989,42,75k-100k,mobile,new,South,61,True,155,2,0,True,True,True,153,1,0,7.764480143705374,2,1
user_009990,58,30k-50k,mobile,new,East,51,True,87,2,0,False,False,True,64,3,0,8.034260400422955,23,-1
user_009991,62,75k-100k,mobile,new,East,25,True,121,5,0,False,False,True,107,4,0,5.996252027277064,14,1
user_009992,30,50k-75k,desktop,new,East,66,True,129,2,1,False,True,True,72,1,0,8.814814708432133,57,1
user_009993,27,50k-75k,mobile,returning,West,77,True,70,2,0,False,True,True,82,5,0,9.071703805508857,-12,-3
user_009994,26,<30k,desktop,returning,Midwest,43,False,0,0,0,False,False,False,0,0,0,,0,0
user_009995,46,>150k,tablet,returning,West,50,True,79,3,0,True,True,True,67,1,0,10.0,12,2
user_009996,46,75k-100k,mobile,returning,West,78,True,67,1,0,False,True,True,32,1,0,8.06324668297176,35,0
user_009997,29,>150k,desktop,returning,West,96,True,74,2,0,True,True,True,93,3,0,6.611320125827014,-19,-1
user_009998,34,100k-150k,mobile,returning,East,69,True,87,2,0,True,True,True,56,1,0,8.028822326899382,31,1
user_009999,22,75k-100k,desktop,new,West,62,False,0,0,0,True,True,False,0,0,0,,0,0
