user_id,age,income_bracket,device_type,user_type,region,tech_savviness,filed_2023,time_to_complete_2023,sessions_2023,support_tickets_2023,early_login_2024,used_smart_assistant,filed_2024,time_to_complete_2024,sessions_2024,support_tickets_2024,satisfaction_2024,time_improvement,session_improvement
user_000000,41,50k-75k,tablet,returning,Midwest,41,True,83,2,0,True,True,True,40,1,0,7.940143815046259,43,1
user_000001,37,<30k,desktop,returning,Midwest,43,True,112,1,0,False,False,True,96,1,0,7.240809715473777,16,0
user_000002,19,30k-50k,mobile,new,East,61,True,122,1,0,False,True,True,29,1,0,8.454383537545061,93,0
user_000003,66,75k-100k,mobile,new,East,31,True,125,5,0,False,False,True,121,3,0,6.208181794504734,4,2
user_000004,27,30k-50k,desktop,returning,West,85,True,56,4,1,False,True,True,36,3,0,8.153965746850586,20,1
user_000005,35,<30k,desktop,returning,South,30,True,133,2,0,True,True,True,81,1,0,8.299457827517692,52,1
user_000006,57,75k-100k,mobile,new,East,16,True,206,4,0,False,True,True,200,5,0,8.031864024559363,6,-1
user_000007,56,30k-50k,desktop,returning,West,47,True,67,1,0,True,False,True,72,1,0,7.549876412018367,-5,0
user_000008,22,<30k,mobile,new,East,49,True,113,4,0,False,True,True,92,1,1,9.745587774595066,21,3
user_000009,49,100k-150k,mobile,new,East,59,True,90,6,0,False,True,True,82,5,0,5.660753893613093,8,1
user_000010,60,<30k,tablet,returning,West,48,False,0,0,0,True,False,False,0,0,0,,0,0
user_000011,49,75k-100k,mobile,returning,West,74,True,73,2,0,True,True,True,55,1,0,7.896393975638586,18,1
user_000012,57,30k-50k,mobile,new,East,55,False,0,0,0,False,True,True,94,1,0,8.497789378443048,-94,-1
user_000013,50,100k-150k,desktop,new,Midwest,83,True,146,5,0,True,True,True,107,1,1,8.079375328208949,39,4
user_000014,46,75k-100k,desktop,returning,East,45,True,140,1,2,False,True,True,71,2,0,7.898961700510644,69,-1
user_000015,67,30k-50k,desktop,returning,West,37,True,86,2,0,True,False,True,87,1,0,8.987763157885624,-1,1
user_000016,58,30k-50k,mobile,new,West,49,True,158,3,0,False,False,True,162,1,0,9.121557998133104,-4,2
user_000017,34,100k-150k,mobile,returning,East,80,True,86,3,1,True,True,True,88,1,0,8.43717079435691,-2,2
user_000018,45,30k-50k,mobile,returning,South,41,True,57,4,0,True,True,True,20,3,0,10.0,37,1
user_000019,42,50k-75k,mobile,new,East,56,False,0,0,0,False,False,True,106,1,0,7.698660889769077,-106,-1
user_000020,18,50k-75k,desktop,returning,South,64,True,85,1,0,True,True,True,67,1,0,6.278398907328336,18,0
user_000021,42,30k-50k,mobile,returning,East,54,True,77,7,0,False,True,True,122,4,0,9.632139080216376,-45,3
user_000022,62,<30k,desktop,returning,West,46,True,107,5,1,False,False,False,0,0,0,,107,5
user_000023,53,30k-50k,desktop,returning,Midwest,77,True,67,3,0,True,True,True,37,2,0,9.461391228830246,30,1
user_000024,46,<30k,desktop,new,West,42,False,0,0,0,False,True,False,0,0,0,,0,0
user_000025,29,75k-100k,mobile,returning,West,87,True,32,1,0,False,False,True,22,1,0,6.748450293374858,10,0
user_000026,33,75k-100k,mobile,returning,West,75,True,32,3,0,True,True,True,30,3,0,9.063161300854086,2,0
user_000027,48,100k-150k,desktop,new,Midwest,79,True,118,1,0,True,True,True,65,1,0,6.955943093036154,53,0
user_000028,48,50k-75k,mobile,new,South,56,False,0,0,0,False,True,True,113,1,0,9.113894829613189,-113,-1
user_000029,48,30k-50k,mobile,returning,South,50,True,70,6,0,False,False,True,59,11,0,8.790331308524445,11,-5
user_000030,49,75k-100k,mobile,new,South,34,True,159,4,0,True,True,True,100,2,0,8.43737567341579,59,2
user_000031,27,<30k,mobile,returning,Midwest,64,True,77,6,0,False,True,True,87,5,1,5.670495378601664,-10,1
user_000032,59,75k-100k,mobile,new,Midwest,36,False,0,0,0,False,False,True,139,1,1,5.519915132180389,-139,-1
user_000033,31,75k-100k,desktop,new,East,57,True,140,3,0,True,True,True,85,3,0,8.94441988356907,55,0
user_000034,45,>150k,mobile,returning,Midwest,81,True,59,1,1,True,True,True,70,1,0,8.03775798136305,-11,0
user_000035,28,50k-75k,desktop,new,Midwest,72,False,0,0,0,False,True,True,106,1,0,7.8293821265629,-106,-1
user_000036,52,100k-150k,tablet,returning,East,63,True,103,3,1,True,True,True,78,3,0,9.54330665415142,25,0
user_000037,38,>150k,desktop,new,East,77,True,120,1,1,True,True,True,100,1,0,5.13549478927785,20,0
user_000038,31,30k-50k,desktop,returning,Midwest,67,True,30,1,0,False,True,True,60,1,0,9.464965823044643,-30,0
user_000039,50,75k-100k,tablet,new,East,58,True,156,3,0,False,True,True,113,1,0,5.114540568979533,43,2
user_000040,52,75k-100k,desktop,returning,East,57,True,114,5,0,False,False,True,81,4,0,7.266315115054821,33,1
user_000041,53,100k-150k,desktop,returning,East,82,True,124,2,1,True,True,True,91,2,0,9.273364120141617,33,0
user_000042,33,75k-100k,desktop,returning,East,66,True,101,3,0,True,True,True,82,5,0,7.685883730469237,19,-2
user_000043,55,50k-75k,mobile,returning,East,25,True,162,7,0,True,True,True,175,7,0,6.5185856018931245,-13,0
user_000044,45,<30k,mobile,returning,East,23,False,0,0,0,False,False,False,0,0,0,,0,0
user_000045,45,75k-100k,mobile,returning,West,50,True,119,5,0,False,False,True,133,2,0,10.0,-14,3
user_000046,18,50k-75k,desktop,returning,South,67,True,88,3,1,True,True,True,78,4,0,5.769275002028007,10,-1
user_000047,52,75k-100k,mobile,returning,West,72,True,83,4,0,False,True,True,75,2,0,9.297965070741894,8,2
user_000048,71,50k-75k,mobile,new,East,41,True,86,5,1,True,False,True,88,4,0,4.3172039730357294,-2,1
user_000049,76,75k-100k,mobile,returning,Midwest,45,True,59,1,0,True,True,True,50,2,0,8.27205402360868,9,-1
user_000050,51,50k-75k,mobile,returning,South,56,True,44,2,0,True,True,True,48,4,0,6.133551519390509,-4,-2
user_000051,41,50k-75k,mobile,returning,East,31,True,123,2,0,False,False,True,124,1,0,5.916894607493905,-1,1
user_000052,66,50k-75k,desktop,returning,West,23,True,163,3,0,True,False,True,182,2,0,9.989607967023382,-19,1
user_000053,47,50k-75k,desktop,returning,West,50,True,133,1,0,True,True,True,63,1,0,7.153071820285562,70,0
user_000054,68,<30k,desktop,returning,Midwest,1,False,0,0,0,True,False,True,117,1,0,6.784896805143395,-117,-1
user_000055,49,50k-75k,desktop,returning,East,40,True,116,2,0,True,False,True,132,1,0,6.479386778177804,-16,1
user_000056,36,<30k,mobile,returning,West,62,True,121,3,0,True,True,True,105,5,0,9.728895339230297,16,-2
user_000057,57,<30k,desktop,returning,South,29,True,127,3,0,True,False,True,117,1,0,10.0,10,2
user_000058,44,30k-50k,mobile,returning,South,46,False,0,0,0,True,True,True,65,1,0,5.721772363922514,-65,-1
user_000059,41,50k-75k,desktop,new,South,61,True,125,3,0,False,True,True,87,2,0,7.175459545713521,38,1
user_000060,64,75k-100k,desktop,new,South,30,False,0,0,0,True,False,True,131,3,0,8.00024681409095,-131,-3
user_000061,49,30k-50k,desktop,returning,West,58,True,83,4,0,True,False,True,83,5,0,8.919103341870356,0,-1
user_000062,29,>150k,desktop,returning,East,66,True,98,3,0,False,False,True,89,4,0,8.769626865738974,9,-1
user_000063,44,75k-100k,desktop,returning,South,31,True,89,3,0,True,True,True,67,3,0,9.18793884796225,22,0
user_000064,32,<30k,desktop,returning,South,50,True,84,1,0,False,True,True,43,1,0,8.01096881098716,41,0
user_000065,48,<30k,desktop,returning,West,42,True,114,1,1,True,True,True,112,1,0,8.668346699313416,2,0
user_000066,23,<30k,desktop,returning,West,48,True,60,1,0,True,False,False,0,0,0,,60,1
user_000067,34,100k-150k,desktop,returning,South,76,True,90,1,1,False,True,True,79,1,0,6.2716973416840816,11,0
user_000068,44,75k-100k,desktop,returning,South,29,True,174,6,0,True,False,True,147,2,0,4.976377820522917,27,4
user_000069,49,<30k,desktop,new,West,37,False,0,0,0,False,False,True,129,1,0,7.4718064225383465,-129,-1
user_000070,55,75k-100k,desktop,returning,East,43,True,66,5,0,True,False,True,58,3,0,7.456570552729276,8,2
user_000071,48,30k-50k,tablet,new,South,45,True,78,2,0,True,False,True,41,3,0,6.68561456770016,37,-1
user_000072,66,<30k,desktop,returning,East,39,True,69,4,0,True,True,True,72,3,0,10.0,-3,1
user_000073,77,50k-75k,desktop,returning,South,17,True,130,1,0,False,False,True,126,2,0,7.679181122062957,4,-1
user_000074,33,30k-50k,mobile,returning,East,72,False,0,0,0,False,True,True,82,1,0,6.86125832240735,-82,-1
user_000075,59,>150k,tablet,returning,East,41,True,80,1,0,False,True,True,55,1,0,8.499004203543272,25,0
user_000076,25,75k-100k,mobile,returning,South,92,True,51,6,0,True,True,True,48,4,0,10.0,3,2
user_000077,62,100k-150k,desktop,new,West,52,False,0,0,0,False,True,True,90,4,0,8.612331573402944,-90,-4
user_000078,43,>150k,mobile,returning,East,83,True,101,4,0,False,False,True,90,3,0,6.689894905247411,11,1
user_000079,45,50k-75k,mobile,new,South,45,True,55,3,0,True,True,True,69,3,0,7.065176694176017,-14,0
user_000080,28,75k-100k,desktop,returning,West,77,True,99,2,0,True,True,True,49,2,0,9.168963871177397,50,0
user_000081,21,>150k,desktop,new,Midwest,99,False,0,0,0,True,True,True,105,1,0,5.804440061303554,-105,-1
user_000082,62,<30k,desktop,returning,South,21,True,157,1,0,False,False,False,0,0,0,,157,1
user_000083,54,50k-75k,desktop,returning,East,70,True,85,1,1,True,True,True,41,1,0,9.436051816246009,44,0
user_000084,60,75k-100k,mobile,new,West,18,True,142,5,0,False,False,True,112,7,0,6.09814540018825,30,-2
user_000085,67,50k-75k,mobile,returning,East,36,True,59,3,0,True,True,True,28,1,0,7.79621637737221,31,2
user_000086,19,50k-75k,desktop,returning,South,64,True,92,3,0,False,False,True,86,2,0,8.980469134003432,6,1
user_000087,25,50k-75k,tablet,returning,East,80,True,148,3,0,True,True,False,0,0,0,,148,3
user_000088,50,<30k,mobile,new,West,35,False,0,0,0,False,True,False,0,0,0,,0,0
user_000089,30,30k-50k,mobile,returning,East,77,True,36,4,0,False,True,True,25,2,0,8.948345532842835,11,2
user_000090,43,30k-50k,mobile,new,East,34,True,114,3,1,False,False,False,0,0,0,,114,3
user_000091,34,30k-50k,mobile,returning,Midwest,68,False,0,0,0,True,True,True,122,2,1,8.552363648266395,-122,-2
user_000092,54,100k-150k,desktop,new,East,76,True,79,1,0,False,True,True,51,1,0,7.994063635515693,28,0
user_000093,22,30k-50k,mobile,returning,East,90,True,37,2,0,True,True,False,0,0,0,,37,2
user_000094,53,50k-75k,desktop,new,East,54,True,99,2,0,False,True,True,75,3,0,7.63895354553017,24,-1
user_000095,20,50k-75k,desktop,new,East,73,True,108,1,0,False,True,True,97,1,0,9.397920067858044,11,0
user_000096,35,30k-50k,mobile,new,East,33,True,165,5,0,True,False,True,159,10,0,4.558507831858899,6,-5
user_000097,44,<30k,desktop,returning,Midwest,57,True,98,7,0,False,False,True,85,3,0,6.848843255603754,13,4
user_000098,29,<30k,desktop,returning,Midwest,52,True,103,1,0,True,True,True,69,1,0,9.9067283941329,34,0
user_000099,24,30k-50k,mobile,returning,Midwest,73,True,70,1,0,True,True,True,57,1,1,10.0,13,0
user_000100,36,<30k,mobile,new,West,37,False,0,0,0,False,False,False,0,0,0,,0,0
user_000101,49,30k-50k,desktop,new,East,49,True,147,2,1,False,False,True,155,3,0,6.722897953335722,-8,-1
user_000102,36,<30k,mobile,returning,South,46,True,107,2,0,False,False,True,120,1,0,7.018617256051884,-13,1
user_000103,19,30k-50k,desktop,returning,Midwest,73,True,41,2,0,True,True,True,23,1,1,7.063829281732606,18,1
user_000104,20,75k-100k,mobile,new,East,70,True,130,1,0,True,True,True,101,1,0,6.740434796165101,29,0
user_000105,44,<30k,desktop,new,Midwest,16,False,0,0,0,False,False,False,0,0,0,,0,0
user_000106,60,50k-75k,mobile,new,West,36,True,73,6,0,False,False,False,0,0,0,,73,6
user_000107,18,30k-50k,desktop,returning,Midwest,53,True,112,3,0,True,True,True,116,2,0,6.2282436300538375,-4,1
user_000108,50,30k-50k,desktop,returning,South,35,True,108,5,0,False,False,False,0,0,0,,108,5
user_000109,62,100k-150k,mobile,new,Midwest,48,True,131,7,0,False,True,True,87,7,0,6.1113029456067185,44,0
user_000110,50,<30k,desktop,new,West,43,True,152,5,2,False,False,True,136,6,0,7.751408718031691,16,-1
user_000111,63,75k-100k,desktop,returning,South,23,True,112,5,0,False,True,True,108,4,0,7.8907089675763675,4,1
user_000112,45,50k-75k,mobile,returning,East,75,True,73,2,0,True,True,True,34,2,0,9.25201918842327,39,0
user_000113,48,30k-50k,desktop,returning,East,61,True,78,3,0,True,False,True,64,3,0,6.355134655074495,14,0
user_000114,50,<30k,desktop,returning,East,33,True,144,6,0,True,True,True,128,3,0,6.311667919384197,16,3
user_000115,38,75k-100k,desktop,returning,South,32,True,142,1,0,True,False,True,138,1,1,6.16690616328797,4,0
user_000116,52,30k-50k,desktop,new,Midwest,50,True,167,4,1,True,True,True,89,2,0,7.474506264868509,78,2
user_000117,40,30k-50k,desktop,new,South,30,True,146,1,1,False,False,True,138,1,0,6.099762619484806,8,0
user_000118,58,75k-100k,mobile,new,Midwest,50,True,101,2,0,False,False,True,97,3,0,7.176246786575151,4,-1
user_000119,18,75k-100k,desktop,new,East,92,False,0,0,0,False,True,False,0,0,0,,0,0
user_000120,80,50k-75k,desktop,new,Midwest,31,False,0,0,0,True,True,True,99,1,0,8.51401046079287,-99,-1
user_000121,52,<30k,desktop,returning,Midwest,38,True,84,1,0,True,True,True,37,1,0,7.835843714291191,47,0
user_000122,68,75k-100k,mobile,returning,Midwest,22,False,0,0,0,False,True,True,110,1,0,8.639848781479175,-110,-1
user_000123,45,100k-150k,desktop,returning,West,91,False,0,0,0,True,True,True,96,1,0,8.646826460726484,-96,-1
user_000124,29,50k-75k,mobile,new,East,45,True,73,3,0,True,True,True,57,4,0,7.8298909351669534,16,-1
user_000125,39,50k-75k,desktop,new,East,75,True,86,2,0,False,True,True,52,1,0,9.768718182162205,34,1
user_000126,18,30k-50k,desktop,new,West,79,True,105,1,0,False,True,True,74,2,0,9.334882746510676,31,-1
user_000127,40,100k-150k,mobile,returning,Midwest,43,True,97,2,0,False,True,True,101,2,0,8.252595558705805,-4,0
user_000128,45,<30k,tablet,returning,Midwest,34,True,58,3,0,False,True,False,0,0,0,,58,3
user_000129,44,30k-50k,desktop,new,West,51,True,174,7,0,False,False,True,182,10,0,6.097237054734267,-8,-3
user_000130,18,50k-75k,mobile,returning,East,86,True,94,5,0,True,True,True,100,6,0,7.412702682076772,-6,-1
user_000131,23,50k-75k,desktop,new,West,68,False,0,0,0,True,True,False,0,0,0,,0,0
user_000132,59,75k-100k,mobile,new,West,64,True,177,3,0,False,True,True,174,1,0,8.576644553393965,3,2
user_000133,37,<30k,mobile,new,Midwest,42,True,168,2,0,True,False,True,161,2,0,6.7505590190997,7,0
user_000134,55,75k-100k,mobile,new,West,66,True,131,3,0,True,False,True,136,5,0,5.970737838637299,-5,-2
user_000135,53,100k-150k,mobile,returning,West,70,True,84,4,0,True,True,True,94,1,0,10.0,-10,3
user_000136,49,<30k,mobile,new,West,31,False,0,0,0,True,False,False,0,0,0,,0,0
user_000137,34,50k-75k,desktop,returning,East,48,True,106,2,0,True,True,True,109,2,0,8.383747993467239,-3,0
user_000138,18,50k-75k,mobile,returning,East,95,True,106,1,0,True,True,False,0,0,0,,106,1
user_000139,44,30k-50k,desktop,returning,West,76,True,67,2,0,True,True,True,64,3,0,7.909641290811724,3,-1
user_000140,49,100k-150k,desktop,returning,West,49,True,116,4,0,True,True,True,92,4,0,7.502732249641721,24,0
user_000141,45,75k-100k,mobile,new,South,50,True,192,3,0,False,True,True,165,2,0,7.815313727630375,27,1
user_000142,47,30k-50k,mobile,new,South,30,True,126,2,0,True,True,True,125,1,0,9.33394658181045,1,1
user_000143,48,30k-50k,desktop,returning,South,59,True,72,2,0,False,True,True,73,3,1,8.991477787954961,-1,-1
user_000144,18,75k-100k,desktop,new,South,45,True,129,2,0,False,False,True,130,2,0,8.782341511463368,-1,0
user_000145,47,50k-75k,mobile,new,Midwest,33,True,114,1,0,False,False,True,142,1,0,8.326368027214734,-28,0
user_000146,30,30k-50k,mobile,new,East,85,True,120,2,1,False,True,True,96,2,0,5.856532765479114,24,0
user_000147,32,50k-75k,desktop,returning,South,75,True,117,5,0,False,False,False,0,0,0,,117,5
user_000148,80,<30k,mobile,returning,West,33,True,119,6,0,True,True,True,66,8,0,8.01030576620982,53,-2
user_000149,44,30k-50k,desktop,new,West,86,True,85,1,0,True,True,True,74,3,0,9.914177144542899,11,-2
user_000150,54,75k-100k,mobile,new,South,59,True,85,3,0,False,False,True,73,4,0,6.314449732409981,12,-1
user_000151,43,30k-50k,desktop,returning,West,69,True,114,4,0,True,False,True,120,6,0,6.2434109175716825,-6,-2
user_000152,53,30k-50k,desktop,returning,Midwest,61,True,114,5,0,True,False,True,110,3,0,7.46958327029949,4,2
user_000153,51,75k-100k,desktop,new,East,53,True,104,2,0,False,False,True,111,3,0,8.221891584295422,-7,-1
user_000154,28,30k-50k,desktop,returning,West,95,True,38,3,0,True,True,True,49,5,0,8.777657859811116,-11,-2
user_000155,45,100k-150k,tablet,returning,East,65,True,81,7,0,True,True,True,59,2,0,10.0,22,5
user_000156,38,30k-50k,desktop,new,Midwest,40,False,0,0,0,False,True,True,93,1,1,5.113916540107748,-93,-1
user_000157,42,<30k,desktop,new,Midwest,28,True,181,4,0,False,False,True,201,3,0,6.97146457688494,-20,1
user_000158,49,50k-75k,desktop,new,Midwest,58,True,122,1,0,False,False,True,128,1,0,6.008906391925413,-6,0
user_000159,46,30k-50k,mobile,returning,West,75,True,63,6,0,True,True,True,44,5,0,8.542736489145463,19,1
user_000160,37,100k-150k,desktop,returning,East,86,True,30,3,0,False,True,True,35,4,1,7.902282354462197,-5,-1
user_000161,38,50k-75k,desktop,returning,South,66,True,82,3,0,True,True,True,68,3,0,7.917384373406323,14,0
user_000162,24,50k-75k,desktop,new,West,66,True,157,2,0,True,True,True,144,1,0,7.296689995736449,13,1
user_000163,44,30k-50k,mobile,new,West,63,True,118,2,1,False,True,True,69,2,1,6.978609923264644,49,0
user_000164,59,50k-75k,desktop,new,South,26,True,85,5,0,True,False,True,141,6,0,4.3310614148097155,-56,-1
user_000165,47,100k-150k,desktop,returning,West,82,True,50,2,0,True,True,True,49,3,0,9.134452683682076,1,-1
user_000166,35,75k-100k,desktop,new,West,51,True,132,2,0,False,False,True,154,1,0,8.930330882343121,-22,1
user_000167,66,75k-100k,mobile,new,South,21,True,172,3,0,True,True,True,96,1,0,8.820995850330746,76,2
user_000168,48,75k-100k,mobile,returning,West,37,True,87,4,0,False,False,True,87,4,0,7.5223122972531575,0,0
user_000169,35,50k-75k,desktop,new,South,39,True,104,9,0,False,False,True,68,5,0,7.549208234956577,36,4
user_000170,54,100k-150k,tablet,returning,South,90,True,74,4,0,True,True,True,35,3,0,7.590466388756354,39,1
user_000171,44,<30k,mobile,returning,East,66,True,127,3,0,True,True,True,156,1,0,7.106773921242953,-29,2
user_000172,44,<30k,mobile,returning,West,67,False,0,0,0,False,True,True,66,1,0,6.142142312709072,-66,-1
user_000173,55,50k-75k,desktop,returning,East,77,True,44,5,1,True,False,True,68,3,0,8.473636251529761,-24,2
user_000174,57,30k-50k,desktop,returning,Midwest,37,True,128,3,0,True,False,True,114,1,0,6.362737315322106,14,2
user_000175,42,75k-100k,desktop,returning,South,47,True,30,1,0,False,False,True,37,1,0,6.107225895381013,-7,0
user_000176,45,30k-50k,desktop,new,South,64,False,0,0,0,True,True,True,82,1,0,8.685549764908867,-82,-1
user_000177,24,<30k,mobile,returning,South,66,True,127,1,0,True,True,True,69,1,0,7.721190109744716,58,0
user_000178,48,75k-100k,desktop,returning,West,83,True,58,3,0,True,True,True,69,3,0,7.843024361425138,-11,0
user_000179,38,>150k,mobile,returning,South,62,True,74,1,0,True,True,True,101,1,0,8.25753190619141,-27,0
user_000180,62,30k-50k,desktop,new,Midwest,7,False,0,0,0,False,False,True,116,1,0,3.720583344157822,-116,-1
user_000181,36,<30k,desktop,returning,South,40,True,38,4,1,False,True,False,0,0,0,,38,4
user_000182,68,75k-100k,mobile,new,East,34,True,164,4,1,True,False,True,161,4,0,6.812479963808624,3,0
user_000183,23,75k-100k,mobile,new,South,32,True,145,1,0,True,True,True,130,1,0,10.0,15,0
user_000184,48,30k-50k,desktop,returning,West,51,True,78,2,0,True,True,True,23,3,0,6.967125003925594,55,-1
user_000185,54,75k-100k,mobile,returning,West,58,True,108,1,0,True,True,True,63,1,0,7.044723034735239,45,0
user_000186,44,50k-75k,desktop,returning,East,53,True,111,1,0,True,True,True,71,1,0,9.58660057546535,40,0
user_000187,26,100k-150k,mobile,new,West,100,True,115,4,0,True,True,True,90,5,0,7.815493559385168,25,-1
user_000188,50,100k-150k,desktop,returning,West,81,True,35,4,0,True,True,True,41,5,0,7.666777766699649,-6,-1
user_000189,47,75k-100k,desktop,returning,Midwest,55,True,78,5,0,False,False,True,105,7,0,7.351081666073951,-27,-2
user_000190,34,75k-100k,desktop,new,West,100,True,93,3,0,False,True,True,52,1,0,8.46801738425074,41,2
user_000191,57,30k-50k,desktop,new,Midwest,20,False,0,0,0,True,False,True,129,2,0,7.47981542855383,-129,-2
user_000192,38,30k-50k,desktop,new,West,23,False,0,0,0,False,False,True,159,1,0,7.67149621265786,-159,-1
user_000193,30,75k-100k,mobile,returning,South,64,True,134,1,0,True,True,True,121,1,1,9.20448276461414,13,0
user_000194,67,30k-50k,tablet,new,East,48,False,0,0,0,False,False,True,100,2,0,7.822551620942066,-100,-2
user_000195,41,50k-75k,mobile,new,East,39,True,128,4,0,False,False,True,98,2,1,8.571983788753883,30,2
user_000196,71,<30k,mobile,returning,West,44,False,0,0,0,False,False,True,81,2,0,6.541921033070005,-81,-2
user_000197,65,100k-150k,mobile,new,West,73,True,127,4,0,True,False,True,136,8,1,6.466428504363471,-9,-4
user_000198,55,<30k,desktop,new,East,45,False,0,0,0,True,True,True,87,1,0,8.184408824677027,-87,-1
user_000199,64,75k-100k,desktop,new,South,32,True,170,2,0,False,False,True,180,1,0,6.131101363737284,-10,1
user_000200,35,50k-75k,desktop,returning,Midwest,37,True,81,3,0,True,True,True,80,4,0,8.874014255683452,1,-1
user_000201,52,100k-150k,mobile,returning,East,56,True,30,3,0,False,False,True,20,4,0,7.206762996356224,10,-1
user_000202,45,75k-100k,desktop,returning,Midwest,46,False,0,0,0,True,False,True,121,1,0,8.4307585366471,-121,-1
user_000203,41,30k-50k,desktop,new,West,34,False,0,0,0,False,True,False,0,0,0,,0,0
user_000204,26,100k-150k,desktop,returning,East,63,True,66,1,0,False,True,True,56,1,0,9.166936382265176,10,0
user_000205,70,>150k,mobile,returning,Midwest,38,True,90,3,0,False,True,True,91,5,0,7.403174754303088,-1,-2
user_000206,54,50k-75k,desktop,returning,East,26,True,165,2,0,True,True,True,108,1,0,9.60398882931078,57,1
user_000207,35,100k-150k,mobile,returning,Midwest,65,True,124,2,0,True,True,True,72,1,1,7.511345950146692,52,1
user_000208,44,75k-100k,desktop,new,West,77,True,40,1,0,False,True,True,32,1,0,8.663459932063164,8,0
user_000209,62,30k-50k,desktop,returning,East,8,True,151,3,0,True,True,True,122,2,0,6.954568363990844,29,1
user_000210,25,30k-50k,mobile,returning,East,87,True,31,1,0,False,True,True,40,1,0,8.573589396450874,-9,0
user_000211,46,75k-100k,mobile,returning,East,30,False,0,0,0,False,False,True,102,1,0,8.47542443163986,-102,-1
user_000212,67,30k-50k,desktop,returning,West,57,True,67,1,0,False,False,True,87,1,0,5.6816899090977415,-20,0
user_000213,40,30k-50k,mobile,new,Midwest,76,True,90,1,0,False,True,True,89,2,0,7.295623574672496,1,-1
user_000214,41,100k-150k,desktop,returning,South,57,True,83,5,0,True,True,True,86,2,0,9.525828977184727,-3,3
user_000215,55,30k-50k,mobile,returning,South,43,True,55,2,0,False,False,True,34,1,0,8.201699667171964,21,1
user_000216,58,30k-50k,desktop,new,West,50,True,154,5,0,True,False,True,154,3,0,7.226075389187668,0,2
user_000217,61,50k-75k,desktop,returning,Midwest,14,True,161,1,1,False,False,True,118,1,0,6.524875076664038,43,0
user_000218,35,30k-50k,desktop,returning,West,88,True,80,1,0,True,True,True,104,1,1,7.239537031170725,-24,0
user_000219,47,100k-150k,mobile,returning,South,65,True,43,2,0,False,True,True,49,1,0,8.838182545035728,-6,1
user_000220,61,50k-75k,desktop,returning,Midwest,47,True,97,4,0,True,True,True,51,5,0,7.548877136103705,46,-1
user_000221,49,30k-50k,desktop,returning,Midwest,33,True,49,4,0,True,True,True,53,2,0,5.693223073455242,-4,2
user_000222,49,>150k,mobile,returning,East,71,True,65,4,0,True,True,True,84,3,0,9.35205702366334,-19,1
user_000223,62,50k-75k,desktop,returning,East,16,False,0,0,0,True,False,False,0,0,0,,0,0
user_000224,42,100k-150k,desktop,returning,East,66,True,102,1,0,True,True,True,57,1,0,8.280419345184773,45,0
user_000225,68,50k-75k,mobile,new,East,22,True,162,5,1,False,False,True,161,3,0,4.429942733234201,1,2
user_000226,69,50k-75k,mobile,new,East,50,True,179,2,0,False,False,True,149,2,0,8.42701535243522,30,0
user_000227,18,75k-100k,desktop,returning,South,99,True,46,3,0,True,True,True,37,3,0,9.468686143991874,9,0
user_000228,60,<30k,mobile,returning,East,61,True,105,1,0,True,True,True,73,1,0,8.97278302349453,32,0
user_000229,56,75k-100k,desktop,returning,Midwest,34,True,68,4,0,False,False,True,96,5,0,7.220190079545373,-28,-1
user_000230,33,30k-50k,desktop,new,South,60,True,96,1,0,True,True,True,96,1,0,7.242018170583627,0,0
user_000231,47,50k-75k,mobile,new,East,70,False,0,0,0,False,True,True,91,1,0,9.463243162889666,-91,-1
user_000232,30,30k-50k,desktop,returning,East,66,True,76,1,0,True,True,True,94,1,0,7.0229063456801315,-18,0
user_000233,35,30k-50k,desktop,new,East,54,False,0,0,0,False,False,False,0,0,0,,0,0
user_000234,48,50k-75k,mobile,returning,East,70,True,106,1,0,True,False,True,93,3,0,8.097345971301333,13,-2
user_000235,45,<30k,desktop,returning,Midwest,35,True,65,5,1,False,False,True,117,5,0,7.062248056865214,-52,0
user_000236,26,30k-50k,mobile,returning,East,59,True,84,2,0,False,False,True,112,3,0,8.127887983998912,-28,-1
user_000237,34,75k-100k,mobile,returning,East,74,True,37,2,0,False,True,True,68,1,0,8.72984796064445,-31,1
user_000238,54,75k-100k,desktop,returning,West,66,True,124,5,1,True,False,True,108,3,0,6.536434601826512,16,2
user_000239,59,30k-50k,mobile,new,Midwest,63,True,103,3,0,False,False,True,82,5,0,8.005301988263767,21,-2
user_000240,32,30k-50k,mobile,returning,East,94,True,90,1,0,True,True,True,53,2,0,9.138578804336571,37,-1
user_000241,53,50k-75k,desktop,returning,South,69,True,55,1,0,True,True,True,28,1,0,7.212841830418761,27,0
user_000242,36,30k-50k,mobile,new,South,29,True,192,2,0,False,False,True,209,1,0,7.084384042206849,-17,1
user_000243,48,30k-50k,mobile,new,East,26,True,148,4,0,True,False,True,109,3,0,8.37414936679986,39,1
user_000244,63,100k-150k,desktop,returning,East,31,True,77,3,0,True,True,True,74,4,0,6.695311593506402,3,-1
user_000245,34,>150k,desktop,returning,Midwest,79,True,73,2,1,False,True,True,49,1,0,6.104729089319334,24,1
user_000246,47,50k-75k,tablet,new,Midwest,23,True,189,1,0,False,True,True,128,1,0,8.860494844395397,61,0
user_000247,61,<30k,desktop,returning,East,34,True,30,2,0,True,True,True,20,1,0,10.0,10,1
user_000248,63,100k-150k,mobile,returning,West,62,True,93,3,0,True,False,True,90,5,0,7.3019033219963445,3,-2
user_000249,47,50k-75k,desktop,new,South,42,True,135,4,0,False,True,True,105,4,0,7.588752135664084,30,0
user_000250,33,75k-100k,desktop,new,East,50,True,121,2,1,False,True,True,127,1,0,9.64481569731579,-6,1
user_000251,28,<30k,desktop,returning,East,27,True,131,6,0,True,False,True,137,9,1,6.386889084265858,-6,-3
user_000252,46,75k-100k,desktop,returning,East,48,True,30,2,0,True,True,True,49,1,0,8.404321196172862,-19,1
user_000253,34,50k-75k,desktop,returning,South,79,True,103,5,0,False,True,True,119,5,0,8.256420879900897,-16,0
user_000254,45,<30k,mobile,new,Midwest,34,True,65,4,0,True,True,True,20,2,0,8.312566098885057,45,2
user_000255,44,75k-100k,desktop,new,South,57,True,88,1,0,False,False,True,102,2,0,6.352945183127742,-14,-1
user_000256,29,75k-100k,desktop,new,East,65,True,146,5,0,True,False,True,154,5,1,7.382028183054749,-8,0
user_000257,45,50k-75k,mobile,new,West,67,True,87,2,0,True,False,True,82,1,0,8.157751594472748,5,1
user_000258,30,>150k,mobile,new,East,82,True,101,3,0,False,True,True,65,4,0,8.911627077469587,36,-1
user_000259,41,75k-100k,mobile,returning,Midwest,67,True,79,3,1,False,False,True,49,1,0,5.3926362700506925,30,2
user_000260,35,<30k,tablet,new,Midwest,30,True,111,4,0,True,True,True,84,3,0,9.697571200994417,27,1
user_000261,51,75k-100k,mobile,returning,South,62,True,129,4,0,True,True,True,100,4,0,7.58549215654875,29,0
user_000262,24,30k-50k,desktop,returning,East,66,True,69,2,0,False,True,True,32,1,0,9.495168414615735,37,1
user_000263,36,50k-75k,mobile,returning,Midwest,6,True,102,2,1,False,False,True,98,2,0,7.4189239982363135,4,0
user_000264,22,<30k,mobile,returning,West,72,False,0,0,0,False,True,True,110,1,0,7.503876611336615,-110,-1
user_000265,44,<30k,mobile,returning,South,43,False,0,0,0,False,False,True,97,2,0,5.958553642982055,-97,-2
user_000266,44,<30k,desktop,returning,South,21,True,149,1,1,True,True,True,80,1,0,8.404874552677349,69,0
user_000267,24,30k-50k,mobile,returning,East,45,True,79,5,0,True,True,True,43,6,0,8.229545912163504,36,-1
user_000268,34,50k-75k,desktop,returning,South,80,True,71,6,0,False,True,True,64,3,0,6.655968047162686,7,3
user_000269,77,75k-100k,mobile,new,South,20,True,163,4,0,False,False,True,154,4,0,7.924177212361844,9,0
user_000270,45,75k-100k,desktop,returning,Midwest,33,True,43,6,0,False,False,True,20,4,0,8.909553278492693,23,2
user_000271,39,30k-50k,desktop,returning,Midwest,47,True,71,1,0,True,True,True,20,1,0,8.407226975307465,51,0
user_000272,24,<30k,mobile,returning,Midwest,40,True,119,5,0,False,False,False,0,0,0,,119,5
user_000273,62,30k-50k,desktop,returning,West,55,True,72,3,0,True,True,True,81,1,0,8.339663794710384,-9,2
user_000274,59,30k-50k,mobile,new,South,18,False,0,0,0,False,False,True,131,2,0,7.75205078863256,-131,-2
user_000275,64,75k-100k,mobile,new,West,53,True,116,6,0,False,True,True,76,4,0,8.83511852112902,40,2
user_000276,35,75k-100k,desktop,new,South,58,True,130,2,0,False,False,True,131,1,0,6.756817475810173,-1,1
user_000277,53,>150k,desktop,returning,Midwest,76,True,59,2,0,False,False,True,58,1,0,8.888200537244387,1,1
user_000278,29,<30k,mobile,returning,West,40,True,121,5,0,False,True,True,95,7,0,9.334520743065607,26,-2
user_000279,41,50k-75k,desktop,returning,West,55,True,116,1,0,False,True,True,89,2,0,6.414929260992607,27,-1
user_000280,42,100k-150k,desktop,new,South,64,True,110,4,1,False,False,True,113,2,0,8.387208003341353,-3,2
user_000281,54,75k-100k,desktop,returning,Midwest,62,True,102,2,0,True,True,True,79,2,0,8.594046397178488,23,0
user_000282,50,30k-50k,desktop,returning,South,35,True,91,4,0,False,True,True,31,2,0,6.509300922237053,60,2
user_000283,49,100k-150k,mobile,returning,South,85,True,30,4,0,True,True,True,20,4,0,8.370139376846781,10,0
user_000284,56,50k-75k,desktop,new,Midwest,35,False,0,0,0,False,True,True,113,1,0,8.824480483563343,-113,-1
user_000285,41,75k-100k,desktop,new,East,37,True,66,5,0,False,False,False,0,0,0,,66,5
user_000286,27,100k-150k,mobile,returning,Midwest,86,True,84,1,0,False,True,True,85,1,0,10.0,-1,0
user_000287,33,50k-75k,desktop,returning,West,89,False,0,0,0,True,False,True,72,2,0,7.73118183917763,-72,-2
user_000288,55,>150k,mobile,new,West,69,True,140,3,0,True,True,True,125,1,0,10.0,15,2
user_000289,48,>150k,mobile,returning,Midwest,73,True,66,4,1,True,True,True,48,3,0,6.885098459276503,18,1
user_000290,22,50k-75k,mobile,returning,West,98,True,56,5,0,False,True,True,34,3,0,8.250233866401024,22,2
user_000291,36,75k-100k,mobile,returning,East,52,True,98,1,0,True,False,True,110,1,0,9.372393108867234,-12,0
user_000292,60,50k-75k,desktop,returning,Midwest,38,True,73,2,0,True,False,True,79,2,0,6.3778608244287245,-6,0
user_000293,42,30k-50k,desktop,returning,West,53,True,36,4,0,True,True,True,31,3,0,7.8979121902098415,5,1
user_000294,27,75k-100k,desktop,returning,East,67,False,0,0,0,True,True,True,89,2,0,6.22508098708154,-89,-2
user_000295,67,30k-50k,mobile,new,West,54,True,134,2,1,False,False,True,136,3,0,6.598347480564576,-2,-1
user_000296,63,>150k,desktop,returning,East,58,True,104,1,1,False,True,True,80,1,2,7.8216605131077035,24,0
user_000297,73,<30k,mobile,returning,East,48,True,75,1,0,False,True,True,26,1,0,7.165820770307753,49,0
user_000298,47,30k-50k,mobile,new,West,33,False,0,0,0,False,False,True,135,1,0,7.414936813642161,-135,-1
user_000299,52,30k-50k,desktop,new,East,42,False,0,0,0,False,True,True,71,2,0,9.396231031551592,-71,-2
user_000300,44,50k-75k,desktop,new,West,86,True,70,2,0,False,False,True,46,2,0,7.193459482342181,24,0
user_000301,30,50k-75k,desktop,returning,West,84,True,39,4,0,True,True,True,45,4,0,8.589200304076696,-6,0
user_000302,43,75k-100k,desktop,returning,West,56,True,52,1,0,False,False,True,56,2,0,8.380178274654229,-4,-1
user_000303,58,30k-50k,mobile,returning,West,32,False,0,0,0,True,True,True,64,1,0,6.1274022105507715,-64,-1
user_000304,18,50k-75k,desktop,new,East,83,True,46,1,1,False,True,True,27,2,0,8.033915488573175,19,-1
user_000305,46,30k-50k,desktop,new,Midwest,52,True,118,3,0,False,False,True,117,5,0,8.443437301214532,1,-2
user_000306,56,100k-150k,mobile,returning,East,31,True,95,4,0,False,True,True,59,1,0,8.621862740534494,36,3
user_000307,20,30k-50k,desktop,returning,South,82,True,78,2,0,True,True,True,25,3,0,5.438113389259302,53,-1
user_000308,48,<30k,mobile,new,East,57,True,87,5,0,False,True,True,72,6,0,10.0,15,-1
user_000309,47,50k-75k,mobile,returning,Midwest,39,True,128,1,0,True,True,True,114,1,0,6.439157876295028,14,0
user_000310,51,50k-75k,mobile,returning,East,63,True,56,2,0,True,True,False,0,0,0,,56,2
user_000311,45,50k-75k,mobile,returning,East,39,True,58,4,0,False,False,True,82,1,0,7.210546131158487,-24,3
user_000312,35,100k-150k,desktop,new,South,48,True,118,2,0,False,True,True,119,1,0,9.438371130794556,-1,1
user_000313,49,30k-50k,mobile,returning,East,46,True,129,5,0,False,True,True,95,4,0,9.67907354008539,34,1
user_000314,58,100k-150k,desktop,new,East,48,True,100,5,0,False,False,True,82,4,0,7.048160904303528,18,1
user_000315,38,50k-75k,desktop,new,Midwest,62,False,0,0,0,False,False,True,153,1,0,4.708723543932994,-153,-1
user_000316,58,75k-100k,tablet,new,East,24,True,143,9,0,False,False,True,103,9,0,5.422625130453941,40,0
user_000317,46,50k-75k,desktop,returning,East,62,True,122,3,0,False,True,True,85,1,0,7.792327278769065,37,2
user_000318,39,30k-50k,desktop,returning,East,43,True,70,2,1,False,False,True,77,2,0,5.288026067319937,-7,0
user_000319,75,30k-50k,desktop,returning,West,28,True,102,5,0,True,True,True,122,1,0,6.978939093153322,-20,4
user_000320,43,<30k,desktop,returning,East,46,True,112,2,0,False,False,True,113,4,0,7.7714884240652,-1,-2
user_000321,42,>150k,desktop,returning,West,89,True,34,5,1,True,True,True,27,9,0,9.832256560096408,7,-4
user_000322,53,30k-50k,mobile,returning,East,54,True,40,4,0,False,True,True,20,3,0,6.413183078380046,20,1
user_000323,47,<30k,desktop,new,South,54,True,165,1,0,False,False,True,147,1,1,8.214469659933687,18,0
user_000324,18,75k-100k,mobile,returning,South,55,True,72,1,0,False,True,True,94,1,0,9.854285255316423,-22,0
user_000325,57,50k-75k,desktop,new,West,53,False,0,0,0,False,False,True,96,1,0,7.219345076952785,-96,-1
user_000326,69,<30k,mobile,new,East,20,True,141,5,1,False,False,True,116,5,0,7.2397926564718125,25,0
user_000327,51,75k-100k,desktop,returning,South,44,True,150,1,0,False,False,True,168,1,0,7.26600352324005,-18,0
user_000328,38,75k-100k,mobile,returning,East,53,True,128,5,0,False,True,True,83,4,1,7.570411478703997,45,1
user_000329,58,30k-50k,desktop,new,South,9,True,167,2,0,False,False,True,148,3,0,6.711997537153867,19,-1
user_000330,52,75k-100k,desktop,new,West,62,True,57,2,0,False,False,True,48,2,0,7.776789510250028,9,0
user_000331,51,100k-150k,desktop,returning,Midwest,56,True,30,1,0,True,True,True,20,1,0,7.670426181725794,10,0
user_000332,61,75k-100k,desktop,new,East,33,False,0,0,0,True,False,True,117,3,0,5.164845589947289,-117,-3
user_000333,36,50k-75k,mobile,returning,West,58,True,90,2,1,False,False,True,84,2,0,6.318651743305227,6,0
user_000334,52,75k-100k,desktop,new,South,41,True,38,1,0,False,True,True,50,1,1,5.75927173803767,-12,0
user_000335,30,75k-100k,desktop,new,South,81,True,81,2,0,False,True,True,81,1,0,6.702058260546278,0,1
user_000336,50,100k-150k,mobile,returning,West,100,True,67,3,0,True,True,True,65,3,0,8.321563408662644,2,0
user_000337,56,<30k,mobile,new,East,0,True,142,2,0,True,False,False,0,0,0,,142,2
user_000338,59,30k-50k,mobile,returning,West,70,True,98,4,0,True,True,True,78,2,0,8.944974445527714,20,2
user_000339,46,100k-150k,mobile,new,West,92,True,130,2,1,False,True,True,98,3,0,7.341189670829217,32,-1
user_000340,59,<30k,desktop,returning,West,42,True,117,2,0,False,False,True,148,3,0,4.858076504540536,-31,-1
user_000341,35,100k-150k,desktop,returning,East,37,True,77,4,0,False,True,True,35,2,0,6.215168099929109,42,2
user_000342,69,75k-100k,desktop,returning,East,54,True,118,3,0,True,True,True,111,1,0,9.288346332689086,7,2
user_000343,41,50k-75k,desktop,new,East,37,False,0,0,0,False,True,False,0,0,0,,0,0
user_000344,45,50k-75k,desktop,returning,Midwest,70,True,82,1,0,True,True,True,61,1,1,7.292370007566504,21,0
user_000345,35,75k-100k,mobile,new,East,49,True,106,2,1,True,True,True,93,4,0,9.202701686295221,13,-2
user_000346,23,<30k,mobile,returning,East,58,True,93,3,0,True,True,False,0,0,0,,93,3
user_000347,40,75k-100k,mobile,new,East,38,True,145,7,1,False,False,True,144,8,0,5.675280509847933,1,-1
user_000348,42,100k-150k,desktop,returning,East,75,True,72,5,0,True,False,True,70,5,1,7.80361018401335,2,0
user_000349,61,<30k,desktop,new,East,25,True,196,4,0,False,False,True,150,8,0,6.260890364942241,46,-4
user_000350,34,50k-75k,desktop,returning,West,57,True,75,3,0,True,True,True,34,4,0,6.6162988019122615,41,-1
user_000351,21,50k-75k,mobile,returning,Midwest,78,True,56,1,0,False,True,True,64,1,0,10.0,-8,0
user_000352,37,100k-150k,tablet,returning,West,77,True,38,4,0,True,True,True,28,4,0,7.35413707434042,10,0
user_000353,40,30k-50k,mobile,returning,Midwest,31,True,81,9,0,True,False,True,75,11,1,7.234113916454063,6,-2
user_000354,43,50k-75k,mobile,new,East,51,False,0,0,0,False,True,False,0,0,0,,0,0
user_000355,28,<30k,mobile,returning,Midwest,76,True,72,2,0,True,True,False,0,0,0,,72,2
user_000356,59,50k-75k,mobile,returning,South,34,False,0,0,0,True,False,True,110,1,0,9.212539044224245,-110,-1
user_000357,27,75k-100k,mobile,returning,West,81,True,50,5,0,True,True,True,20,1,0,9.04359574179491,30,4
user_000358,36,<30k,mobile,new,East,41,True,122,3,0,False,True,True,77,2,0,9.054965988847448,45,1
user_000359,59,<30k,desktop,new,Midwest,26,True,159,5,0,False,False,True,121,6,0,6.099356783842037,38,-1
user_000360,60,75k-100k,mobile,returning,East,24,True,139,1,0,False,False,True,130,1,0,6.19026058304519,9,0
user_000361,42,50k-75k,desktop,returning,South,57,True,160,1,0,True,True,True,141,1,0,8.109561405271602,19,0
user_000362,60,30k-50k,desktop,returning,Midwest,46,True,68,4,1,True,False,True,79,3,1,6.81917657794162,-11,1
user_000363,40,50k-75k,mobile,returning,West,71,True,30,2,0,True,True,True,20,1,0,8.77471860171553,10,1
user_000364,36,30k-50k,mobile,returning,Midwest,41,True,107,2,0,True,True,True,94,4,0,4.817806324346061,13,-2
user_000365,26,50k-75k,mobile,returning,Midwest,56,True,104,2,0,False,False,True,127,1,0,6.269946044380513,-23,1
user_000366,37,>150k,desktop,returning,West,74,True,30,3,0,False,True,False,0,0,0,,30,3
user_000367,43,50k-75k,tablet,returning,West,54,True,80,2,0,False,False,True,56,1,0,9.586584064540553,24,1
user_000368,53,30k-50k,mobile,returning,East,45,True,90,3,1,False,True,True,64,4,0,8.324412851337836,26,-1
user_000369,62,<30k,tablet,new,South,25,False,0,0,0,True,False,True,104,1,0,6.665337715785688,-104,-1
user_000370,21,>150k,mobile,returning,East,68,True,94,4,0,True,True,True,33,9,1,10.0,61,-5
user_000371,54,50k-75k,mobile,returning,East,57,True,147,5,0,True,True,True,117,6,0,10.0,30,-1
user_000372,42,50k-75k,mobile,new,West,52,True,124,4,0,False,False,False,0,0,0,,124,4
user_000373,28,30k-50k,tablet,returning,East,73,True,135,2,0,True,True,True,69,2,0,6.995629695619273,66,0
user_000374,61,50k-75k,desktop,returning,East,64,False,0,0,0,True,False,True,94,1,1,7.481714344199896,-94,-1
user_000375,80,75k-100k,mobile,returning,West,22,False,0,0,0,False,False,True,136,2,1,6.966984315284563,-136,-2
user_000376,61,30k-50k,tablet,returning,Midwest,31,True,112,5,0,True,False,True,101,3,0,6.2701001595272805,11,2
user_000377,54,<30k,desktop,new,South,29,True,151,3,0,True,False,True,138,2,0,6.366262230317801,13,1
user_000378,61,100k-150k,mobile,returning,South,44,True,87,4,0,False,True,True,96,1,1,9.244953324210767,-9,3
user_000379,36,50k-75k,mobile,new,West,80,True,110,1,0,False,False,True,118,1,0,7.981448596179595,-8,0
user_000380,44,50k-75k,desktop,returning,South,49,True,85,1,1,True,True,False,0,0,0,,85,1
user_000381,42,100k-150k,desktop,returning,South,57,True,126,2,0,True,True,True,98,2,0,8.778658311084607,28,0
user_000382,53,100k-150k,mobile,returning,South,15,True,179,6,0,True,True,True,154,2,0,8.203094485782758,25,4
user_000383,61,75k-100k,desktop,new,East,49,True,98,5,0,True,False,True,115,8,1,10.0,-17,-3
user_000384,35,75k-100k,mobile,new,East,62,True,119,4,0,True,True,True,136,6,0,8.25302716763799,-17,-2
user_000385,59,30k-50k,tablet,new,South,37,True,116,6,0,False,True,True,71,5,0,8.84465711338911,45,1
user_000386,35,30k-50k,mobile,returning,South,51,True,30,5,0,False,False,True,50,3,0,8.923641641092505,-20,2
user_000387,50,75k-100k,desktop,returning,South,61,True,80,2,0,True,True,True,107,2,0,8.634694838098332,-27,0
user_000388,34,<30k,desktop,new,East,57,True,101,3,0,False,True,True,97,1,0,7.858799237368576,4,2
user_000389,18,30k-50k,mobile,returning,South,68,True,99,3,0,True,True,True,70,5,0,9.75857671236156,29,-2
user_000390,20,<30k,desktop,returning,Midwest,43,True,101,2,0,True,True,True,70,3,0,7.44326243661871,31,-1
user_000391,57,30k-50k,mobile,returning,South,27,True,75,4,1,False,False,True,65,4,0,5.478506211427409,10,0
user_000392,45,30k-50k,desktop,new,Midwest,49,True,101,3,0,False,False,True,130,4,0,5.675721793166945,-29,-1
user_000393,18,50k-75k,desktop,new,South,67,True,107,3,1,True,True,False,0,0,0,,107,3
user_000394,57,50k-75k,desktop,new,Midwest,15,False,0,0,0,True,True,True,120,1,0,7.333663403713604,-120,-1
user_000395,50,100k-150k,desktop,returning,East,57,True,112,2,0,False,True,True,97,2,0,8.069855272502068,15,0
user_000396,37,30k-50k,desktop,new,West,62,True,135,2,1,True,True,True,121,1,0,8.88144813659077,14,1
user_000397,40,75k-100k,mobile,new,East,52,True,136,1,0,False,True,True,106,1,0,8.377206419757716,30,0
user_000398,35,100k-150k,mobile,new,Midwest,55,False,0,0,0,False,True,True,100,2,0,5.7970774925874915,-100,-2
user_000399,48,50k-75k,mobile,returning,East,52,True,116,1,1,False,False,True,113,1,1,6.479095759580897,3,0
