user_id,age,income_bracket,device_type,user_type,region,tech_savviness,filed_2023,time_to_complete_2023,sessions_2023,support_tickets_2023,early_login_2024,used_smart_assistant,filed_2024,time_to_complete_2024,sessions_2024,support_tickets_2024,satisfaction_2024,time_improvement,session_improvement
user_000000,41,50k-75k,tablet,returning,Midwest,41,True,113,3,0,False,True,True,75,1,0,9.61933100676659,38,2
user_000001,37,<30k,desktop,returning,Midwest,43,True,54,1,0,False,False,True,38,3,0,7.416109846573303,16,-2
user_000002,19,30k-50k,mobile,new,East,61,True,62,2,0,False,False,True,60,1,0,7.508820809903639,2,1
user_000003,66,75k-100k,mobile,new,East,31,True,99,3,0,True,True,True,59,6,0,6.923858737133103,40,-3
user_000004,27,30k-50k,desktop,returning,West,85,True,57,3,0,True,True,False,0,0,0,,57,3
user_000005,35,<30k,desktop,returning,South,30,True,60,4,0,False,False,True,52,4,0,8.327434766596102,8,0
user_000006,57,75k-100k,mobile,new,East,16,False,0,0,0,False,False,True,85,3,0,7.738929708828464,-85,-3
user_000007,56,30k-50k,desktop,returning,West,47,True,97,2,0,False,False,True,103,2,0,9.275161039253707,-6,0
user_000008,22,<30k,mobile,new,East,49,True,101,4,0,True,True,False,0,0,0,,101,4
user_000009,49,100k-150k,mobile,new,East,59,False,0,0,0,False,True,True,69,1,0,6.293529803398482,-69,-1
user_000010,60,<30k,tablet,returning,West,48,True,38,2,0,False,True,True,33,2,0,9.709340593888728,5,0
user_000011,49,75k-100k,mobile,returning,West,74,True,106,4,0,False,True,True,78,3,0,7.03210227730732,28,1
user_000012,57,30k-50k,mobile,new,East,55,True,120,2,0,False,True,True,103,3,0,7.142389052259114,17,-1
user_000013,50,100k-150k,desktop,new,Midwest,83,True,30,3,0,True,True,True,20,1,0,8.273229753305083,10,2
user_000014,46,75k-100k,desktop,returning,East,45,True,99,4,0,False,True,True,82,3,0,8.085704999097311,17,1
user_000015,67,30k-50k,desktop,returning,West,37,False,0,0,0,False,True,True,89,1,0,8.562237508286149,-89,-1
user_000016,58,30k-50k,mobile,new,West,49,False,0,0,0,True,True,True,94,1,0,7.7152253189657385,-94,-1
user_000017,34,100k-150k,mobile,returning,East,80,True,132,4,1,True,True,True,132,4,0,9.114767205698897,0,0
user_000018,45,30k-50k,mobile,returning,South,41,True,44,1,0,False,False,True,43,1,1,6.457212462662564,1,0
user_000019,42,50k-75k,mobile,new,East,56,True,104,5,0,True,True,True,94,1,0,7.766252454460117,10,4
user_000020,18,50k-75k,desktop,returning,South,64,True,71,1,0,False,False,True,64,1,0,7.102200734040583,7,0
user_000021,42,30k-50k,mobile,returning,East,54,True,112,3,0,False,True,True,90,1,0,7.568106687719994,22,2
user_000022,62,<30k,desktop,returning,West,46,True,45,1,0,True,False,True,85,1,0,7.52257343661845,-40,0
user_000023,53,30k-50k,desktop,returning,Midwest,77,True,32,4,0,True,True,True,20,4,0,7.472413394118868,12,0
user_000024,46,<30k,desktop,new,West,42,True,99,4,0,False,True,True,77,2,0,8.508374946239826,22,2
user_000025,29,75k-100k,mobile,returning,West,87,True,111,4,0,True,True,True,73,4,0,7.703748647190166,38,0
user_000026,33,75k-100k,mobile,returning,West,75,True,99,2,0,True,True,True,79,1,0,7.820892024864846,20,1
user_000027,48,100k-150k,desktop,new,Midwest,79,True,77,2,0,True,True,True,76,1,0,7.168108684827467,1,1
user_000028,48,50k-75k,mobile,new,South,56,False,0,0,0,False,False,False,0,0,0,,0,0
user_000029,48,30k-50k,mobile,returning,South,50,True,109,1,0,False,True,True,63,1,0,8.411547520946367,46,0
user_000030,49,75k-100k,mobile,new,South,34,True,122,5,0,False,True,True,79,4,0,9.528876300219379,43,1
user_000031,27,<30k,mobile,returning,Midwest,64,True,104,1,0,True,True,True,32,1,0,8.724740953252379,72,0
user_000032,59,75k-100k,mobile,new,Midwest,36,True,67,4,0,True,True,True,29,5,0,8.626009579006096,38,-1
user_000033,31,75k-100k,desktop,new,East,57,True,133,1,1,True,True,True,100,1,0,7.815170385446028,33,0
user_000034,45,>150k,mobile,returning,Midwest,81,True,60,4,0,True,True,False,0,0,0,,60,4
user_000035,28,50k-75k,desktop,new,Midwest,72,True,134,6,0,True,True,True,81,6,0,6.704769129279124,53,0
user_000036,52,100k-150k,tablet,returning,East,63,True,62,3,0,True,True,True,44,1,0,8.392836476340916,18,2
user_000037,38,>150k,desktop,new,East,77,True,94,4,0,False,True,True,97,3,0,7.812618300111437,-3,1
user_000038,31,30k-50k,desktop,returning,Midwest,67,True,45,1,0,True,True,True,20,2,0,5.671276500318636,25,-1
user_000039,50,75k-100k,tablet,new,East,58,True,132,4,0,True,False,True,117,1,1,7.932527783771392,15,3
user_000040,52,75k-100k,desktop,returning,East,57,True,112,3,0,False,False,True,111,2,0,5.5085413435108705,1,1
user_000041,53,100k-150k,desktop,returning,East,82,True,58,4,0,True,False,True,59,8,0,5.815660546713827,-1,-4
user_000042,33,75k-100k,desktop,returning,East,66,True,59,1,0,True,True,True,65,1,0,6.3681161583875765,-6,0
user_000043,55,50k-75k,mobile,returning,East,25,True,133,1,0,True,False,True,158,1,0,5.648387501092496,-25,0
user_000044,45,<30k,mobile,returning,East,23,False,0,0,0,False,False,False,0,0,0,,0,0
user_000045,45,75k-100k,mobile,returning,West,50,True,94,3,0,True,True,True,98,4,0,8.619266017730677,-4,-1
user_000046,18,50k-75k,desktop,returning,South,67,True,106,1,0,True,True,True,104,1,0,6.435869378300713,2,0
user_000047,52,75k-100k,mobile,returning,West,72,True,72,2,0,True,True,True,54,3,1,8.716068819490342,18,-1
user_000048,71,50k-75k,mobile,new,East,41,False,0,0,0,True,True,True,92,1,0,8.352819679167958,-92,-1
user_000049,76,75k-100k,mobile,returning,Midwest,45,True,110,3,0,False,True,True,61,1,1,8.287457265043077,49,2
user_000050,51,50k-75k,mobile,returning,South,56,False,0,0,0,False,True,True,139,1,0,6.195162811821387,-139,-1
user_000051,41,50k-75k,mobile,returning,East,31,True,88,3,0,True,False,True,73,4,0,7.191293161841207,15,-1
user_000052,66,50k-75k,desktop,returning,West,23,True,90,1,2,True,True,True,62,2,0,8.361720946648825,28,-1
user_000053,47,50k-75k,desktop,returning,West,50,False,0,0,0,True,False,True,113,1,0,7.020146359773398,-113,-1
user_000054,68,<30k,desktop,returning,Midwest,1,True,153,2,1,True,False,True,175,1,0,6.531620526343408,-22,1
user_000055,49,50k-75k,desktop,returning,East,40,False,0,0,0,True,False,True,160,3,0,6.805332603995029,-160,-3
user_000056,36,<30k,mobile,returning,West,62,True,149,1,0,True,False,True,163,3,0,8.634596765591274,-14,-2
user_000057,57,<30k,desktop,returning,South,29,False,0,0,0,False,False,True,118,1,0,7.037278512118941,-118,-1
user_000058,44,30k-50k,mobile,returning,South,46,True,124,1,0,False,False,True,139,2,0,7.4493382184714605,-15,-1
user_000059,41,50k-75k,desktop,new,South,61,True,152,4,0,False,True,True,110,3,0,9.500724090219522,42,1
user_000060,64,75k-100k,desktop,new,South,30,True,97,2,0,False,False,True,99,2,0,4.550942921194374,-2,0
user_000061,49,30k-50k,desktop,returning,West,58,True,84,4,1,True,False,True,78,6,1,6.982380602181565,6,-2
user_000062,29,>150k,desktop,returning,East,66,False,0,0,0,True,True,True,94,1,0,8.361444692688758,-94,-1
user_000063,44,75k-100k,desktop,returning,South,31,True,89,3,0,True,False,True,64,3,0,8.300772958164961,25,0
user_000064,32,<30k,desktop,returning,South,50,True,86,5,0,False,True,True,25,3,0,6.490825474641143,61,2
user_000065,48,<30k,desktop,returning,West,42,False,0,0,0,False,False,False,0,0,0,,0,0
user_000066,23,<30k,desktop,returning,West,48,False,0,0,0,True,True,True,102,2,0,8.656394869853163,-102,-2
user_000067,34,100k-150k,desktop,returning,South,76,True,50,1,0,False,True,True,66,1,1,6.728321630758842,-16,0
user_000068,44,75k-100k,desktop,returning,South,29,True,123,6,0,False,True,True,105,5,0,5.406605475713948,18,1
user_000069,49,<30k,desktop,new,West,37,False,0,0,0,False,True,True,116,1,0,6.7718194563575675,-116,-1
user_000070,55,75k-100k,desktop,returning,East,43,True,85,1,0,True,False,True,113,3,0,6.4939715730412315,-28,-2
user_000071,48,30k-50k,tablet,new,South,45,True,101,3,0,False,True,True,59,1,0,7.231125664848026,42,2
user_000072,66,<30k,desktop,returning,East,39,False,0,0,0,False,True,True,57,1,0,6.696036573337662,-57,-1
user_000073,77,50k-75k,desktop,returning,South,17,False,0,0,0,False,False,False,0,0,0,,0,0
user_000074,33,30k-50k,mobile,returning,East,72,True,95,2,1,True,True,True,77,1,0,8.34344919215387,18,1
user_000075,59,>150k,tablet,returning,East,41,True,109,3,0,False,True,True,80,2,0,9.030479762191202,29,1
user_000076,25,75k-100k,mobile,returning,South,92,True,30,3,1,False,True,True,40,1,0,5.463192152805693,-10,2
user_000077,62,100k-150k,desktop,new,West,52,True,118,5,0,True,True,True,97,8,0,8.106550186781362,21,-3
user_000078,43,>150k,mobile,returning,East,83,True,30,5,0,True,True,True,20,4,0,10.0,10,1
user_000079,45,50k-75k,mobile,new,South,45,True,109,3,0,True,True,True,75,1,0,7.601272758499894,34,2
user_000080,28,75k-100k,desktop,returning,West,77,True,58,4,0,True,True,True,34,1,0,9.47360357119809,24,3
user_000081,21,>150k,desktop,new,Midwest,99,True,54,1,1,True,True,True,69,2,0,7.905244197269198,-15,-1
user_000082,62,<30k,desktop,returning,South,21,True,158,2,0,False,False,False,0,0,0,,158,2
user_000083,54,50k-75k,desktop,returning,East,70,True,46,1,0,True,False,True,54,1,0,8.856194623030996,-8,0
user_000084,60,75k-100k,mobile,new,West,18,False,0,0,0,False,False,True,143,2,0,6.735141905982342,-143,-2
user_000085,67,50k-75k,mobile,returning,East,36,True,110,6,0,False,False,True,125,12,0,7.696795042465812,-15,-6
user_000086,19,50k-75k,desktop,returning,South,64,False,0,0,0,True,True,True,96,1,0,7.996232060647634,-96,-1
user_000087,25,50k-75k,tablet,returning,East,80,True,63,1,0,True,True,True,80,1,1,7.721428866794362,-17,0
user_000088,50,<30k,mobile,new,West,35,False,0,0,0,True,False,True,130,1,0,6.3260048778939115,-130,-1
user_000089,30,30k-50k,mobile,returning,East,77,True,99,3,1,False,True,True,97,3,0,4.957170826102499,2,0
user_000090,43,30k-50k,mobile,new,East,34,True,97,7,1,True,True,True,70,2,0,6.299028967148767,27,5
user_000091,34,30k-50k,mobile,returning,Midwest,68,True,115,3,0,True,True,True,99,3,0,9.240532286786015,16,0
user_000092,54,100k-150k,desktop,new,East,76,True,132,1,0,True,True,True,115,1,0,8.945571163791787,17,0
user_000093,22,30k-50k,mobile,returning,East,90,True,100,3,0,True,True,True,65,5,0,7.82591971264735,35,-2
user_000094,53,50k-75k,desktop,new,East,54,True,120,2,0,True,False,True,118,2,0,6.237799695696274,2,0
user_000095,20,50k-75k,desktop,new,East,73,False,0,0,0,False,True,False,0,0,0,,0,0
user_000096,35,30k-50k,mobile,new,East,33,True,75,5,0,False,False,True,76,1,0,8.802568677420785,-1,4
user_000097,44,<30k,desktop,returning,Midwest,57,True,85,1,0,False,False,True,69,1,0,7.163981121542518,16,0
user_000098,29,<30k,desktop,returning,Midwest,52,True,105,2,0,False,False,True,91,1,0,7.342891881869531,14,1
user_000099,24,30k-50k,mobile,returning,Midwest,73,True,72,3,1,False,True,True,20,2,0,8.089251933434534,52,1
user_000100,36,<30k,mobile,new,West,37,True,67,5,1,True,False,True,79,3,0,8.240896331850745,-12,2
user_000101,49,30k-50k,desktop,new,East,49,True,121,4,0,False,True,True,94,3,0,7.615250628431826,27,1
user_000102,36,<30k,mobile,returning,South,46,False,0,0,0,True,False,True,107,1,0,7.758710610474238,-107,-1
user_000103,19,30k-50k,desktop,returning,Midwest,73,True,51,1,0,False,True,True,20,1,0,8.671134062152033,31,0
user_000104,20,75k-100k,mobile,new,East,70,True,130,4,0,True,True,False,0,0,0,,130,4
user_000105,44,<30k,desktop,new,Midwest,16,False,0,0,0,False,False,False,0,0,0,,0,0
user_000106,60,50k-75k,mobile,new,West,36,True,129,2,0,True,True,True,97,1,0,7.244960471635611,32,1
user_000107,18,30k-50k,desktop,returning,Midwest,53,True,80,3,0,True,False,True,51,2,0,5.517577805222548,29,1
user_000108,50,30k-50k,desktop,returning,South,35,True,30,1,0,False,True,True,21,1,0,5.848215797055019,9,0
user_000109,62,100k-150k,mobile,new,Midwest,48,True,82,5,0,True,False,True,81,3,0,6.851963518240569,1,2
user_000110,50,<30k,desktop,new,West,43,True,135,2,0,False,True,True,122,2,0,8.370675551923156,13,0
user_000111,63,75k-100k,desktop,returning,South,23,True,124,2,2,False,False,True,131,1,0,7.340776956902396,-7,1
user_000112,45,50k-75k,mobile,returning,East,75,True,38,4,1,False,True,True,20,2,0,8.875196652496362,18,2
user_000113,48,30k-50k,desktop,returning,East,61,True,43,1,0,True,True,True,35,2,0,8.427806481703024,8,-1
user_000114,50,<30k,desktop,returning,East,33,False,0,0,0,True,True,True,81,1,0,7.089843292482962,-81,-1
user_000115,38,75k-100k,desktop,returning,South,32,True,175,5,0,True,False,True,155,2,0,7.2498753511602665,20,3
user_000116,52,30k-50k,desktop,new,Midwest,50,True,140,3,0,False,True,True,115,5,0,5.278730518237946,25,-2
user_000117,40,30k-50k,desktop,new,South,30,True,121,3,0,False,True,True,139,1,0,5.61323711870499,-18,2
user_000118,58,75k-100k,mobile,new,Midwest,50,True,131,4,0,False,True,True,102,4,0,8.324101293617316,29,0
user_000119,18,75k-100k,desktop,new,East,92,True,120,3,0,True,True,True,118,1,0,6.955761438270585,2,2
user_000120,80,50k-75k,desktop,new,Midwest,31,True,46,2,0,False,False,True,31,1,0,6.419047613917848,15,1
user_000121,52,<30k,desktop,returning,Midwest,38,True,110,2,1,True,False,False,0,0,0,,110,2
user_000122,68,75k-100k,mobile,returning,Midwest,22,True,77,1,1,True,True,True,44,1,0,9.000668695812479,33,0
user_000123,45,100k-150k,desktop,returning,West,91,True,78,3,0,False,True,True,65,1,0,7.815321306962704,13,2
user_000124,29,50k-75k,mobile,new,East,45,False,0,0,0,True,True,True,118,1,0,7.8927980918523035,-118,-1
user_000125,39,50k-75k,desktop,new,East,75,True,55,3,0,True,True,True,38,2,0,8.682604884056511,17,1
user_000126,18,30k-50k,desktop,new,West,79,True,36,3,0,True,True,True,20,2,0,7.252474046411288,16,1
user_000127,40,100k-150k,mobile,returning,Midwest,43,True,80,4,0,True,True,True,52,1,0,8.420599726149677,28,3
user_000128,45,<30k,tablet,returning,Midwest,34,False,0,0,0,True,True,True,121,1,0,8.732816269054954,-121,-1
user_000129,44,30k-50k,desktop,new,West,51,True,101,1,0,True,True,True,83,2,0,7.55993879770876,18,-1
user_000130,18,50k-75k,mobile,returning,East,86,True,30,4,0,True,True,True,20,4,0,10.0,10,0
user_000131,23,50k-75k,desktop,new,West,68,True,156,5,0,True,True,True,131,1,0,9.468520323126912,25,4
user_000132,59,75k-100k,mobile,new,West,64,True,113,4,0,False,True,True,113,1,1,7.441384680652702,0,3
user_000133,37,<30k,mobile,new,Midwest,42,True,141,5,1,False,True,True,113,6,2,6.708554553284269,28,-1
user_000134,55,75k-100k,mobile,new,West,66,True,114,6,0,True,True,True,94,7,0,5.701257207382638,20,-1
user_000135,53,100k-150k,mobile,returning,West,70,True,30,2,0,True,True,True,41,1,0,9.931262267876894,-11,1
user_000136,49,<30k,mobile,new,West,31,False,0,0,0,False,True,False,0,0,0,,0,0
user_000137,34,50k-75k,desktop,returning,East,48,True,109,3,0,False,False,True,81,8,1,7.133104586251363,28,-5
user_000138,18,50k-75k,mobile,returning,East,95,True,72,3,0,False,True,True,56,1,0,8.902681664422369,16,2
user_000139,44,30k-50k,desktop,returning,West,76,True,73,4,0,True,True,False,0,0,0,,73,4
user_000140,49,100k-150k,desktop,returning,West,49,True,30,1,0,False,True,True,20,1,0,6.097704787124171,10,0
user_000141,45,75k-100k,mobile,new,South,50,True,149,3,0,False,False,True,156,8,0,8.324432077690613,-7,-5
user_000142,47,30k-50k,mobile,new,South,30,False,0,0,0,True,True,False,0,0,0,,0,0
user_000143,48,30k-50k,desktop,returning,South,59,True,110,5,0,False,True,True,83,3,0,7.179942756175844,27,2
user_000144,18,75k-100k,desktop,new,South,45,True,79,5,0,False,False,True,101,2,0,6.360430053519032,-22,3
user_000145,47,50k-75k,mobile,new,Midwest,33,False,0,0,0,False,False,False,0,0,0,,0,0
user_000146,30,30k-50k,mobile,new,East,85,True,93,1,0,False,True,True,47,1,0,9.05938236333092,46,0
user_000147,32,50k-75k,desktop,returning,South,75,True,78,5,0,True,True,True,54,9,0,5.1369932365841535,24,-4
user_000148,80,<30k,mobile,returning,West,33,False,0,0,0,True,False,False,0,0,0,,0,0
user_000149,44,30k-50k,desktop,new,West,86,True,63,1,0,False,False,False,0,0,0,,63,1
user_000150,54,75k-100k,mobile,new,South,59,True,148,3,0,True,False,True,130,4,0,8.025316618274122,18,-1
user_000151,43,30k-50k,desktop,returning,West,69,True,53,1,0,True,True,True,60,1,0,6.551240854899403,-7,0
user_000152,53,30k-50k,desktop,returning,Midwest,61,False,0,0,0,True,True,True,142,1,0,10.0,-142,-1
user_000153,51,75k-100k,desktop,new,East,53,True,62,5,0,False,False,True,92,6,0,5.480351514458575,-30,-1
user_000154,28,30k-50k,desktop,returning,West,95,True,53,5,0,False,False,True,96,5,0,8.204162220882786,-43,0
user_000155,45,100k-150k,tablet,returning,East,65,True,86,1,0,True,False,True,80,1,0,7.720145071766679,6,0
user_000156,38,30k-50k,desktop,new,Midwest,40,True,111,2,0,False,True,False,0,0,0,,111,2
user_000157,42,<30k,desktop,new,Midwest,28,True,185,1,0,False,False,True,197,1,0,8.092989334673568,-12,0
user_000158,49,50k-75k,desktop,new,Midwest,58,True,69,5,0,False,True,True,71,3,0,8.227896765104134,-2,2
user_000159,46,30k-50k,mobile,returning,West,75,True,30,7,0,True,True,True,22,8,0,7.128289352322082,8,-1
user_000160,37,100k-150k,desktop,returning,East,86,True,44,1,0,False,True,True,54,2,0,6.394550277366343,-10,-1
user_000161,38,50k-75k,desktop,returning,South,66,True,79,1,0,True,True,True,79,1,0,8.026538853941714,0,0
user_000162,24,50k-75k,desktop,new,West,66,True,191,1,1,False,False,True,192,1,0,6.53390651081347,-1,0
user_000163,44,30k-50k,mobile,new,West,63,False,0,0,0,False,True,True,97,2,0,10.0,-97,-2
user_000164,59,50k-75k,desktop,new,South,26,True,127,5,0,False,False,True,142,6,0,7.75099357917427,-15,-1
user_000165,47,100k-150k,desktop,returning,West,82,True,109,2,0,True,True,True,62,1,0,7.082100115041101,47,1
user_000166,35,75k-100k,desktop,new,West,51,True,127,2,0,False,True,True,85,1,0,10.0,42,1
user_000167,66,75k-100k,mobile,new,South,21,True,158,4,0,True,True,True,125,4,0,10.0,33,0
user_000168,48,75k-100k,mobile,returning,West,37,True,96,3,0,True,True,True,57,2,0,8.640351709779772,39,1
user_000169,35,50k-75k,desktop,new,South,39,True,98,3,0,False,True,True,45,3,0,8.39249026166397,53,0
user_000170,54,100k-150k,tablet,returning,South,90,True,84,1,0,False,False,True,87,3,1,8.213420293404125,-3,-2
user_000171,44,<30k,mobile,returning,East,66,True,63,4,0,False,False,True,21,1,0,8.493189011682238,42,3
user_000172,44,<30k,mobile,returning,West,67,True,46,1,0,True,True,True,53,1,0,8.323240792984777,-7,0
user_000173,55,50k-75k,desktop,returning,East,77,True,94,1,0,True,True,False,0,0,0,,94,1
user_000174,57,30k-50k,desktop,returning,Midwest,37,True,90,2,1,False,False,True,101,3,0,6.281840570365624,-11,-1
user_000175,42,75k-100k,desktop,returning,South,47,True,90,2,0,False,False,True,109,2,0,7.348689894763283,-19,0
user_000176,45,30k-50k,desktop,new,South,64,True,176,1,1,True,True,True,129,1,0,7.722827459856905,47,0
user_000177,24,<30k,mobile,returning,South,66,True,63,1,0,False,True,True,23,1,0,7.965698331491943,40,0
user_000178,48,75k-100k,desktop,returning,West,83,True,91,1,0,True,True,True,78,1,0,9.42481517371484,13,0
user_000179,38,>150k,mobile,returning,South,62,True,103,3,1,True,False,True,72,4,1,6.611875656228716,31,-1
user_000180,62,30k-50k,desktop,new,Midwest,7,True,120,6,0,False,False,True,147,9,0,7.7087420016758506,-27,-3
user_000181,36,<30k,desktop,returning,South,40,True,36,2,0,False,False,True,34,3,0,7.418131949753708,2,-1
user_000182,68,75k-100k,mobile,new,East,34,True,125,2,1,False,False,True,161,2,0,7.929863719319116,-36,0
user_000183,23,75k-100k,mobile,new,South,32,True,151,1,0,False,False,True,131,1,0,8.726880752938868,20,0
user_000184,48,30k-50k,desktop,returning,West,51,True,88,2,0,True,True,True,89,1,0,7.29655733767126,-1,1
user_000185,54,75k-100k,mobile,returning,West,58,True,33,1,0,True,True,True,30,1,0,7.021619315998568,3,0
user_000186,44,50k-75k,desktop,returning,East,53,False,0,0,0,True,False,True,136,1,0,7.829751090601587,-136,-1
user_000187,26,100k-150k,mobile,new,West,100,True,168,3,0,True,True,True,124,2,0,6.255701407672451,44,1
user_000188,50,100k-150k,desktop,returning,West,81,True,126,2,0,True,True,True,107,1,0,9.860211832175768,19,1
user_000189,47,75k-100k,desktop,returning,Midwest,55,True,57,4,0,False,False,True,20,2,0,7.540117582046406,37,2
user_000190,34,75k-100k,desktop,new,West,100,True,90,3,0,True,True,True,69,1,0,6.3667966785378,21,2
user_000191,57,30k-50k,desktop,new,Midwest,20,False,0,0,0,True,True,True,78,1,0,7.5889345775007575,-78,-1
user_000192,38,30k-50k,desktop,new,West,23,True,154,3,0,True,True,True,134,2,0,7.590434582407929,20,1
user_000193,30,75k-100k,mobile,returning,South,64,True,30,1,0,True,True,True,20,1,0,9.26628782948529,10,0
user_000194,67,30k-50k,tablet,new,East,48,False,0,0,0,True,True,True,99,2,0,6.882082227765433,-99,-2
user_000195,41,50k-75k,mobile,new,East,39,True,101,5,0,False,False,True,141,5,0,8.626201216841647,-40,0
user_000196,71,<30k,mobile,returning,West,44,True,104,4,0,True,True,True,110,1,0,8.338338648570861,-6,3
user_000197,65,100k-150k,mobile,new,West,73,True,107,2,0,True,True,True,117,1,0,7.018323382924594,-10,1
user_000198,55,<30k,desktop,new,East,45,False,0,0,0,False,True,False,0,0,0,,0,0
user_000199,64,75k-100k,desktop,new,South,32,True,124,2,1,True,False,True,116,2,0,7.637769542633509,8,0
user_000200,35,50k-75k,desktop,returning,Midwest,37,True,77,1,0,False,False,True,93,3,1,6.008809181458103,-16,-2
user_000201,52,100k-150k,mobile,returning,East,56,False,0,0,0,False,True,True,82,3,0,8.481365913517076,-82,-3
user_000202,45,75k-100k,desktop,returning,Midwest,46,True,92,2,1,False,False,True,129,3,0,6.549656052676674,-37,-1
user_000203,41,30k-50k,desktop,new,West,34,True,102,5,0,False,True,True,70,2,0,9.756492949989013,32,3
user_000204,26,100k-150k,desktop,returning,East,63,True,71,1,0,True,True,True,83,2,0,8.433003654430667,-12,-1
user_000205,70,>150k,mobile,returning,Midwest,38,True,83,4,1,True,True,True,37,1,0,6.843793853766261,46,3
user_000206,54,50k-75k,desktop,returning,East,26,True,86,2,1,False,True,True,45,3,0,9.593394659231866,41,-1
user_000207,35,100k-150k,mobile,returning,Midwest,65,True,123,6,0,True,False,True,121,4,0,9.061087744256623,2,2
user_000208,44,75k-100k,desktop,new,West,77,True,121,3,0,False,True,True,99,3,0,7.165437550188522,22,0
user_000209,62,30k-50k,desktop,returning,East,8,True,135,1,1,False,False,True,127,1,0,7.431890947185573,8,0
user_000210,25,30k-50k,mobile,returning,East,87,False,0,0,0,True,True,True,92,1,0,6.814828728646367,-92,-1
user_000211,46,75k-100k,mobile,returning,East,30,True,82,4,1,True,True,True,77,3,1,5.9817455568021645,5,1
user_000212,67,30k-50k,desktop,returning,West,57,True,90,3,0,False,True,True,111,3,0,6.914719397202957,-21,0
user_000213,40,30k-50k,mobile,new,Midwest,76,True,102,2,1,True,True,True,64,2,0,8.409815146862794,38,0
user_000214,41,100k-150k,desktop,returning,South,57,True,154,4,0,False,False,True,142,3,0,9.094840441310401,12,1
user_000215,55,30k-50k,mobile,returning,South,43,True,43,3,0,True,True,True,42,3,0,7.823542322362344,1,0
user_000216,58,30k-50k,desktop,new,West,50,True,131,1,1,False,True,True,112,1,0,9.11505000381326,19,0
user_000217,61,50k-75k,desktop,returning,Midwest,14,True,134,4,0,False,False,True,146,2,0,10.0,-12,2
user_000218,35,30k-50k,desktop,returning,West,88,True,31,4,1,True,True,True,46,7,0,7.68945979449162,-15,-3
user_000219,47,100k-150k,mobile,returning,South,65,True,103,2,0,True,True,True,81,1,0,6.828623162576181,22,1
user_000220,61,50k-75k,desktop,returning,Midwest,47,True,99,1,0,False,False,True,107,2,1,6.325241013613501,-8,-1
user_000221,49,30k-50k,desktop,returning,Midwest,33,True,65,5,0,True,True,True,54,4,0,9.57223382726516,11,1
user_000222,49,>150k,mobile,returning,East,71,False,0,0,0,True,True,True,114,1,0,6.8998126765591214,-114,-1
user_000223,62,50k-75k,desktop,returning,East,16,True,140,3,0,False,False,True,99,4,0,7.320014248945657,41,-1
user_000224,42,100k-150k,desktop,returning,East,66,True,69,3,1,True,True,True,62,1,0,7.911625545865719,7,2
user_000225,68,50k-75k,mobile,new,East,22,False,0,0,0,False,False,False,0,0,0,,0,0
user_000226,69,50k-75k,mobile,new,East,50,True,113,3,0,False,True,True,105,4,0,8.731657674384211,8,-1
user_000227,18,75k-100k,desktop,returning,South,99,True,39,4,0,True,True,True,36,1,0,7.678852706694998,3,3
user_000228,60,<30k,mobile,returning,East,61,False,0,0,0,True,True,True,110,1,0,10.0,-110,-1
user_000229,56,75k-100k,desktop,returning,Midwest,34,True,67,5,0,True,True,True,77,4,0,8.657031836522744,-10,1
user_000230,33,30k-50k,desktop,new,South,60,True,106,2,0,True,True,True,97,1,0,8.188518380772596,9,1
user_000231,47,50k-75k,mobile,new,East,70,True,139,3,0,True,True,True,105,1,0,7.774613210683611,34,2
user_000232,30,30k-50k,desktop,returning,East,66,True,85,2,0,True,True,True,35,2,0,9.075254412114479,50,0
user_000233,35,30k-50k,desktop,new,East,54,True,65,3,0,False,False,True,42,1,0,9.99964267453376,23,2
user_000234,48,50k-75k,mobile,returning,East,70,True,108,2,0,True,True,True,95,1,0,8.978296548769677,13,1
user_000235,45,<30k,desktop,returning,Midwest,35,True,132,3,0,False,False,True,162,4,0,6.911895216039361,-30,-1
user_000236,26,30k-50k,mobile,returning,East,59,True,83,2,0,True,True,True,64,1,0,7.063034058105208,19,1
user_000237,34,75k-100k,mobile,returning,East,74,True,83,4,0,True,True,True,57,2,0,8.846249897721977,26,2
user_000238,54,75k-100k,desktop,returning,West,66,True,48,4,0,False,True,True,43,5,0,7.653796817332805,5,-1
user_000239,59,30k-50k,mobile,new,Midwest,63,True,83,3,0,False,False,False,0,0,0,,83,3
user_000240,32,30k-50k,mobile,returning,East,94,True,112,4,0,False,True,True,124,3,0,8.090346754484031,-12,1
user_000241,53,50k-75k,desktop,returning,South,69,True,116,2,0,True,True,True,70,2,0,6.668172770633718,46,0
user_000242,36,30k-50k,mobile,new,South,29,False,0,0,0,False,True,True,89,1,0,8.26092689687101,-89,-1
user_000243,48,30k-50k,mobile,new,East,26,True,107,5,1,True,False,False,0,0,0,,107,5
user_000244,63,100k-150k,desktop,returning,East,31,True,74,4,0,False,False,True,75,4,0,8.19233527313136,-1,0
user_000245,34,>150k,desktop,returning,Midwest,79,True,55,5,0,True,True,True,67,5,1,6.7994310276758165,-12,0
user_000246,47,50k-75k,tablet,new,Midwest,23,True,156,7,0,False,False,True,170,7,0,7.900016339689825,-14,0
user_000247,61,<30k,desktop,returning,East,34,False,0,0,0,False,False,False,0,0,0,,0,0
user_000248,63,100k-150k,mobile,returning,West,62,True,123,4,0,True,True,True,92,1,0,10.0,31,3
user_000249,47,50k-75k,desktop,new,South,42,False,0,0,0,True,True,True,109,2,0,7.782230957172718,-109,-2
user_000250,33,75k-100k,desktop,new,East,50,True,78,2,0,True,True,True,80,3,0,8.32855031034344,-2,-1
user_000251,28,<30k,desktop,returning,East,27,False,0,0,0,True,False,False,0,0,0,,0,0
user_000252,46,75k-100k,desktop,returning,East,48,True,96,3,0,False,True,True,68,1,0,9.01689885578012,28,2
user_000253,34,50k-75k,desktop,returning,South,79,True,63,3,0,True,True,True,40,2,0,9.827492260696909,23,1
user_000254,45,<30k,mobile,new,Midwest,34,True,84,5,0,False,False,True,82,5,0,7.372307790575391,2,0
user_000255,44,75k-100k,desktop,new,South,57,True,95,1,1,False,True,True,55,1,0,7.51718448264583,40,0
user_000256,29,75k-100k,desktop,new,East,65,True,125,6,0,True,False,True,114,7,0,9.461530618595118,11,-1
user_000257,45,50k-75k,mobile,new,West,67,True,48,4,0,False,True,False,0,0,0,,48,4
user_000258,30,>150k,mobile,new,East,82,True,105,3,0,True,True,True,124,3,0,7.877540412761251,-19,0
user_000259,41,75k-100k,mobile,returning,Midwest,67,True,68,2,0,True,True,True,31,1,0,10.0,37,1
user_000260,35,<30k,tablet,new,Midwest,30,True,109,4,0,False,True,True,96,4,0,8.050158901675397,13,0
user_000261,51,75k-100k,mobile,returning,South,62,True,107,3,0,True,True,True,88,4,0,8.817015206203697,19,-1
user_000262,24,30k-50k,desktop,returning,East,66,False,0,0,0,False,False,True,124,3,1,6.585834901517844,-124,-3
user_000263,36,50k-75k,mobile,returning,Midwest,6,True,95,5,1,False,False,True,91,4,0,9.928378008746433,4,1
user_000264,22,<30k,mobile,returning,West,72,False,0,0,0,True,True,True,86,2,0,8.400304838461373,-86,-2
user_000265,44,<30k,mobile,returning,South,43,False,0,0,0,False,True,True,104,2,0,8.527603666727629,-104,-2
user_000266,44,<30k,desktop,returning,South,21,True,155,1,0,True,False,True,173,1,0,7.223169035071357,-18,0
user_000267,24,30k-50k,mobile,returning,East,45,True,30,3,0,False,True,True,20,4,0,10.0,10,-1
user_000268,34,50k-75k,desktop,returning,South,80,False,0,0,0,True,True,True,106,4,0,7.625487427822177,-106,-4
user_000269,77,75k-100k,mobile,new,South,20,True,188,2,0,False,True,True,178,3,0,7.48450202528994,10,-1
user_000270,45,75k-100k,desktop,returning,Midwest,33,True,113,6,0,True,True,False,0,0,0,,113,6
user_000271,39,30k-50k,desktop,returning,Midwest,47,True,104,1,0,False,False,True,76,1,0,6.117300149442879,28,0
user_000272,24,<30k,mobile,returning,Midwest,40,True,68,4,0,False,True,True,83,2,0,10.0,-15,2
user_000273,62,30k-50k,desktop,returning,West,55,False,0,0,0,False,False,True,129,1,0,3.6379578837169775,-129,-1
user_000274,59,30k-50k,mobile,new,South,18,False,0,0,0,False,False,False,0,0,0,,0,0
user_000275,64,75k-100k,mobile,new,West,53,True,112,1,0,False,False,True,138,1,0,7.481498960490416,-26,0
user_000276,35,75k-100k,desktop,new,South,58,True,85,2,0,False,False,True,74,1,0,5.315716015101787,11,1
user_000277,53,>150k,desktop,returning,Midwest,76,True,45,6,0,True,True,True,60,6,0,10.0,-15,0
user_000278,29,<30k,mobile,returning,West,40,False,0,0,0,True,True,True,107,1,0,8.082804200884473,-107,-1
user_000279,41,50k-75k,desktop,returning,West,55,True,77,2,0,True,True,True,47,1,0,8.434289403633185,30,1
user_000280,42,100k-150k,desktop,new,South,64,True,105,3,1,False,True,True,61,1,1,8.782636878702128,44,2
user_000281,54,75k-100k,desktop,returning,Midwest,62,True,95,4,0,True,True,True,89,3,0,7.9723411009818115,6,1
user_000282,50,30k-50k,desktop,returning,South,35,True,109,2,0,True,False,True,54,2,0,9.213559004362438,55,0
user_000283,49,100k-150k,mobile,returning,South,85,True,57,4,1,True,True,True,49,3,0,6.218289557045394,8,1
user_000284,56,50k-75k,desktop,new,Midwest,35,True,144,5,0,False,True,True,126,9,0,8.553473913798557,18,-4
user_000285,41,75k-100k,desktop,new,East,37,True,114,2,0,True,True,True,83,3,0,10.0,31,-1
user_000286,27,100k-150k,mobile,returning,Midwest,86,True,63,3,2,True,True,True,50,1,0,7.8052443018995605,13,2
user_000287,33,50k-75k,desktop,returning,West,89,True,99,3,0,True,True,True,68,4,0,9.389038760951237,31,-1
user_000288,55,>150k,mobile,new,West,69,True,107,3,0,True,True,True,110,4,0,9.386231080846267,-3,-1
user_000289,48,>150k,mobile,returning,Midwest,73,True,91,5,0,True,True,True,100,5,0,8.958333832545415,-9,0
user_000290,22,50k-75k,mobile,returning,West,98,True,30,2,0,True,True,False,0,0,0,,30,2
user_000291,36,75k-100k,mobile,returning,East,52,True,37,4,0,False,False,True,25,4,0,5.825306957478294,12,0
user_000292,60,50k-75k,desktop,returning,Midwest,38,True,76,4,0,False,False,True,93,6,0,8.651243014001716,-17,-2
user_000293,42,30k-50k,desktop,returning,West,53,False,0,0,0,True,False,True,106,2,0,6.6678162731780946,-106,-2
user_000294,27,75k-100k,desktop,returning,East,67,True,87,1,0,True,True,False,0,0,0,,87,1
user_000295,67,30k-50k,mobile,new,West,54,False,0,0,0,False,False,True,147,1,1,8.104865141814855,-147,-1
user_000296,63,>150k,desktop,returning,East,58,True,101,2,0,True,False,True,115,2,0,6.321768948170323,-14,0
user_000297,73,<30k,mobile,returning,East,48,True,54,3,0,False,False,True,29,1,1,8.151484160030753,25,2
user_000298,47,30k-50k,mobile,new,West,33,False,0,0,0,False,True,True,44,1,1,8.453458738737478,-44,-1
user_000299,52,30k-50k,desktop,new,East,42,True,142,2,0,False,True,False,0,0,0,,142,2
user_000300,44,50k-75k,desktop,new,West,86,True,103,1,0,False,False,True,99,1,0,4.470933983614655,4,0
user_000301,30,50k-75k,desktop,returning,West,84,True,45,6,0,True,True,True,26,4,0,8.347888033423715,19,2
user_000302,43,75k-100k,desktop,returning,West,56,True,145,3,0,True,False,True,122,3,0,7.560210059141426,23,0
user_000303,58,30k-50k,mobile,returning,West,32,True,64,4,0,False,True,True,20,2,0,7.92661207658533,44,2
user_000304,18,50k-75k,desktop,new,East,83,True,125,2,0,False,True,True,85,3,0,6.389015353226097,40,-1
user_000305,46,30k-50k,desktop,new,Midwest,52,True,126,1,0,False,True,True,80,1,0,8.388828121066478,46,0
user_000306,56,100k-150k,mobile,returning,East,31,True,64,2,0,True,True,True,61,4,0,8.133280967834759,3,-2
user_000307,20,30k-50k,desktop,returning,South,82,True,98,3,0,True,True,True,42,2,0,8.520313669168768,56,1
user_000308,48,<30k,mobile,new,East,57,True,121,4,1,False,True,True,82,2,0,7.600812229109222,39,2
user_000309,47,50k-75k,mobile,returning,Midwest,39,True,122,4,0,False,False,True,106,9,0,7.798697281157297,16,-5
user_000310,51,50k-75k,mobile,returning,East,63,True,51,2,0,True,False,True,56,2,0,7.860656938081197,-5,0
user_000311,45,50k-75k,mobile,returning,East,39,True,87,7,0,True,True,True,24,7,0,8.40312246967575,63,0
user_000312,35,100k-150k,desktop,new,South,48,True,87,3,0,False,False,True,90,2,1,8.36181138345051,-3,1
user_000313,49,30k-50k,mobile,returning,East,46,True,34,2,0,False,False,True,76,8,0,8.950993193026429,-42,-6
user_000314,58,100k-150k,desktop,new,East,48,True,146,3,0,False,False,True,141,1,0,4.42336860527175,5,2
user_000315,38,50k-75k,desktop,new,Midwest,62,True,140,1,0,False,False,True,140,1,0,8.417025139362677,0,0
user_000316,58,75k-100k,tablet,new,East,24,False,0,0,0,True,True,True,133,1,0,8.847280339826517,-133,-1
user_000317,46,50k-75k,desktop,returning,East,62,True,90,3,0,False,True,True,94,3,0,8.238869265123917,-4,0
user_000318,39,30k-50k,desktop,returning,East,43,True,72,2,0,False,True,True,53,1,0,7.188874802235407,19,1
user_000319,75,30k-50k,desktop,returning,West,28,True,127,1,0,False,True,True,129,2,0,8.657043463138393,-2,-1
user_000320,43,<30k,desktop,returning,East,46,True,98,1,0,True,False,False,0,0,0,,98,1
user_000321,42,>150k,desktop,returning,West,89,True,77,3,0,True,True,True,64,5,0,5.9000161276276515,13,-2
user_000322,53,30k-50k,mobile,returning,East,54,False,0,0,0,True,False,True,78,1,0,6.527734046682159,-78,-1
user_000323,47,<30k,desktop,new,South,54,True,86,2,0,False,False,True,102,1,1,7.4494060600368845,-16,1
user_000324,18,75k-100k,mobile,returning,South,55,True,45,4,0,False,False,True,37,5,0,3.655411817519251,8,-1
user_000325,57,50k-75k,desktop,new,West,53,False,0,0,0,False,False,False,0,0,0,,0,0
user_000326,69,<30k,mobile,new,East,20,True,147,3,2,False,False,False,0,0,0,,147,3
user_000327,51,75k-100k,desktop,returning,South,44,True,64,7,0,False,False,True,53,5,0,6.444136514912742,11,2
user_000328,38,75k-100k,mobile,returning,East,53,True,83,2,0,False,True,True,72,1,0,8.069546202369407,11,1
user_000329,58,30k-50k,desktop,new,South,9,True,197,3,1,True,False,True,160,2,1,7.242277103339766,37,1
user_000330,52,75k-100k,desktop,new,West,62,True,151,1,1,True,False,True,166,1,0,6.694750699568125,-15,0
user_000331,51,100k-150k,desktop,returning,Midwest,56,True,138,4,0,False,False,True,152,6,0,6.68408163489095,-14,-2
user_000332,61,75k-100k,desktop,new,East,33,True,71,1,0,False,False,False,0,0,0,,71,1
user_000333,36,50k-75k,mobile,returning,West,58,True,106,5,0,True,True,True,118,1,0,8.13240251979125,-12,4
user_000334,52,75k-100k,desktop,new,South,41,True,149,2,0,False,True,True,143,1,0,7.642525586307763,6,1
user_000335,30,75k-100k,desktop,new,South,81,True,151,1,0,False,True,True,128,1,0,10.0,23,0
user_000336,50,100k-150k,mobile,returning,West,100,True,96,5,0,True,True,True,92,6,0,7.799061237133618,4,-1
user_000337,56,<30k,mobile,new,East,0,False,0,0,0,False,False,True,139,1,0,8.844610383729881,-139,-1
user_000338,59,30k-50k,mobile,returning,West,70,True,130,2,0,True,False,True,115,2,0,8.387711148836724,15,0
user_000339,46,100k-150k,mobile,new,West,92,True,101,4,0,True,True,True,113,3,0,9.769566477458211,-12,1
user_000340,59,<30k,desktop,returning,West,42,True,115,2,0,True,False,True,107,2,1,8.752581228977672,8,0
user_000341,35,100k-150k,desktop,returning,East,37,True,93,4,0,False,True,True,58,1,0,7.275292887507541,35,3
user_000342,69,75k-100k,desktop,returning,East,54,True,81,4,1,False,False,True,74,4,0,9.280372951997453,7,0
user_000343,41,50k-75k,desktop,new,East,37,True,134,2,1,False,False,True,113,4,1,7.503841645485786,21,-2
user_000344,45,50k-75k,desktop,returning,Midwest,70,True,110,5,0,True,False,True,91,3,0,6.359789445516246,19,2
user_000345,35,75k-100k,mobile,new,East,49,True,98,4,0,False,True,True,82,2,0,6.831769029623054,16,2
user_000346,23,<30k,mobile,returning,East,58,True,69,1,0,False,False,True,65,1,0,8.847299599498648,4,0
user_000347,40,75k-100k,mobile,new,East,38,True,137,6,0,False,True,True,88,3,0,8.824130586857198,49,3
user_000348,42,100k-150k,desktop,returning,East,75,True,30,1,0,False,True,True,43,1,1,5.706732803180876,-13,0
user_000349,61,<30k,desktop,new,East,25,True,124,2,0,False,False,True,115,5,1,6.285616024655002,9,-3
user_000350,34,50k-75k,desktop,returning,West,57,True,149,1,0,False,False,True,181,1,0,7.677474112159138,-32,0
user_000351,21,50k-75k,mobile,returning,Midwest,78,False,0,0,0,True,True,True,91,1,0,9.461374652965443,-91,-1
user_000352,37,100k-150k,tablet,returning,West,77,True,57,2,0,False,False,True,38,1,0,5.493408583626605,19,1
user_000353,40,30k-50k,mobile,returning,Midwest,31,True,68,8,0,False,False,True,55,12,0,4.329621732532632,13,-4
user_000354,43,50k-75k,mobile,new,East,51,False,0,0,0,False,True,True,104,1,0,7.803624993421965,-104,-1
user_000355,28,<30k,mobile,returning,Midwest,76,False,0,0,0,True,True,True,108,1,0,9.167332128719329,-108,-1
user_000356,59,50k-75k,mobile,returning,South,34,True,94,5,0,True,True,True,81,3,1,6.555903116034645,13,2
user_000357,27,75k-100k,mobile,returning,West,81,True,71,2,1,False,True,True,88,3,0,8.54912298520899,-17,-1
user_000358,36,<30k,mobile,new,East,41,True,86,4,0,True,True,True,87,4,0,9.790331670993968,-1,0
user_000359,59,<30k,desktop,new,Midwest,26,True,107,7,2,True,False,True,69,7,1,6.66899422634064,38,0
user_000360,60,75k-100k,mobile,returning,East,24,True,100,2,0,True,False,True,96,4,0,7.3653100862088445,4,-2
user_000361,42,50k-75k,desktop,returning,South,57,True,62,2,0,True,True,True,39,1,0,7.698834267164002,23,1
user_000362,60,30k-50k,desktop,returning,Midwest,46,True,125,2,1,False,False,True,99,1,0,7.410808923785669,26,1
user_000363,40,50k-75k,mobile,returning,West,71,True,101,4,1,True,True,True,65,1,0,9.861177224016968,36,3
user_000364,36,30k-50k,mobile,returning,Midwest,41,False,0,0,0,True,True,True,99,2,0,10.0,-99,-2
user_000365,26,50k-75k,mobile,returning,Midwest,56,True,112,1,0,False,True,True,87,2,0,7.045539584755153,25,-1
user_000366,37,>150k,desktop,returning,West,74,True,68,2,0,True,True,True,67,1,0,9.41379540021214,1,1
user_000367,43,50k-75k,tablet,returning,West,54,True,116,2,0,False,False,False,0,0,0,,116,2
user_000368,53,30k-50k,mobile,returning,East,45,True,92,6,0,False,False,True,72,13,0,8.420478652764185,20,-7
user_000369,62,<30k,tablet,new,South,25,True,136,1,0,False,False,True,138,1,0,8.269728056080996,-2,0
user_000370,21,>150k,mobile,returning,East,68,True,131,6,0,True,True,True,119,4,0,8.082312758339373,12,2
user_000371,54,50k-75k,mobile,returning,East,57,True,93,3,0,True,True,True,93,5,0,8.885033676159846,0,-2
user_000372,42,50k-75k,mobile,new,West,52,True,107,2,0,False,False,True,112,3,0,5.298806906581923,-5,-1
user_000373,28,30k-50k,tablet,returning,East,73,True,68,1,0,True,True,True,81,1,0,8.067103841200288,-13,0
user_000374,61,50k-75k,desktop,returning,East,64,True,87,3,0,True,False,True,112,2,1,7.083631856273859,-25,1
user_000375,80,75k-100k,mobile,returning,West,22,True,125,7,0,False,True,True,82,3,0,9.770544957250753,43,4
user_000376,61,30k-50k,tablet,returning,Midwest,31,True,66,7,0,False,False,True,37,4,0,5.22456443954555,29,3
user_000377,54,<30k,desktop,new,South,29,False,0,0,0,False,False,True,122,2,0,7.88583683628089,-122,-2
user_000378,61,100k-150k,mobile,returning,South,44,True,77,2,0,True,True,True,91,3,0,8.1619274361959,-14,-1
user_000379,36,50k-75k,mobile,new,West,80,True,81,2,0,True,True,True,20,1,0,6.753978296955151,61,1
user_000380,44,50k-75k,desktop,returning,South,49,True,63,3,1,True,True,True,30,3,0,8.090924806985,33,0
user_000381,42,100k-150k,desktop,returning,South,57,True,110,5,0,False,True,True,97,2,0,8.812402876776483,13,3
user_000382,53,100k-150k,mobile,returning,South,15,False,0,0,0,True,True,True,114,1,1,7.221108399720033,-114,-1
user_000383,61,75k-100k,desktop,new,East,49,True,134,2,1,False,False,True,115,2,1,5.752777160916907,19,0
user_000384,35,75k-100k,mobile,new,East,62,True,179,2,1,True,False,True,150,2,0,6.191640908283381,29,0
user_000385,59,30k-50k,tablet,new,South,37,False,0,0,0,False,False,True,101,1,0,8.940408310510875,-101,-1
user_000386,35,30k-50k,mobile,returning,South,51,True,103,3,0,False,True,True,62,5,0,7.873370073474855,41,-2
user_000387,50,75k-100k,desktop,returning,South,61,True,114,4,0,False,True,True,83,2,0,10.0,31,2
user_000388,34,<30k,desktop,new,East,57,True,144,3,0,False,False,True,157,1,0,6.078091102273388,-13,2
user_000389,18,30k-50k,mobile,returning,South,68,True,58,5,2,False,True,True,73,5,0,9.632415913471192,-15,0
user_000390,20,<30k,desktop,returning,Midwest,43,True,63,1,0,True,True,True,64,1,0,7.466624564146755,-1,0
user_000391,57,30k-50k,mobile,returning,South,27,True,39,3,0,True,True,True,20,1,0,8.1635735546764,19,2
user_000392,45,30k-50k,desktop,new,Midwest,49,True,133,2,0,False,True,True,92,1,0,9.520453595035125,41,1
user_000393,18,50k-75k,desktop,new,South,67,True,92,4,0,False,True,True,74,3,0,8.392433625015048,18,1
user_000394,57,50k-75k,desktop,new,Midwest,15,False,0,0,0,True,False,False,0,0,0,,0,0
user_000395,50,100k-150k,desktop,returning,East,57,True,127,3,0,True,True,True,115,2,0,8.825057257545469,12,1
user_000396,37,30k-50k,desktop,new,West,62,True,112,1,0,True,True,True,114,1,0,8.237944266430345,-2,0
user_000397,40,75k-100k,mobile,new,East,52,True,101,1,1,False,True,True,62,2,1,6.698661126854052,39,-1
user_000398,35,100k-150k,mobile,new,Midwest,55,True,79,2,0,False,True,True,20,1,0,6.637985482176718,59,1
user_000399,48,50k-75k,mobile,returning,East,52,True,118,3,0,False,True,True,99,4,0,7.8782853281838126,19,-1
user_000400,48,50k-75k,desktop,returning,South,36,True,80,8,1,False,True,True,83,4,0,6.653035133861221,-3,4
user_000401,59,50k-75k,mobile,returning,Midwest,48,False,0,0,0,True,False,True,135,1,0,8.495428219260203,-135,-1
user_000402,35,>150k,desktop,returning,Midwest,55,True,79,4,0,True,True,True,78,4,0,7.216882508802214,1,0
user_000403,45,75k-100k,desktop,new,East,59,True,101,1,0,True,False,True,147,2,0,6.106584497827682,-46,-1
user_000404,37,50k-75k,desktop,new,East,47,True,107,3,0,False,False,True,88,2,0,7.2153771654797945,19,1
user_000405,54,75k-100k,mobile,returning,South,27,True,33,2,0,True,True,True,20,2,0,6.6251140603375385,13,0
user_000406,21,50k-75k,desktop,new,Midwest,77,True,152,1,0,False,True,True,94,2,1,10.0,58,-1
user_000407,27,<30k,desktop,returning,East,84,True,142,3,0,True,True,True,139,5,0,7.407968886049263,3,-2
user_000408,36,75k-100k,mobile,returning,East,47,True,73,2,2,False,True,False,0,0,0,,73,2
user_000409,41,<30k,desktop,new,South,20,True,166,5,0,True,True,True,143,4,0,8.314202384685844,23,1
user_000410,44,50k-75k,mobile,returning,Midwest,41,True,77,1,0,True,True,True,65,2,0,8.624211705920326,12,-1
user_000411,55,>150k,desktop,returning,East,75,True,30,3,0,True,True,True,22,4,0,8.519364757004153,8,-1
user_000412,55,50k-75k,tablet,new,West,68,False,0,0,0,True,True,True,83,1,0,9.230173460733717,-83,-1
user_000413,46,<30k,mobile,new,East,63,True,142,2,0,True,False,True,159,2,0,6.121700021713513,-17,0
user_000414,47,30k-50k,mobile,new,East,50,True,170,5,0,True,False,False,0,0,0,,170,5
user_000415,41,100k-150k,mobile,returning,South,82,True,107,1,0,True,True,True,78,1,0,8.035324958709213,29,0
user_000416,43,50k-75k,mobile,new,West,35,True,91,2,0,True,True,True,45,1,0,7.33144413368191,46,1
user_000417,45,75k-100k,desktop,new,South,48,True,155,1,0,False,True,True,111,1,0,6.819860283826435,44,0
user_000418,39,>150k,mobile,returning,West,70,True,72,3,0,True,True,True,61,1,0,9.766882593980604,11,2
user_000419,52,75k-100k,desktop,returning,West,77,True,105,3,0,True,True,True,85,2,0,6.044105953553601,20,1
user_000420,41,50k-75k,desktop,new,East,56,False,0,0,0,True,True,False,0,0,0,,0,0
user_000421,32,50k-75k,desktop,returning,West,100,False,0,0,0,False,True,True,120,1,0,7.993752638672452,-120,-1
user_000422,75,<30k,tablet,returning,West,35,False,0,0,0,False,True,False,0,0,0,,0,0
user_000423,18,<30k,mobile,returning,East,83,False,0,0,0,True,True,True,126,1,1,7.05464543237818,-126,-1
user_000424,38,<30k,mobile,returning,West,58,True,110,1,0,True,False,True,139,1,0,9.394769707505224,-29,0
user_000425,21,>150k,mobile,returning,South,86,True,99,1,0,True,True,True,124,1,0,7.772381589297861,-25,0
user_000426,51,50k-75k,desktop,new,Midwest,45,True,127,1,0,True,False,True,149,1,0,6.949792282855499,-22,0
user_000427,55,75k-100k,mobile,returning,Midwest,25,True,128,1,0,True,True,True,85,1,0,10.0,43,0
user_000428,40,75k-100k,mobile,returning,South,44,True,79,5,0,True,True,True,69,4,0,9.047184722755457,10,1
user_000429,26,<30k,mobile,returning,West,79,True,73,5,0,True,True,False,0,0,0,,73,5
user_000430,38,30k-50k,desktop,returning,West,59,True,43,2,0,False,True,True,48,2,0,8.025692754085147,-5,0
user_000431,56,50k-75k,desktop,new,East,32,False,0,0,0,False,True,True,121,1,0,8.543148835976146,-121,-1
user_000432,66,>150k,mobile,returning,East,40,True,57,3,0,True,False,True,60,2,0,7.600605142892836,-3,1
user_000433,34,100k-150k,tablet,returning,East,96,True,59,1,0,False,False,True,69,1,0,6.479583482430924,-10,0
user_000434,45,50k-75k,mobile,returning,West,45,True,37,4,0,False,True,True,22,2,0,9.4048145464478,15,2
user_000435,38,30k-50k,mobile,new,West,70,True,107,4,0,True,True,True,61,4,0,7.51095009936408,46,0
user_000436,69,>150k,desktop,returning,Midwest,46,True,72,1,0,True,True,True,30,1,0,6.715094748393797,42,0
user_000437,42,30k-50k,mobile,returning,South,58,True,123,2,0,False,True,True,117,2,0,8.971682899753754,6,0
user_000438,26,75k-100k,desktop,returning,West,85,True,48,3,0,False,True,True,39,4,0,10.0,9,-1
user_000439,18,30k-50k,desktop,new,West,82,True,73,3,0,True,True,True,86,1,0,8.00027286555154,-13,2
user_000440,55,100k-150k,desktop,new,Midwest,77,True,144,3,0,False,True,True,122,6,0,9.639016729923977,22,-3
user_000441,37,30k-50k,desktop,returning,East,48,True,85,1,0,False,True,True,62,1,0,6.539857230702299,23,0
user_000442,34,<30k,desktop,new,East,60,True,150,1,1,True,True,False,0,0,0,,150,1
user_000443,55,>150k,mobile,new,East,47,True,139,2,0,False,True,True,90,4,1,6.736233788120509,49,-2
user_000444,62,75k-100k,desktop,returning,East,20,True,152,4,0,False,False,True,153,8,0,8.420197066815422,-1,-4
user_000445,36,100k-150k,mobile,returning,South,81,False,0,0,0,True,False,True,132,2,0,7.882046940070356,-132,-2
user_000446,32,50k-75k,desktop,new,East,77,True,104,1,0,False,True,True,72,1,0,4.783249673027011,32,0
user_000447,54,75k-100k,desktop,returning,West,37,True,94,4,1,False,False,True,119,5,0,6.551127186476451,-25,-1
user_000448,74,30k-50k,desktop,returning,West,91,True,70,2,0,True,False,True,71,3,0,7.8607913386631605,-1,-1
user_000449,40,50k-75k,desktop,returning,Midwest,71,True,73,6,0,False,False,True,109,6,0,7.5230441051586565,-36,0
user_000450,57,100k-150k,desktop,returning,South,35,True,38,5,0,True,False,True,20,9,0,7.816410258951968,18,-4
user_000451,51,30k-50k,mobile,new,South,56,True,121,3,0,False,False,True,107,2,0,6.3863521642193115,14,1
user_000452,28,75k-100k,desktop,returning,East,64,True,93,2,0,True,True,True,59,1,0,6.066183967208961,34,1
user_000453,22,75k-100k,desktop,returning,West,74,True,40,3,0,False,True,True,20,4,0,6.160011817773709,20,-1
user_000454,45,75k-100k,desktop,returning,South,35,True,142,6,0,False,False,True,155,6,0,7.577651930868912,-13,0
user_000455,18,75k-100k,desktop,new,South,81,True,103,2,0,False,False,True,119,6,0,9.570623285477398,-16,-4
user_000456,55,<30k,desktop,new,East,34,True,198,2,0,False,False,False,0,0,0,,198,2
user_000457,63,75k-100k,desktop,new,Midwest,33,True,79,3,0,True,False,True,93,5,0,7.724121301332597,-14,-2
user_000458,18,100k-150k,mobile,returning,West,100,True,60,1,0,False,True,True,52,1,0,7.914829796720971,8,0
user_000459,35,30k-50k,mobile,returning,East,73,True,119,2,0,False,False,True,110,2,1,9.298073948902621,9,0
user_000460,28,<30k,desktop,new,East,78,False,0,0,0,True,True,False,0,0,0,,0,0
user_000461,61,<30k,mobile,returning,Midwest,41,True,32,2,0,False,False,False,0,0,0,,32,2
user_000462,30,30k-50k,mobile,returning,West,65,True,118,1,0,True,True,True,107,1,0,9.375021056123368,11,0
user_000463,41,50k-75k,tablet,new,East,36,True,154,4,0,True,False,True,155,10,1,7.0200404505949665,-1,-6
user_000464,22,75k-100k,desktop,returning,East,60,True,60,2,0,True,True,True,23,2,0,7.2208183938603,37,0
user_000465,48,30k-50k,desktop,new,East,51,True,185,4,0,False,False,True,187,4,0,6.541923854626581,-2,0
user_000466,36,75k-100k,mobile,new,South,40,True,113,1,0,True,False,True,118,1,1,9.301009285980033,-5,0
user_000467,57,50k-75k,desktop,returning,East,17,True,120,4,0,False,False,True,95,5,0,6.9877849628499815,25,-1
user_000468,60,75k-100k,desktop,new,East,39,True,95,4,0,True,True,True,20,2,0,7.833444318865356,75,2
user_000469,53,100k-150k,mobile,new,South,65,True,84,4,0,False,False,True,39,1,0,8.13308173933444,45,3
user_000470,41,30k-50k,desktop,returning,Midwest,44,True,75,2,0,True,True,True,73,4,0,7.9734047784429745,2,-2
user_000471,61,50k-75k,mobile,returning,South,24,True,219,4,0,False,False,False,0,0,0,,219,4
user_000472,44,30k-50k,desktop,returning,West,57,False,0,0,0,False,True,True,128,1,0,9.556676424214146,-128,-1
user_000473,38,<30k,desktop,returning,East,15,True,81,5,1,True,False,True,65,3,0,5.551015770106481,16,2
user_000474,25,75k-100k,mobile,returning,Midwest,75,True,96,5,0,True,True,True,88,1,0,8.076022474710093,8,4
user_000475,33,75k-100k,mobile,new,South,54,True,131,2,0,False,False,True,114,2,0,7.22156709524197,17,0
user_000476,55,30k-50k,mobile,new,East,72,True,64,5,0,True,True,False,0,0,0,,64,5
user_000477,52,75k-100k,mobile,returning,South,52,True,67,1,1,False,True,True,104,1,0,9.052787055950002,-37,0
user_000478,58,100k-150k,desktop,new,Midwest,58,True,103,4,2,False,True,True,72,2,0,7.721575028391906,31,2
user_000479,61,50k-75k,mobile,returning,South,65,True,80,3,0,True,True,True,34,5,0,8.135043476313186,46,-2
user_000480,41,30k-50k,mobile,returning,Midwest,66,True,108,2,0,False,False,True,110,3,0,7.230817842131349,-2,-1
user_000481,74,75k-100k,mobile,returning,East,23,True,157,6,0,True,True,True,102,3,0,7.444344487969938,55,3
user_000482,39,100k-150k,mobile,returning,East,64,True,87,1,0,False,True,True,98,1,0,7.330016553682972,-11,0
user_000483,37,30k-50k,desktop,new,East,71,True,129,5,0,True,True,True,107,2,0,7.112101624371742,22,3
user_000484,56,75k-100k,mobile,new,West,50,True,120,5,0,False,False,True,115,7,0,7.313011763008371,5,-2
user_000485,28,100k-150k,desktop,new,East,72,True,76,1,0,False,False,True,90,1,0,9.411745267812039,-14,0
user_000486,52,50k-75k,desktop,returning,East,58,True,112,3,0,False,True,True,69,2,0,6.642193638377405,43,1
user_000487,46,30k-50k,desktop,returning,East,16,True,100,3,0,True,False,True,100,3,0,7.432570809997342,0,0
user_000488,47,100k-150k,desktop,new,East,100,True,121,1,0,True,True,True,101,4,0,7.863080107808356,20,-3
user_000489,51,30k-50k,desktop,returning,South,54,True,96,1,0,False,True,True,54,1,0,10.0,42,0
user_000490,53,50k-75k,desktop,new,Midwest,31,True,109,2,0,False,False,False,0,0,0,,109,2
user_000491,59,30k-50k,mobile,new,West,58,True,98,1,0,True,True,True,63,1,0,7.03146399012551,35,0
user_000492,34,50k-75k,mobile,new,West,61,True,186,2,0,False,False,True,191,2,0,7.058000747952988,-5,0
user_000493,24,<30k,mobile,returning,Midwest,46,True,128,5,0,True,True,True,95,4,0,7.3715903743333815,33,1
user_000494,21,30k-50k,tablet,returning,Midwest,36,False,0,0,0,True,True,True,56,2,0,5.324509311065747,-56,-2
user_000495,18,50k-75k,desktop,returning,West,80,True,87,4,0,True,True,True,84,3,0,8.713333933220698,3,1
user_000496,31,100k-150k,desktop,returning,West,98,True,63,2,0,True,True,True,74,1,0,10.0,-11,1
user_000497,57,30k-50k,mobile,returning,West,41,True,59,1,0,False,False,True,30,1,0,7.921484145782008,29,0
user_000498,80,30k-50k,desktop,returning,West,28,True,172,4,0,False,False,True,209,3,1,6.485820266080261,-37,1
user_000499,49,75k-100k,desktop,new,West,86,True,123,1,0,True,True,True,99,1,0,7.879191927609685,24,0
user_000500,61,100k-150k,desktop,returning,East,40,True,82,4,0,True,False,True,72,5,0,7.741856989487408,10,-1
user_000501,32,50k-75k,mobile,returning,South,64,True,101,2,0,True,True,True,86,2,0,9.823776720571697,15,0
user_000502,57,50k-75k,desktop,returning,West,11,True,136,2,1,False,False,True,139,6,0,4.632344764850522,-3,-4
user_000503,63,>150k,mobile,returning,West,52,True,91,1,0,False,False,True,97,1,0,5.678906754560307,-6,0
user_000504,35,50k-75k,tablet,returning,East,32,False,0,0,0,True,False,True,123,1,0,7.096251095312395,-123,-1
user_000505,58,50k-75k,mobile,returning,East,54,True,144,2,0,True,False,True,132,4,0,5.652741493075928,12,-2
user_000506,41,75k-100k,mobile,new,Midwest,44,True,131,5,0,False,False,True,145,4,0,7.213869507325703,-14,1
user_000507,51,100k-150k,desktop,returning,West,96,True,30,2,0,False,False,True,20,1,0,6.8389439481540055,10,1
user_000508,51,75k-100k,desktop,returning,East,37,True,81,2,0,False,True,True,42,1,0,8.249319054790284,39,1
user_000509,49,75k-100k,desktop,new,West,66,True,121,1,0,False,False,True,130,1,2,8.994741974661856,-9,0
user_000510,47,100k-150k,desktop,returning,Midwest,74,True,149,2,0,True,True,True,131,1,0,7.962567185363086,18,1
user_000511,32,75k-100k,mobile,returning,Midwest,55,True,30,2,1,False,True,True,20,5,0,6.229370389370406,10,-3
user_000512,45,30k-50k,mobile,new,East,63,False,0,0,0,True,True,False,0,0,0,,0,0
user_000513,52,30k-50k,mobile,returning,East,65,True,62,4,0,True,True,True,20,7,0,9.39486388837073,42,-3
user_000514,47,75k-100k,mobile,returning,East,58,True,59,1,0,False,False,False,0,0,0,,59,1
user_000515,51,30k-50k,mobile,new,Midwest,24,True,170,3,2,True,False,True,187,4,0,7.274409241103828,-17,-1
user_000516,34,30k-50k,desktop,returning,South,73,False,0,0,0,True,True,True,102,1,0,9.737290323952605,-102,-1
user_000517,50,<30k,desktop,returning,East,16,True,124,5,0,False,False,True,131,4,3,7.081653474799011,-7,1
user_000518,40,<30k,desktop,new,South,45,True,128,2,0,True,True,True,114,1,0,7.756241544411886,14,1
user_000519,52,100k-150k,tablet,returning,South,36,False,0,0,0,True,False,True,111,3,1,8.440556629816886,-111,-3
user_000520,56,<30k,mobile,returning,East,34,True,75,5,0,True,False,True,112,7,0,8.635941283205785,-37,-2
user_000521,29,100k-150k,tablet,new,West,91,True,55,2,0,True,True,True,35,1,0,8.845626742344365,20,1
user_000522,61,<30k,mobile,returning,Midwest,0,True,143,7,0,False,False,True,156,6,0,8.65786083621964,-13,1
user_000523,50,30k-50k,mobile,returning,Midwest,61,True,67,2,0,True,False,True,48,3,0,7.2720222918035065,19,-1
user_000524,47,50k-75k,desktop,returning,Midwest,45,False,0,0,0,False,True,True,96,1,0,6.424591672288729,-96,-1
user_000525,52,75k-100k,mobile,returning,East,29,False,0,0,0,False,False,True,76,1,0,8.008972806143987,-76,-1
user_000526,54,100k-150k,desktop,new,East,78,True,134,3,1,True,True,True,123,4,0,7.881249372019144,11,-1
user_000527,29,50k-75k,mobile,returning,Midwest,87,False,0,0,0,True,True,True,57,1,0,6.305360605131792,-57,-1
user_000528,60,100k-150k,mobile,returning,Midwest,65,True,76,5,1,True,True,True,51,5,0,5.3342943690805384,25,0
user_000529,53,30k-50k,mobile,returning,Midwest,31,True,152,3,0,False,True,True,97,2,0,7.473909334355952,55,1
user_000530,68,50k-75k,desktop,returning,West,57,True,107,1,0,True,True,True,80,1,0,7.528689257099829,27,0
user_000531,18,100k-150k,desktop,returning,East,80,False,0,0,0,True,True,False,0,0,0,,0,0
user_000532,71,30k-50k,desktop,new,South,53,True,171,3,0,False,False,True,140,2,0,4.718617948227239,31,1
user_000533,47,50k-75k,mobile,new,East,38,False,0,0,0,False,True,True,76,1,0,7.6807552986275045,-76,-1
user_000534,54,100k-150k,desktop,returning,West,62,True,132,2,0,True,True,True,89,3,0,7.2779686106945025,43,-1
user_000535,48,30k-50k,desktop,returning,West,72,True,86,2,0,True,True,False,0,0,0,,86,2
user_000536,37,>150k,desktop,returning,West,72,True,83,4,0,True,True,True,63,1,0,9.164016238203503,20,3
user_000537,41,>150k,desktop,returning,South,48,True,121,4,0,False,True,True,93,4,0,6.963773440382345,28,0
user_000538,37,<30k,mobile,new,East,35,False,0,0,0,False,False,True,86,2,0,6.916160097484651,-86,-2
user_000539,44,30k-50k,mobile,returning,South,52,False,0,0,0,False,False,True,95,1,0,7.405247391164576,-95,-1
user_000540,37,30k-50k,desktop,new,East,44,False,0,0,0,False,True,False,0,0,0,,0,0
user_000541,53,30k-50k,mobile,returning,West,51,True,113,2,0,False,True,True,92,5,0,8.870119674439293,21,-3
user_000542,44,<30k,mobile,returning,West,37,True,77,7,0,True,False,True,83,10,0,7.221303055407944,-6,-3
user_000543,47,30k-50k,desktop,returning,West,100,True,38,1,0,True,True,True,20,1,0,7.1955314865972415,18,0
user_000544,43,<30k,desktop,new,East,27,True,191,1,1,False,False,True,194,1,0,7.848444196163468,-3,0
user_000545,71,30k-50k,desktop,new,East,30,True,142,2,0,True,True,True,108,4,0,7.035295586912695,34,-2
user_000546,50,50k-75k,desktop,returning,South,16,True,133,2,0,True,True,True,135,1,0,9.672709436649287,-2,1
user_000547,44,100k-150k,tablet,returning,East,43,True,52,3,0,False,False,True,35,6,0,6.94271197830149,17,-3
user_000548,59,75k-100k,desktop,returning,South,24,True,134,4,0,False,False,True,121,4,0,9.047227827120834,13,0
user_000549,41,50k-75k,mobile,returning,South,40,True,59,5,0,True,False,True,67,2,0,7.326809670337008,-8,3
user_000550,78,>150k,mobile,returning,Midwest,42,False,0,0,0,True,False,True,119,2,0,9.40553043599073,-119,-2
user_000551,48,30k-50k,desktop,returning,Midwest,28,True,133,2,0,False,True,False,0,0,0,,133,2
user_000552,36,30k-50k,mobile,new,West,72,True,82,7,0,True,True,True,70,3,0,9.929341462469687,12,4
user_000553,63,100k-150k,tablet,returning,West,52,True,144,2,0,True,False,True,129,3,0,5.020881604776213,15,-1
user_000554,37,50k-75k,mobile,returning,South,52,False,0,0,0,True,True,True,103,1,0,9.300070572300022,-103,-1
user_000555,32,75k-100k,mobile,new,South,51,False,0,0,0,True,True,True,127,1,0,7.61818313896798,-127,-1
user_000556,35,<30k,desktop,returning,Midwest,41,True,139,1,0,False,False,True,133,1,0,7.291661289106735,6,0
user_000557,30,50k-75k,mobile,new,East,59,True,124,5,2,False,True,True,116,3,0,9.838110400958897,8,2
user_000558,35,30k-50k,desktop,returning,East,56,True,111,4,0,False,True,True,84,5,0,9.672458677301751,27,-1
user_000559,37,50k-75k,mobile,returning,South,65,True,101,4,0,True,False,True,68,2,0,7.965429052098715,33,2
user_000560,47,100k-150k,mobile,new,West,43,True,105,2,0,False,False,True,121,1,0,7.629881512817343,-16,1
user_000561,18,75k-100k,desktop,returning,East,95,True,87,5,0,True,True,True,103,3,0,5.562005513095308,-16,2
user_000562,36,100k-150k,mobile,new,East,69,True,85,3,0,True,False,True,62,1,0,7.376246325178349,23,2
user_000563,38,75k-100k,mobile,new,East,68,True,149,3,0,True,True,True,113,3,0,9.646340590298271,36,0
user_000564,55,75k-100k,mobile,returning,West,87,True,83,5,0,False,True,False,0,0,0,,83,5
user_000565,46,100k-150k,mobile,new,West,94,True,113,6,0,False,False,True,82,5,0,7.732304394078838,31,1
user_000566,46,75k-100k,mobile,new,West,63,True,125,1,1,False,False,True,96,1,0,6.140479669733119,29,0
user_000567,58,100k-150k,mobile,returning,Midwest,38,True,72,3,0,False,True,True,63,3,0,10.0,9,0
user_000568,58,100k-150k,desktop,returning,East,72,True,78,2,0,False,True,True,60,1,0,9.473190964358128,18,1
user_000569,20,>150k,mobile,new,West,89,True,86,2,0,True,True,True,63,3,0,8.63792210475486,23,-1
user_000570,54,30k-50k,desktop,returning,West,57,True,139,1,1,False,False,True,139,1,0,5.086015997669909,0,0
user_000571,46,<30k,mobile,new,Midwest,0,False,0,0,0,False,True,True,111,1,0,6.401877211534529,-111,-1
user_000572,52,30k-50k,desktop,returning,South,67,True,66,1,0,False,True,True,20,2,1,5.416112250822426,46,-1
user_000573,30,100k-150k,desktop,returning,West,100,True,111,4,0,True,True,True,99,2,0,10.0,12,2
user_000574,62,50k-75k,desktop,returning,South,13,False,0,0,0,False,False,True,148,1,1,7.234982294790015,-148,-1
user_000575,63,30k-50k,mobile,new,East,31,False,0,0,0,True,True,True,80,2,0,8.528608607124347,-80,-2
user_000576,18,<30k,desktop,returning,East,58,True,113,3,0,True,True,True,87,3,0,6.308224516786709,26,0
user_000577,58,50k-75k,mobile,new,West,46,True,86,2,0,False,True,False,0,0,0,,86,2
user_000578,48,30k-50k,desktop,returning,South,64,True,53,3,0,False,True,True,42,3,0,5.287733430751506,11,0
user_000579,43,75k-100k,desktop,returning,East,51,True,73,5,0,True,False,True,72,8,0,7.247817887418389,1,-3
user_000580,67,50k-75k,desktop,new,South,39,True,179,2,0,False,False,True,154,3,0,7.717522129926067,25,-1
user_000581,48,<30k,desktop,returning,West,31,True,112,1,0,True,True,True,108,1,0,6.314820299964596,4,0
user_000582,18,30k-50k,desktop,returning,South,52,False,0,0,0,False,True,True,83,1,0,8.25956649349798,-83,-1
user_000583,53,<30k,mobile,returning,East,19,True,122,4,0,True,False,True,124,8,0,5.264306215589028,-2,-4
user_000584,43,30k-50k,desktop,returning,South,64,True,30,4,1,False,True,True,20,1,1,6.87572762026783,10,3
user_000585,22,50k-75k,mobile,returning,East,27,True,102,4,0,True,False,True,112,6,0,6.162766197089099,-10,-2
user_000586,38,100k-150k,mobile,returning,South,77,True,108,2,0,True,True,True,100,1,0,6.10248963462592,8,1
user_000587,47,50k-75k,mobile,returning,West,66,False,0,0,0,False,True,True,77,1,0,7.46007774888021,-77,-1
user_000588,51,50k-75k,mobile,returning,East,35,True,63,6,0,False,True,True,46,6,0,9.089134173256122,17,0
user_000589,30,>150k,desktop,returning,West,91,True,30,2,0,False,True,True,20,1,0,7.040391061091847,10,1
user_000590,55,75k-100k,desktop,returning,West,29,True,131,1,2,True,False,True,122,3,0,5.765512581557017,9,-2
user_000591,24,50k-75k,desktop,returning,Midwest,54,True,147,2,1,False,True,True,107,3,1,7.2306214146438865,40,-1
user_000592,36,<30k,mobile,returning,Midwest,38,True,124,3,0,False,False,True,143,4,0,6.129042038741211,-19,-1
user_000593,43,50k-75k,mobile,new,South,37,False,0,0,0,False,True,True,112,2,0,7.628595940688245,-112,-2
user_000594,71,30k-50k,desktop,returning,West,45,True,87,4,0,False,False,True,83,6,0,9.011456235135158,4,-2
user_000595,48,>150k,mobile,returning,South,70,True,102,2,0,True,True,True,90,1,0,6.790044337698914,12,1
user_000596,34,75k-100k,mobile,returning,East,97,False,0,0,0,True,True,True,95,1,0,7.129974338073784,-95,-1
user_000597,63,75k-100k,desktop,new,South,32,True,156,2,0,False,False,True,171,1,0,5.8432656912593055,-15,1
user_000598,44,50k-75k,mobile,returning,East,68,True,82,2,1,True,True,True,37,1,0,6.414459810774763,45,1
user_000599,43,50k-75k,mobile,returning,East,56,True,106,3,0,False,False,True,82,2,0,6.835363884622644,24,1
user_000600,43,75k-100k,mobile,returning,South,53,True,76,2,0,True,True,True,59,1,0,6.228523423628722,17,1
user_000601,69,75k-100k,mobile,returning,West,61,True,121,5,0,True,True,True,111,3,0,7.110967095179943,10,2
user_000602,25,75k-100k,mobile,returning,West,88,True,36,3,0,True,True,True,20,5,0,8.60694110279164,16,-2
user_000603,40,30k-50k,desktop,returning,West,41,True,107,3,0,True,True,True,97,3,0,10.0,10,0
user_000604,60,75k-100k,desktop,new,East,59,True,171,3,0,False,True,True,111,3,0,7.499318197714023,60,0
user_000605,52,30k-50k,mobile,new,South,39,True,67,2,0,False,False,True,94,1,0,7.2612915653580945,-27,1
user_000606,18,100k-150k,mobile,new,West,100,True,66,2,1,False,True,True,38,3,0,9.119298722151525,28,-1
user_000607,43,<30k,desktop,new,South,34,True,84,2,1,False,False,True,121,2,1,5.368192612876111,-37,0
user_000608,59,50k-75k,mobile,returning,East,19,True,164,5,0,False,False,True,143,9,0,6.65915212898729,21,-4
user_000609,43,30k-50k,desktop,returning,East,40,True,95,1,1,False,False,True,54,1,0,9.238735819997506,41,0
user_000610,43,100k-150k,desktop,new,West,61,True,141,4,1,True,False,True,163,2,0,6.662447616796516,-22,2
user_000611,18,30k-50k,desktop,new,West,74,True,97,1,0,False,False,False,0,0,0,,97,1
user_000612,64,30k-50k,mobile,returning,West,49,True,123,6,0,False,True,True,101,5,0,9.2859967754537,22,1
user_000613,27,75k-100k,mobile,new,East,43,True,167,2,1,False,True,True,153,2,0,8.270529310798336,14,0
user_000614,30,75k-100k,mobile,new,East,79,True,105,7,1,True,True,True,61,8,0,7.5664303625028095,44,-1
user_000615,29,75k-100k,mobile,returning,South,53,True,30,3,0,False,True,True,49,1,0,6.838812286053774,-19,2
user_000616,59,50k-75k,mobile,returning,South,37,True,137,10,0,True,True,True,110,10,0,9.937887111166186,27,0
user_000617,27,50k-75k,mobile,returning,East,83,True,52,2,0,False,True,True,66,1,0,7.962244189940785,-14,1
user_000618,58,<30k,tablet,new,South,47,False,0,0,0,False,False,True,71,1,0,8.351788743290843,-71,-1
user_000619,21,100k-150k,mobile,returning,Midwest,51,True,109,3,1,True,True,True,123,3,0,9.225852931537663,-14,0
user_000620,47,30k-50k,desktop,returning,West,66,True,94,1,0,True,False,False,0,0,0,,94,1
user_000621,30,100k-150k,desktop,returning,West,84,True,82,1,0,True,True,True,56,2,0,8.375885188482949,26,-1
user_000622,58,75k-100k,mobile,returning,West,51,True,83,1,0,False,True,False,0,0,0,,83,1
user_000623,56,30k-50k,desktop,returning,Midwest,56,True,134,4,0,False,False,True,118,4,0,5.945454590544108,16,0
user_000624,29,50k-75k,mobile,returning,West,91,True,30,1,0,True,True,True,20,1,0,9.12192192728143,10,0
user_000625,49,75k-100k,desktop,new,West,45,True,146,5,0,True,False,True,134,6,1,8.69297688436769,12,-1
user_000626,56,100k-150k,mobile,returning,East,49,True,106,4,0,True,True,True,85,1,0,7.373442296063363,21,3
user_000627,28,30k-50k,desktop,new,West,100,True,148,2,0,False,False,True,105,5,0,8.631770707066657,43,-3
user_000628,47,50k-75k,mobile,new,Midwest,59,True,125,6,0,False,True,True,94,5,0,8.584012023283062,31,1
user_000629,19,50k-75k,desktop,new,West,95,True,85,6,0,False,True,True,79,5,0,9.469530933706606,6,1
user_000630,48,100k-150k,mobile,new,Midwest,32,True,93,3,0,False,False,True,66,3,0,6.603231335730342,27,0
user_000631,50,75k-100k,desktop,returning,Midwest,47,True,74,3,0,True,True,True,79,1,0,7.12607320877739,-5,2
user_000632,62,30k-50k,mobile,new,West,66,False,0,0,0,False,True,False,0,0,0,,0,0
user_000633,54,50k-75k,mobile,returning,East,79,True,96,1,0,True,True,True,84,1,0,8.702505584576445,12,0
user_000634,48,30k-50k,mobile,new,South,54,True,134,7,0,False,True,True,95,6,0,7.445365780084452,39,1
user_000635,31,<30k,mobile,returning,South,75,False,0,0,0,True,True,True,57,1,0,8.353787758318742,-57,-1
user_000636,46,30k-50k,mobile,returning,South,53,True,113,3,0,False,True,True,105,5,0,8.454948359683085,8,-2
user_000637,21,50k-75k,mobile,returning,East,92,True,85,1,0,True,True,True,57,1,0,9.937717705826715,28,0
user_000638,66,30k-50k,mobile,new,West,7,True,122,8,0,False,False,True,114,11,1,8.002890305395638,8,-3
user_000639,26,100k-150k,tablet,returning,South,63,True,119,1,0,True,True,True,87,1,0,7.320064364214817,32,0
user_000640,50,50k-75k,desktop,returning,East,35,True,127,3,0,False,True,True,124,4,0,8.872528848218654,3,-1
user_000641,52,<30k,desktop,returning,Midwest,40,False,0,0,0,True,False,True,150,1,0,6.135121549331026,-150,-1
user_000642,76,50k-75k,desktop,returning,West,29,True,138,4,0,True,False,True,104,5,0,6.201969252816039,34,-1
user_000643,44,100k-150k,mobile,new,South,45,True,124,4,1,False,True,True,49,2,0,6.765805419912117,75,2
user_000644,47,50k-75k,desktop,new,West,46,True,115,3,0,False,False,True,98,3,0,8.188255343810368,17,0
user_000645,44,50k-75k,mobile,returning,South,36,False,0,0,0,True,True,True,90,1,0,8.172357000785837,-90,-1
user_000646,68,75k-100k,mobile,new,Midwest,38,False,0,0,0,True,True,True,73,1,0,7.589863550094218,-73,-1
user_000647,52,50k-75k,desktop,returning,West,86,True,116,2,0,True,True,True,82,1,0,8.196086748034167,34,1
user_000648,29,50k-75k,desktop,new,East,88,True,115,3,0,True,True,True,78,1,0,9.802640786665494,37,2
user_000649,55,75k-100k,mobile,returning,East,47,True,99,1,0,True,False,True,97,1,0,6.388738694053695,2,0
user_000650,36,30k-50k,mobile,returning,South,42,True,106,3,1,False,True,False,0,0,0,,106,3
user_000651,27,30k-50k,desktop,new,Midwest,39,True,140,5,0,True,True,True,132,3,0,7.340764555865514,8,2
user_000652,34,<30k,desktop,returning,East,89,True,81,2,0,True,True,True,33,2,0,7.507463158390901,48,0
user_000653,51,75k-100k,mobile,returning,South,46,True,64,1,0,False,True,True,34,1,0,8.695398485120775,30,0
user_000654,19,30k-50k,desktop,returning,Midwest,49,True,90,6,1,False,True,False,0,0,0,,90,6
user_000655,77,<30k,mobile,new,Midwest,37,True,90,2,0,True,False,True,84,2,0,6.973222506584851,6,0
user_000656,32,100k-150k,desktop,new,South,81,True,77,2,0,True,True,False,0,0,0,,77,2
user_000657,43,50k-75k,desktop,returning,East,48,True,105,1,1,False,False,False,0,0,0,,105,1
user_000658,52,50k-75k,desktop,new,South,67,False,0,0,0,True,True,False,0,0,0,,0,0
user_000659,52,100k-150k,mobile,returning,Midwest,68,True,81,1,0,True,True,True,70,1,0,10.0,11,0
user_000660,51,30k-50k,desktop,new,South,7,True,190,1,1,False,False,True,172,1,0,7.579898167075604,18,0
user_000661,34,50k-75k,desktop,returning,East,63,True,135,2,0,False,True,True,127,3,0,8.442534088163356,8,-1
user_000662,57,50k-75k,desktop,returning,West,48,True,77,4,1,False,False,True,93,2,0,8.695496385984931,-16,2
user_000663,51,50k-75k,mobile,returning,West,66,True,69,4,0,True,True,True,40,1,0,9.849262679242921,29,3
user_000664,51,50k-75k,mobile,returning,Midwest,61,True,71,2,0,False,True,True,95,2,0,9.039146106852867,-24,0
user_000665,79,75k-100k,desktop,returning,South,43,True,69,4,0,False,False,True,71,6,0,8.399257135671348,-2,-2
user_000666,47,30k-50k,desktop,returning,West,50,True,114,3,0,True,True,True,90,4,0,7.5673199218521745,24,-1
user_000667,43,75k-100k,desktop,new,Midwest,32,True,98,2,1,False,True,True,49,3,0,7.798485875674253,49,-1
user_000668,43,30k-50k,mobile,new,East,41,True,115,5,0,False,True,True,88,4,1,7.797640508369709,27,1
user_000669,45,50k-75k,desktop,returning,South,27,True,88,9,0,True,False,True,20,13,1,5.758157526312856,68,-4
user_000670,47,<30k,mobile,returning,Midwest,50,True,86,4,1,False,True,True,45,2,0,8.608917529159474,41,2
user_000671,47,>150k,mobile,new,West,54,True,125,1,0,False,True,True,131,2,0,7.180951944615745,-6,-1
user_000672,38,75k-100k,mobile,returning,South,41,True,88,1,0,True,True,True,59,1,1,7.869696227806468,29,0
user_000673,34,30k-50k,mobile,new,East,50,True,89,2,1,False,False,True,109,1,0,4.779772855885409,-20,1
user_000674,59,>150k,desktop,returning,West,28,True,150,5,0,False,False,True,164,3,0,6.396537208349027,-14,2
user_000675,40,<30k,mobile,returning,Midwest,0,True,79,5,1,False,False,True,48,6,0,4.9569694644252635,31,-1
user_000676,67,50k-75k,mobile,new,West,54,True,88,3,1,False,True,True,50,4,1,9.304634023329005,38,-1
user_000677,52,30k-50k,mobile,new,West,51,True,106,1,0,False,False,True,56,1,0,6.090252779273439,50,0
user_000678,42,75k-100k,desktop,returning,South,39,True,60,3,0,False,True,True,51,5,0,8.437794546730597,9,-2
user_000679,45,30k-50k,desktop,returning,West,60,True,93,2,0,False,False,True,103,4,0,7.700496597610374,-10,-2
user_000680,52,30k-50k,mobile,returning,South,36,False,0,0,0,True,False,True,79,1,0,7.700764153804341,-79,-1
user_000681,51,30k-50k,desktop,returning,Midwest,52,False,0,0,0,True,False,True,113,4,0,6.322486832007546,-113,-4
user_000682,64,100k-150k,mobile,returning,West,26,True,108,6,1,False,False,True,59,9,0,8.661526614113441,49,-3
user_000683,30,50k-75k,desktop,returning,West,100,True,90,3,0,False,True,True,70,2,0,8.594257645645248,20,1
user_000684,36,<30k,mobile,returning,South,17,True,130,5,0,False,False,True,113,7,0,8.165293165108292,17,-2
user_000685,67,75k-100k,desktop,returning,East,62,True,71,1,0,True,False,True,92,2,0,5.6476433737515785,-21,-1
user_000686,55,30k-50k,desktop,returning,Midwest,32,True,113,2,0,False,False,True,132,4,0,7.5749819978367645,-19,-2
user_000687,58,<30k,mobile,returning,Midwest,3,True,149,3,1,False,False,True,113,6,0,7.20321024695395,36,-3
user_000688,28,50k-75k,desktop,returning,Midwest,64,True,96,1,0,False,False,True,80,1,0,10.0,16,0
user_000689,18,30k-50k,mobile,returning,East,69,True,81,4,0,False,True,True,65,7,0,9.75434486319778,16,-3
user_000690,43,75k-100k,mobile,returning,South,25,True,151,6,0,True,True,True,113,7,0,7.443909998601794,38,-1
user_000691,59,<30k,desktop,returning,East,25,False,0,0,0,True,True,False,0,0,0,,0,0
user_000692,48,30k-50k,mobile,returning,Midwest,58,True,70,1,1,False,True,True,59,1,0,7.004736864966283,11,0
user_000693,25,100k-150k,mobile,returning,South,84,True,101,1,0,True,True,True,41,1,0,10.0,60,0
user_000694,76,30k-50k,mobile,new,East,54,False,0,0,0,False,False,True,122,1,0,6.973899783709529,-122,-1
user_000695,46,50k-75k,desktop,new,West,40,True,141,4,0,False,False,False,0,0,0,,141,4
user_000696,61,30k-50k,mobile,returning,South,39,True,85,6,0,True,False,True,93,6,0,6.911749354796976,-8,0
user_000697,79,100k-150k,mobile,new,South,22,True,145,2,1,False,False,True,163,1,1,7.553350912130375,-18,1
user_000698,30,75k-100k,desktop,returning,South,80,False,0,0,0,True,True,True,87,1,0,9.176953508376439,-87,-1
user_000699,32,100k-150k,mobile,new,South,69,True,153,8,0,True,True,True,126,5,0,10.0,27,3
user_000700,56,<30k,desktop,returning,Midwest,8,True,138,1,0,False,False,True,156,1,1,6.295065024250728,-18,0
user_000701,45,75k-100k,mobile,returning,West,61,True,84,1,0,True,True,True,41,1,0,9.31986637546507,43,0
user_000702,30,100k-150k,mobile,returning,South,75,True,68,1,0,False,True,True,25,1,0,7.094791685240493,43,0
user_000703,18,75k-100k,desktop,returning,West,80,True,89,4,0,False,True,True,61,6,0,8.727141457813191,28,-2
user_000704,21,50k-75k,desktop,returning,West,70,False,0,0,0,True,True,False,0,0,0,,0,0
user_000705,51,30k-50k,desktop,returning,East,54,True,60,1,0,False,True,True,91,1,0,8.9569809381586,-31,0
user_000706,37,100k-150k,mobile,returning,East,62,False,0,0,0,True,True,True,93,1,1,8.722413909309038,-93,-1
user_000707,48,50k-75k,mobile,new,East,53,True,119,3,0,False,False,True,114,1,1,7.569412599500628,5,2
user_000708,51,30k-50k,desktop,returning,South,32,True,58,3,0,False,False,True,54,3,0,9.563208404183511,4,0
user_000709,47,100k-150k,desktop,new,East,98,True,125,2,0,False,False,True,136,1,0,7.4419040889455195,-11,1
user_000710,62,<30k,mobile,returning,South,1,True,122,6,0,True,True,True,83,5,0,8.773501871685578,39,1
user_000711,60,75k-100k,desktop,returning,East,48,False,0,0,0,False,False,True,121,1,0,5.763400088771724,-121,-1
user_000712,46,75k-100k,mobile,returning,West,57,True,32,1,0,True,False,True,65,1,0,8.310811962732915,-33,0
user_000713,47,50k-75k,desktop,returning,West,78,True,104,2,0,False,True,True,57,2,0,8.702151359688397,47,0
user_000714,64,30k-50k,desktop,returning,Midwest,27,False,0,0,0,False,False,True,127,1,0,8.22688238503301,-127,-1
user_000715,63,100k-150k,desktop,new,South,60,True,123,1,0,True,True,True,94,1,0,8.7683839465934,29,0
user_000716,58,50k-75k,desktop,returning,West,41,True,49,1,0,True,True,True,23,4,0,6.214090144612361,26,-3
user_000717,31,<30k,tablet,returning,Midwest,42,True,112,1,0,False,False,True,116,1,0,7.274936371995755,-4,0
user_000718,51,100k-150k,mobile,returning,East,65,True,93,6,1,True,True,True,87,6,0,6.6186864953669335,6,0
user_000719,60,50k-75k,mobile,new,East,32,True,88,2,1,False,False,True,93,1,0,7.59759447835264,-5,1
user_000720,42,50k-75k,desktop,new,South,43,False,0,0,0,True,False,True,95,2,0,6.934382197933586,-95,-2
user_000721,35,75k-100k,desktop,returning,East,58,True,81,1,0,False,True,True,71,1,0,6.750793738059456,10,0
user_000722,57,100k-150k,desktop,returning,East,37,False,0,0,0,True,False,True,131,2,0,7.158956890282522,-131,-2
user_000723,56,50k-75k,mobile,returning,South,28,True,100,1,0,False,False,True,86,1,0,6.372405939037782,14,0
user_000724,34,30k-50k,mobile,new,East,77,False,0,0,0,True,True,True,96,1,0,7.557923776447217,-96,-1
user_000725,30,<30k,mobile,returning,South,52,True,92,3,1,True,True,True,80,3,0,9.225634466247914,12,0
user_000726,36,50k-75k,mobile,returning,Midwest,49,True,41,4,0,False,True,True,32,4,0,9.61159409328836,9,0
user_000727,63,<30k,tablet,new,West,28,False,0,0,0,False,False,True,139,2,0,7.472776554590782,-139,-2
user_000728,49,30k-50k,mobile,returning,East,49,False,0,0,0,False,False,True,98,1,0,7.699828253658206,-98,-1
user_000729,48,50k-75k,tablet,returning,West,60,True,131,1,0,False,False,True,134,1,0,9.335594264505227,-3,0
user_000730,54,100k-150k,mobile,returning,East,56,True,103,2,1,True,True,False,0,0,0,,103,2
user_000731,33,30k-50k,desktop,new,East,58,False,0,0,0,True,True,True,112,1,0,7.426946249197965,-112,-1
user_000732,18,<30k,mobile,returning,East,41,False,0,0,0,False,False,True,80,3,0,6.3438359408528795,-80,-3
user_000733,42,100k-150k,desktop,returning,East,60,True,59,5,0,False,False,True,92,3,0,7.236075555819896,-33,2
user_000734,49,30k-50k,mobile,new,South,31,True,125,1,0,False,True,True,77,1,0,10.0,48,0
user_000735,47,<30k,mobile,returning,West,69,True,89,6,0,True,False,True,66,5,0,7.794491690125608,23,1
user_000736,48,<30k,tablet,new,South,31,True,124,1,0,True,False,True,145,1,0,6.237772686547858,-21,0
user_000737,42,<30k,desktop,returning,South,38,True,105,2,0,False,False,True,115,4,0,8.4613460973096,-10,-2
user_000738,26,30k-50k,mobile,returning,East,72,True,30,1,1,True,True,True,20,2,0,6.803803053257607,10,-1
user_000739,54,75k-100k,mobile,new,East,62,True,170,4,1,True,True,True,171,3,0,9.17120099858705,-1,1
user_000740,26,75k-100k,mobile,returning,West,53,True,69,7,0,False,True,True,51,5,0,6.054078292514612,18,2
user_000741,39,<30k,mobile,returning,South,33,True,89,3,0,True,True,True,77,2,0,9.89221979070706,12,1
user_000742,39,30k-50k,mobile,returning,West,64,True,77,2,0,True,True,True,43,2,0,10.0,34,0
user_000743,27,>150k,mobile,returning,East,92,True,86,4,0,False,True,True,89,1,0,9.23049144128477,-3,3
user_000744,62,<30k,desktop,returning,South,27,True,117,2,1,False,False,False,0,0,0,,117,2
user_000745,30,<30k,mobile,new,Midwest,49,True,106,2,1,True,True,True,111,1,0,7.403835518544229,-5,1
user_000746,35,50k-75k,desktop,returning,West,49,True,115,1,0,False,False,True,118,1,0,6.10190040857718,-3,0
user_000747,61,30k-50k,desktop,returning,Midwest,23,True,125,3,0,False,False,True,100,5,0,6.857567825066263,25,-2
user_000748,64,30k-50k,desktop,returning,West,28,True,163,3,1,True,False,True,167,8,0,5.827042232254865,-4,-5
user_000749,24,<30k,desktop,new,West,78,True,88,3,0,False,False,True,112,4,1,8.595684967114632,-24,-1
user_000750,44,50k-75k,mobile,new,East,46,True,142,6,1,True,False,True,142,6,0,5.053670379341733,0,0
user_000751,49,<30k,mobile,returning,West,74,True,113,3,0,True,True,True,92,5,0,8.814587065552004,21,-2
user_000752,28,100k-150k,desktop,returning,West,72,True,30,2,0,True,True,True,28,2,0,5.994784233412093,2,0
user_000753,59,75k-100k,mobile,returning,Midwest,33,True,42,6,0,True,True,True,47,7,0,10.0,-5,-1
user_000754,49,<30k,mobile,returning,West,52,True,97,3,0,False,True,True,91,3,0,5.423441480040762,6,0
user_000755,18,50k-75k,mobile,returning,East,67,True,91,2,0,False,True,True,97,1,0,8.69960255533885,-6,1
user_000756,33,100k-150k,desktop,returning,South,51,True,139,4,1,True,True,True,122,1,0,7.7966440795519585,17,3
user_000757,65,100k-150k,mobile,returning,South,55,True,56,4,0,False,False,True,91,2,1,7.459883167405063,-35,2
user_000758,70,100k-150k,desktop,returning,West,45,True,81,1,0,True,True,True,63,2,0,8.14141319136956,18,-1
user_000759,53,50k-75k,desktop,returning,Midwest,33,True,120,3,0,False,False,True,99,3,0,6.031239546901079,21,0
user_000760,22,50k-75k,mobile,new,Midwest,63,True,179,1,1,False,False,True,165,2,0,5.326840272397956,14,-1
user_000761,59,>150k,desktop,returning,East,49,True,70,3,0,True,True,True,33,1,0,8.226917156656608,37,2
user_000762,41,50k-75k,desktop,new,East,44,True,148,3,0,False,False,True,139,3,0,8.277966616628277,9,0
user_000763,59,<30k,mobile,returning,West,41,False,0,0,0,False,True,True,94,1,0,9.70839869629087,-94,-1
user_000764,58,50k-75k,mobile,returning,Midwest,41,True,157,6,0,True,True,True,145,4,0,7.376730413491348,12,2
user_000765,39,>150k,desktop,new,Midwest,48,True,87,1,0,False,True,True,106,2,0,7.54090705514479,-19,-1
user_000766,38,100k-150k,desktop,returning,East,78,True,84,2,0,True,True,True,36,3,0,8.685499908428987,48,-1
user_000767,40,100k-150k,mobile,returning,South,40,True,93,1,0,False,True,True,57,2,0,7.0732963149401655,36,-1
user_000768,36,30k-50k,desktop,returning,Midwest,35,True,117,1,0,True,False,True,109,1,0,7.847052160781543,8,0
user_000769,34,<30k,mobile,returning,South,83,True,120,3,0,True,True,True,87,1,0,7.787623554191886,33,2
user_000770,35,>150k,desktop,returning,East,70,True,100,3,1,False,True,True,58,1,0,7.56947438324439,42,2
user_000771,39,30k-50k,desktop,returning,Midwest,28,True,177,3,1,True,False,True,174,1,1,6.163867084436633,3,2
user_000772,52,75k-100k,tablet,returning,South,66,True,119,3,0,False,True,True,124,1,0,7.638167119878045,-5,2
user_000773,80,30k-50k,desktop,returning,Midwest,13,True,161,3,0,False,False,True,162,4,1,8.251447190005992,-1,-1
user_000774,73,30k-50k,desktop,new,South,18,True,148,2,1,False,False,True,159,2,0,6.221953435506715,-11,0
user_000775,18,50k-75k,mobile,returning,East,70,True,99,6,0,True,True,True,50,5,0,10.0,49,1
user_000776,69,75k-100k,mobile,returning,East,40,True,87,3,0,True,False,True,118,3,0,6.438165148030098,-31,0
user_000777,24,50k-75k,mobile,returning,East,78,True,30,2,0,False,False,True,77,1,1,7.809098099052524,-47,1
user_000778,37,50k-75k,mobile,new,West,69,True,111,2,0,False,True,True,68,2,0,8.47266275198209,43,0
user_000779,30,30k-50k,desktop,returning,West,82,True,91,1,0,True,True,True,59,6,0,9.931726271993977,32,-5
user_000780,43,<30k,mobile,returning,West,41,False,0,0,0,False,True,True,96,1,0,7.224910192085244,-96,-1
user_000781,77,100k-150k,mobile,returning,West,38,True,95,7,0,True,False,True,115,1,0,7.483038078899485,-20,6
user_000782,33,50k-75k,mobile,new,West,76,True,145,1,0,False,True,True,143,1,0,8.876275114286845,2,0
user_000783,68,75k-100k,tablet,returning,South,42,True,95,3,0,True,True,True,94,1,0,6.287150039509923,1,2
user_000784,32,30k-50k,desktop,returning,East,84,True,81,3,0,False,True,True,77,1,1,8.591115124584153,4,2
user_000785,48,30k-50k,desktop,new,East,61,True,63,4,0,True,True,True,40,1,0,7.760857582477031,23,3
user_000786,55,50k-75k,mobile,new,South,87,True,54,5,0,False,True,True,22,7,0,9.247889296224672,32,-2
user_000787,33,<30k,mobile,returning,East,62,True,113,4,0,True,True,True,84,1,0,7.682689018085909,29,3
user_000788,66,75k-100k,desktop,returning,West,51,True,134,3,0,True,True,True,80,3,0,9.155136289653958,54,0
user_000789,30,50k-75k,desktop,returning,South,69,True,80,6,0,True,False,True,80,8,0,7.9250269118579455,0,-2
user_000790,27,30k-50k,mobile,returning,South,80,True,77,3,0,False,True,True,68,2,0,9.654312880974297,9,1
user_000791,38,30k-50k,desktop,returning,West,61,True,77,1,0,False,True,True,20,1,0,9.14837055736472,57,0
user_000792,39,30k-50k,desktop,new,South,40,False,0,0,0,True,True,True,106,1,1,5.597916642375155,-106,-1
user_000793,64,30k-50k,desktop,returning,Midwest,26,True,140,4,0,False,False,True,130,2,0,8.494619479810757,10,2
user_000794,62,100k-150k,mobile,returning,South,39,True,75,4,0,True,True,True,20,2,0,9.899456054388347,55,2
user_000795,28,<30k,desktop,returning,South,76,True,74,3,0,False,True,True,67,2,0,8.157377021575076,7,1
user_000796,53,100k-150k,mobile,new,Midwest,51,True,111,4,0,False,True,True,100,7,0,8.015481554681967,11,-3
user_000797,65,75k-100k,mobile,returning,East,48,False,0,0,0,True,True,False,0,0,0,,0,0
user_000798,41,>150k,mobile,returning,East,68,True,109,6,0,True,True,True,84,11,0,7.70492221244483,25,-5
user_000799,68,100k-150k,mobile,new,South,22,True,85,3,0,False,False,False,0,0,0,,85,3
user_000800,41,50k-75k,desktop,new,West,31,False,0,0,0,False,True,True,97,1,0,6.989628165125478,-97,-1
user_000801,59,30k-50k,mobile,returning,West,48,False,0,0,0,True,True,True,92,1,0,9.506271495961498,-92,-1
user_000802,33,30k-50k,desktop,returning,East,94,False,0,0,0,True,True,True,134,1,0,7.645128751236568,-134,-1
user_000803,43,50k-75k,mobile,returning,Midwest,39,True,113,4,0,True,True,True,88,3,0,7.036349118722906,25,1
user_000804,54,>150k,mobile,returning,South,84,True,98,3,1,False,True,True,111,4,0,7.261796959124336,-13,-1
user_000805,50,75k-100k,desktop,returning,East,48,True,105,3,0,True,False,True,108,1,0,5.349368526975333,-3,2
user_000806,46,75k-100k,mobile,returning,East,38,True,112,2,0,False,False,True,129,1,0,5.993165895218168,-17,1
user_000807,35,50k-75k,desktop,new,South,46,True,126,3,0,False,True,True,100,4,0,8.448749435671788,26,-1
user_000808,38,>150k,desktop,new,East,76,True,94,2,0,False,True,True,51,1,0,8.430333629650185,43,1
user_000809,21,30k-50k,mobile,new,South,62,False,0,0,0,True,True,True,67,1,0,9.866931893945026,-67,-1
user_000810,44,30k-50k,mobile,returning,East,54,True,43,1,0,False,True,True,55,1,1,9.489127024861768,-12,0
user_000811,49,30k-50k,desktop,returning,Midwest,37,True,54,3,0,True,True,True,62,1,0,7.798842169413963,-8,2
user_000812,37,30k-50k,mobile,new,West,65,True,150,3,0,True,True,True,139,2,0,9.184817312069686,11,1
user_000813,50,50k-75k,desktop,returning,West,63,True,107,1,0,True,False,True,95,1,0,7.618797669149756,12,0
user_000814,61,50k-75k,desktop,returning,East,11,False,0,0,0,False,False,True,123,1,0,6.247099552073464,-123,-1
user_000815,48,100k-150k,tablet,returning,East,48,True,107,3,0,False,False,True,105,1,1,8.374447355585753,2,2
user_000816,46,30k-50k,mobile,returning,South,35,True,77,5,1,False,False,True,57,1,0,5.839260432381197,20,4
user_000817,32,<30k,mobile,returning,East,43,True,114,3,0,True,False,True,127,3,0,6.389953186296639,-13,0
user_000818,56,<30k,mobile,returning,South,0,True,94,2,0,True,False,True,117,1,1,9.034921208007898,-23,1
user_000819,45,100k-150k,mobile,returning,South,68,True,103,3,0,True,False,True,125,4,1,7.346403629743926,-22,-1
user_000820,49,<30k,mobile,returning,Midwest,7,False,0,0,0,True,True,True,79,1,0,8.294633806467402,-79,-1
user_000821,44,50k-75k,mobile,new,South,62,True,126,4,0,False,True,True,110,4,1,7.899136301531787,16,0
user_000822,49,75k-100k,mobile,returning,Midwest,45,True,64,6,0,False,False,True,38,9,0,6.903770528986977,26,-3
user_000823,21,75k-100k,mobile,returning,West,62,True,111,1,0,False,True,True,54,1,0,8.287767046581312,57,0
user_000824,18,50k-75k,desktop,returning,South,78,False,0,0,0,True,True,True,90,2,0,7.693255296896974,-90,-2
user_000825,47,100k-150k,mobile,new,East,97,True,126,2,0,True,True,True,101,2,0,7.750071301522274,25,0
user_000826,48,50k-75k,tablet,returning,South,28,True,150,2,1,False,False,True,97,1,0,8.415357650891865,53,1
user_000827,43,100k-150k,desktop,returning,East,51,True,106,3,0,False,False,False,0,0,0,,106,3
user_000828,56,50k-75k,desktop,new,South,25,True,220,3,1,False,False,True,222,6,0,8.619221044976808,-2,-3
user_000829,28,>150k,mobile,new,East,98,True,154,3,0,True,True,True,131,2,0,7.559241116290346,23,1
user_000830,24,75k-100k,mobile,new,East,53,False,0,0,0,False,True,True,104,1,0,7.836862450330791,-104,-1
user_000831,43,50k-75k,mobile,new,East,55,True,161,4,0,False,False,True,176,5,0,6.605207503297465,-15,-1
user_000832,62,50k-75k,desktop,returning,West,59,True,112,2,0,False,True,True,75,2,0,7.480058991646575,37,0
user_000833,67,75k-100k,mobile,returning,West,54,True,111,7,0,True,True,True,106,7,0,6.059417942671947,5,0
user_000834,22,30k-50k,desktop,new,South,61,True,92,3,0,True,True,True,62,3,0,8.769541948545049,30,0
user_000835,63,<30k,tablet,new,West,12,True,183,1,0,False,False,True,169,1,0,5.966407112139073,14,0
user_000836,38,50k-75k,mobile,new,West,39,True,93,7,0,True,True,True,79,8,1,7.841089298067996,14,-1
user_000837,35,75k-100k,mobile,returning,East,60,True,72,4,0,False,True,True,55,2,0,6.205694578396158,17,2
user_000838,52,<30k,mobile,new,East,45,False,0,0,0,False,False,True,95,1,0,7.997130245108551,-95,-1
user_000839,47,100k-150k,mobile,returning,East,59,True,93,4,0,False,True,True,80,6,0,9.81010775434989,13,-2
user_000840,33,<30k,mobile,new,Midwest,70,False,0,0,0,False,True,True,81,1,0,10.0,-81,-1
user_000841,55,100k-150k,mobile,returning,Midwest,42,True,112,3,0,True,True,True,53,1,0,7.869498772599658,59,2
user_000842,20,75k-100k,desktop,new,South,72,True,144,3,0,True,True,True,82,2,0,5.7681105964766415,62,1
user_000843,74,50k-75k,mobile,returning,South,45,True,80,2,0,True,True,True,55,1,0,6.713938304782132,25,1
user_000844,30,50k-75k,mobile,new,East,61,True,110,1,0,True,True,True,107,1,0,7.981372566279982,3,0
user_000845,51,50k-75k,mobile,new,East,60,False,0,0,0,False,True,True,80,1,0,8.557475273198113,-80,-1
user_000846,49,<30k,desktop,returning,South,22,True,137,2,0,True,False,True,156,1,0,4.627205684830438,-19,1
user_000847,37,100k-150k,desktop,returning,East,65,True,127,2,1,False,False,True,178,1,1,8.019426384392949,-51,1
user_000848,28,75k-100k,mobile,returning,East,72,True,30,2,0,True,True,True,20,3,0,6.112958787576079,10,-1
user_000849,18,75k-100k,desktop,new,West,100,True,98,1,0,True,True,True,52,3,0,7.604976630623685,46,-2
user_000850,34,<30k,desktop,returning,South,57,True,119,2,0,True,False,False,0,0,0,,119,2
user_000851,34,<30k,mobile,new,West,48,True,133,6,0,False,True,True,119,5,0,7.214549622706301,14,1
user_000852,49,100k-150k,desktop,returning,Midwest,52,True,76,2,1,False,True,True,65,1,0,7.834062834385059,11,1
user_000853,31,30k-50k,desktop,new,South,50,True,85,2,0,False,False,True,107,1,0,9.638257682436201,-22,1
user_000854,52,100k-150k,mobile,returning,Midwest,76,True,69,2,0,False,True,True,69,5,0,9.918545147408198,0,-3
user_000855,43,75k-100k,mobile,returning,South,57,True,100,6,0,True,True,True,34,8,0,9.003163909126732,66,-2
user_000856,34,<30k,mobile,returning,Midwest,54,False,0,0,0,False,False,True,139,1,0,9.301690888498694,-139,-1
user_000857,48,50k-75k,desktop,returning,Midwest,15,True,123,4,0,True,True,True,98,1,1,10.0,25,3
user_000858,65,<30k,tablet,returning,East,8,False,0,0,0,False,False,True,99,2,0,9.519678270852948,-99,-2
user_000859,50,75k-100k,desktop,new,East,37,True,59,3,0,False,False,True,42,4,0,7.256525637311176,17,-1
user_000860,18,<30k,desktop,returning,South,21,True,104,2,0,True,False,True,152,2,0,6.8454231185680685,-48,0
user_000861,62,<30k,desktop,returning,West,30,True,81,3,0,False,False,True,99,3,0,5.138155325344653,-18,0
user_000862,53,100k-150k,mobile,returning,West,85,True,64,3,0,True,True,True,44,3,0,9.381682508193663,20,0
user_000863,31,<30k,desktop,returning,East,61,True,55,3,0,True,True,True,20,3,0,7.627770583190834,35,0
user_000864,62,75k-100k,desktop,new,West,49,True,100,4,0,True,False,True,101,4,0,4.473430013315272,-1,0
user_000865,27,<30k,mobile,returning,South,35,True,56,4,1,False,True,True,20,2,1,7.502542105220967,36,2
user_000866,62,50k-75k,mobile,new,Midwest,57,True,77,4,0,False,True,True,59,2,1,6.123077883824864,18,2
user_000867,57,75k-100k,desktop,new,East,41,True,126,4,1,True,True,True,108,1,0,7.726404537011998,18,3
user_000868,49,>150k,desktop,new,West,94,True,143,6,0,True,True,False,0,0,0,,143,6
user_000869,38,75k-100k,desktop,returning,South,56,True,146,1,0,False,False,True,164,2,0,6.3415949170864,-18,-1
user_000870,27,75k-100k,mobile,returning,West,84,True,90,3,0,False,False,True,95,1,0,5.159906488170743,-5,2
user_000871,51,75k-100k,mobile,new,East,41,True,116,5,0,True,False,True,115,2,0,7.5435204182147295,1,3
user_000872,36,50k-75k,desktop,new,Midwest,38,True,148,1,0,True,True,False,0,0,0,,148,1
user_000873,18,75k-100k,desktop,returning,East,52,True,54,3,0,False,True,True,51,2,0,7.2172407146065245,3,1
user_000874,21,>150k,mobile,new,East,91,True,80,5,0,False,True,True,49,5,0,8.516605560666905,31,0
user_000875,55,100k-150k,mobile,returning,West,78,True,30,1,0,False,True,False,0,0,0,,30,1
user_000876,27,30k-50k,tablet,returning,South,80,True,70,5,0,True,True,True,64,2,0,8.204429626153058,6,3
user_000877,42,30k-50k,mobile,new,West,46,True,71,2,1,False,True,True,60,3,0,9.69470361024783,11,-1
user_000878,37,75k-100k,mobile,new,Midwest,61,False,0,0,0,True,False,True,105,1,0,7.599335443993945,-105,-1
user_000879,24,75k-100k,desktop,returning,Midwest,76,True,45,1,1,False,True,True,29,3,0,7.231549034238467,16,-2
user_000880,52,<30k,desktop,returning,Midwest,21,True,131,2,1,True,True,True,131,2,0,8.091539772560363,0,0
user_000881,56,75k-100k,tablet,returning,Midwest,20,True,118,5,1,True,False,True,111,6,1,7.956611986003597,7,-1
user_000882,29,<30k,desktop,returning,East,89,False,0,0,0,True,True,True,91,1,0,7.502040186416005,-91,-1
user_000883,50,50k-75k,mobile,returning,South,53,True,78,3,0,True,True,True,34,3,0,8.17984663752233,44,0
user_000884,65,30k-50k,mobile,new,South,42,True,94,2,0,False,False,True,105,4,0,6.921369606122004,-11,-2
user_000885,29,30k-50k,desktop,new,East,75,True,67,4,1,True,True,True,21,4,0,7.8120804102270975,46,0
user_000886,31,100k-150k,mobile,returning,East,88,True,77,6,0,True,True,True,93,9,0,8.152813879630857,-16,-3
user_000887,57,<30k,desktop,new,South,1,True,121,4,1,False,False,True,104,5,0,8.924600989002665,17,-1
user_000888,36,>150k,desktop,returning,South,55,True,114,3,0,False,False,True,58,3,0,6.116155669325458,56,0
user_000889,27,30k-50k,desktop,returning,West,100,True,73,5,0,False,False,True,38,6,1,8.371108333978082,35,-1
user_000890,48,30k-50k,tablet,returning,East,35,True,52,2,2,True,False,True,81,3,1,6.721719957188674,-29,-1
user_000891,60,100k-150k,desktop,returning,East,63,True,77,2,0,False,False,True,47,1,0,8.073599264936325,30,1
user_000892,53,30k-50k,mobile,returning,West,27,True,90,4,0,True,True,True,63,3,0,10.0,27,1
user_000893,51,>150k,desktop,returning,East,84,True,117,4,0,True,True,True,92,7,0,8.155264196435738,25,-3
user_000894,28,100k-150k,mobile,returning,Midwest,76,True,41,1,0,True,True,True,20,1,1,7.393959204907403,21,0
user_000895,55,<30k,mobile,returning,West,37,True,93,3,0,False,True,True,112,2,0,7.145435585946448,-19,1
user_000896,66,30k-50k,desktop,new,South,22,False,0,0,0,False,False,True,113,3,0,8.032942624621331,-113,-3
user_000897,62,<30k,mobile,new,Midwest,0,True,136,6,0,True,False,False,0,0,0,,136,6
user_000898,31,<30k,mobile,returning,East,71,True,63,1,0,True,False,True,47,1,1,8.102402266879873,16,0
user_000899,61,100k-150k,desktop,new,West,66,False,0,0,0,True,True,True,61,1,0,8.808487612209612,-61,-1
user_000900,34,50k-75k,mobile,returning,Midwest,21,True,161,2,0,True,True,True,129,2,0,7.882529113793437,32,0
user_000901,18,30k-50k,desktop,returning,South,22,True,198,5,0,False,False,True,173,9,0,6.49860094125366,25,-4
user_000902,54,50k-75k,desktop,returning,East,74,True,61,1,0,True,True,True,76,1,0,9.367476410068589,-15,0
user_000903,41,50k-75k,mobile,returning,West,69,True,33,7,0,True,True,True,30,4,0,5.873607772702325,3,3
user_000904,40,>150k,desktop,returning,East,50,True,90,1,0,False,True,True,79,1,0,7.878823584608795,11,0
user_000905,36,<30k,desktop,returning,South,27,True,135,5,1,True,False,True,112,3,0,7.158460813063996,23,2
user_000906,32,50k-75k,desktop,returning,East,70,True,32,5,1,True,True,True,41,4,0,7.9564286431885325,-9,1
user_000907,52,>150k,desktop,new,Midwest,44,True,108,1,0,True,True,True,84,3,0,8.406313319739034,24,-2
user_000908,57,30k-50k,desktop,returning,Midwest,33,True,104,5,0,False,False,True,107,3,0,4.51281280012293,-3,2
user_000909,67,<30k,mobile,new,South,9,False,0,0,0,False,False,True,150,1,0,3.605679731040461,-150,-1
user_000910,23,75k-100k,mobile,new,East,62,True,125,2,0,True,True,True,96,1,0,7.820247974614913,29,1
user_000911,59,<30k,desktop,returning,East,32,True,61,1,0,True,True,True,33,3,0,9.078001095932793,28,-2
user_000912,46,<30k,mobile,returning,Midwest,27,True,109,6,0,False,False,False,0,0,0,,109,6
user_000913,53,30k-50k,mobile,returning,South,43,True,75,3,0,False,True,True,54,1,0,10.0,21,2
user_000914,35,50k-75k,desktop,returning,South,53,True,61,2,0,True,True,True,52,1,0,6.528127304117642,9,1
user_000915,80,100k-150k,desktop,new,South,62,True,71,2,0,True,True,True,53,2,0,9.28645812844649,18,0
user_000916,55,75k-100k,mobile,returning,West,61,True,67,4,0,True,True,True,89,5,0,7.472920913437602,-22,-1
user_000917,43,75k-100k,desktop,new,East,2,True,171,6,0,False,False,True,176,3,1,8.569155518838489,-5,3
user_000918,27,<30k,desktop,returning,South,54,True,123,1,0,False,False,False,0,0,0,,123,1
user_000919,33,75k-100k,mobile,returning,Midwest,65,True,56,3,0,True,True,True,51,3,0,6.365319441068078,5,0
user_000920,45,75k-100k,mobile,returning,South,51,True,128,3,1,False,True,True,124,2,0,6.055095659794564,4,1
user_000921,31,50k-75k,desktop,new,East,71,False,0,0,0,True,True,True,74,2,0,10.0,-74,-2
user_000922,41,50k-75k,desktop,returning,West,53,True,121,1,0,False,True,True,113,1,0,9.313487949464681,8,0
user_000923,22,100k-150k,mobile,returning,West,100,True,56,2,0,True,True,True,65,2,0,9.463019584834722,-9,0
user_000924,55,75k-100k,mobile,returning,West,65,True,108,1,0,True,True,True,99,1,0,7.283543816997665,9,0
user_000925,27,<30k,desktop,returning,West,66,False,0,0,0,False,True,True,96,1,0,9.199466044934155,-96,-1
user_000926,54,75k-100k,desktop,new,East,50,True,108,2,0,False,False,True,102,1,0,8.552012015316155,6,1
user_000927,28,50k-75k,mobile,returning,East,22,True,138,4,0,False,True,True,94,6,0,7.1941872736387085,44,-2
user_000928,80,100k-150k,desktop,returning,East,45,True,82,4,0,False,True,True,28,2,0,8.191985981470244,54,2
user_000929,41,30k-50k,desktop,returning,East,44,True,34,2,0,True,True,True,40,1,0,9.01525401066729,-6,1
user_000930,52,100k-150k,mobile,new,East,35,True,104,2,0,False,True,True,46,2,0,7.5827317261628355,58,0
user_000931,24,50k-75k,mobile,returning,South,54,True,75,4,0,True,True,True,80,2,0,7.80084592223249,-5,2
user_000932,66,30k-50k,desktop,returning,West,38,True,30,1,1,True,False,True,22,3,0,7.249205933432304,8,-2
user_000933,49,30k-50k,desktop,new,Midwest,41,False,0,0,0,False,False,True,143,1,0,7.3672214494787145,-143,-1
user_000934,42,50k-75k,desktop,new,South,42,True,134,4,0,True,False,True,121,8,0,6.4181441076285415,13,-4
user_000935,44,50k-75k,mobile,new,South,48,False,0,0,0,True,True,True,112,1,0,7.208841155779459,-112,-1
user_000936,58,100k-150k,desktop,new,Midwest,27,True,186,6,1,False,False,True,181,6,0,6.363726181481492,5,0
user_000937,53,<30k,mobile,new,South,44,True,112,4,1,False,False,False,0,0,0,,112,4
user_000938,65,50k-75k,mobile,new,East,25,False,0,0,0,True,False,True,108,3,0,6.615813752978043,-108,-3
user_000939,55,50k-75k,mobile,new,West,57,True,146,3,0,False,False,True,132,3,0,6.112190662880676,14,0
user_000940,36,75k-100k,desktop,returning,East,57,True,117,3,0,True,True,True,76,1,0,7.119845490597243,41,2
user_000941,62,50k-75k,desktop,returning,South,65,True,164,1,0,False,False,True,146,1,0,7.932696019063562,18,0
user_000942,58,<30k,mobile,new,West,49,True,132,1,0,True,True,True,128,1,0,8.169700367085204,4,0
user_000943,34,<30k,desktop,new,East,39,False,0,0,0,False,True,True,120,1,0,6.980245996372466,-120,-1
user_000944,47,30k-50k,desktop,returning,South,37,True,113,4,0,True,False,True,129,4,0,7.261360999947461,-16,0
user_000945,26,<30k,desktop,returning,East,63,True,109,1,0,True,True,True,67,1,0,7.451373584847849,42,0
user_000946,34,30k-50k,mobile,returning,West,94,True,64,1,0,False,True,True,54,1,0,8.296115755119622,10,0
user_000947,32,<30k,mobile,returning,Midwest,62,True,71,5,0,True,True,True,88,7,0,9.705356535697668,-17,-2
user_000948,33,30k-50k,desktop,new,West,100,False,0,0,0,True,True,True,87,2,0,10.0,-87,-2
user_000949,32,100k-150k,desktop,new,South,61,True,152,2,0,False,True,True,110,1,0,10.0,42,1
user_000950,19,50k-75k,mobile,returning,West,63,False,0,0,0,False,True,True,70,1,0,8.834278835478202,-70,-1
user_000951,29,75k-100k,desktop,new,East,64,True,95,3,0,True,True,True,64,5,0,7.457921019418946,31,-2
user_000952,49,75k-100k,desktop,new,East,37,True,122,5,1,False,False,True,116,5,1,7.1678171792529035,6,0
user_000953,57,<30k,tablet,returning,East,27,True,163,2,1,False,False,True,155,2,0,4.977825288555975,8,0
user_000954,65,50k-75k,mobile,returning,South,49,True,94,2,0,True,True,True,78,2,0,8.94938438043707,16,0
user_000955,69,100k-150k,desktop,returning,West,64,True,125,2,0,False,False,True,134,2,1,8.26731365063106,-9,0
user_000956,38,75k-100k,desktop,new,South,48,True,183,1,1,False,False,True,200,3,0,5.798767831817173,-17,-2
user_000957,61,50k-75k,mobile,new,West,12,False,0,0,0,False,True,True,110,1,0,9.28833235429479,-110,-1
user_000958,45,75k-100k,desktop,returning,West,78,True,70,1,0,False,True,True,37,1,0,8.533806582782717,33,0
user_000959,53,>150k,mobile,new,Midwest,56,True,122,1,1,True,True,True,89,1,0,6.418121405635781,33,0
user_000960,33,<30k,desktop,returning,Midwest,34,True,76,5,0,False,True,True,47,4,1,9.132522541759187,29,1
user_000961,56,100k-150k,mobile,returning,Midwest,59,True,45,2,0,True,True,True,52,1,0,5.927836156751893,-7,1
user_000962,44,30k-50k,desktop,returning,East,57,True,57,3,0,False,False,True,73,3,0,5.002018525543648,-16,0
user_000963,35,<30k,mobile,returning,East,36,False,0,0,0,True,False,True,101,1,0,7.069222522360929,-101,-1
user_000964,67,75k-100k,mobile,returning,East,33,True,111,1,0,False,False,True,125,1,0,5.68852472535631,-14,0
user_000965,65,50k-75k,mobile,returning,East,36,True,99,3,2,True,True,True,87,2,0,8.233825312444951,12,1
user_000966,49,50k-75k,desktop,returning,East,47,True,122,5,0,False,False,True,144,9,1,7.660386028640147,-22,-4
user_000967,47,75k-100k,desktop,returning,West,95,True,93,5,0,True,True,False,0,0,0,,93,5
user_000968,43,50k-75k,mobile,new,West,68,True,180,4,0,True,True,True,127,2,0,9.563683661113895,53,2
user_000969,55,50k-75k,mobile,new,Midwest,91,True,118,4,1,True,True,True,102,2,0,8.472357001838212,16,2
user_000970,18,30k-50k,desktop,new,West,75,True,57,1,1,True,True,True,77,1,0,6.601423546818448,-20,0
user_000971,33,30k-50k,desktop,returning,South,62,False,0,0,0,True,True,True,94,1,0,10.0,-94,-1
user_000972,45,30k-50k,tablet,returning,Midwest,41,True,91,2,1,False,False,True,86,1,0,5.561459097307657,5,1
user_000973,18,<30k,desktop,returning,South,85,True,106,1,0,True,True,False,0,0,0,,106,1
user_000974,42,100k-150k,desktop,new,East,41,True,90,3,0,False,False,True,66,3,0,7.310062739698039,24,0
user_000975,64,50k-75k,desktop,returning,West,45,True,67,4,0,False,False,True,63,3,0,5.067283441572425,4,1
user_000976,55,75k-100k,mobile,returning,South,53,True,73,3,0,False,True,True,68,2,0,9.427610237822028,5,1
user_000977,77,>150k,desktop,returning,East,39,True,72,5,0,True,False,True,101,10,0,7.406903822509679,-29,-5
user_000978,42,50k-75k,desktop,new,Midwest,32,True,95,4,0,False,False,True,99,2,0,4.972818302804214,-4,2
user_000979,18,75k-100k,desktop,returning,East,69,True,107,1,1,False,True,True,108,1,0,8.14423661138322,-1,0
user_000980,50,50k-75k,desktop,returning,South,40,True,83,1,0,False,False,True,109,1,0,6.886929276615842,-26,0
user_000981,55,<30k,desktop,new,East,40,True,108,2,0,False,True,False,0,0,0,,108,2
user_000982,39,<30k,mobile,returning,East,19,True,103,9,0,False,False,True,104,8,1,5.273239916324655,-1,1
user_000983,44,50k-75k,desktop,returning,East,54,True,89,1,0,True,True,True,71,2,0,7.682517160874817,18,-1
user_000984,54,<30k,mobile,returning,West,26,True,151,3,0,False,True,True,68,3,0,7.249477037600451,83,0
user_000985,50,75k-100k,desktop,returning,East,72,True,41,7,1,False,True,True,54,9,0,8.51935670235021,-13,-2
user_000986,59,50k-75k,mobile,new,East,69,True,74,1,0,True,True,True,73,1,0,8.290922408390422,1,0
user_000987,18,>150k,desktop,new,Midwest,69,True,99,2,0,True,True,True,102,1,0,8.524521844666728,-3,1
user_000988,43,100k-150k,mobile,returning,East,59,True,88,4,0,True,True,False,0,0,0,,88,4
user_000989,33,30k-50k,desktop,returning,East,71,True,67,2,0,False,True,True,39,3,0,9.758608166027695,28,-1
user_000990,48,100k-150k,desktop,returning,South,61,True,101,3,0,True,True,True,62,2,0,7.378725028677667,39,1
user_000991,28,75k-100k,desktop,returning,West,81,True,73,1,0,True,True,True,89,2,0,7.818587713478544,-16,-1
user_000992,44,50k-75k,desktop,returning,West,38,True,97,1,1,False,True,True,93,1,0,8.346658277755184,4,0
user_000993,21,>150k,mobile,returning,Midwest,92,True,71,2,0,False,True,True,61,2,0,8.644591411395414,10,0
user_000994,41,50k-75k,mobile,returning,West,58,True,121,4,0,False,False,True,120,8,0,4.786210409445816,1,-4
user_000995,40,30k-50k,desktop,new,West,59,True,138,1,0,False,True,True,130,1,0,10.0,8,0
user_000996,51,<30k,desktop,returning,South,47,True,89,2,0,False,False,True,94,5,0,10.0,-5,-3
user_000997,21,<30k,desktop,returning,South,55,False,0,0,0,True,True,True,84,1,1,7.074408630131165,-84,-1
user_000998,34,100k-150k,desktop,returning,West,85,True,89,5,0,True,True,False,0,0,0,,89,5
user_000999,60,75k-100k,mobile,new,South,23,True,182,5,1,False,False,True,166,12,0,6.156658058035616,16,-7
