user_id,age,income_bracket,device_type,user_type,region,tech_savviness,filed_2023,time_to_complete_2023,sessions_2023,support_tickets_2023,early_login_2024,used_smart_assistant,filed_2024,time_to_complete_2024,sessions_2024,support_tickets_2024,satisfaction_2024,time_improvement,session_improvement
user_000000,41,50k-75k,tablet,returning,Midwest,41,False,0,0,0,False,True,True,90,1,0,7.763752705804335,-90,-1
user_000001,37,<30k,desktop,returning,Midwest,43,False,0,0,0,False,True,True,81,1,0,6.193148405144831,-81,-1
user_000002,19,30k-50k,mobile,new,East,61,False,0,0,0,False,True,True,93,1,0,9.58725048892093,-93,-1
user_000003,66,75k-100k,mobile,new,East,31,True,118,2,0,False,True,True,102,1,0,8.104231730976334,16,1
user_000004,27,30k-50k,desktop,returning,West,85,True,31,1,0,True,True,True,28,2,0,7.26866513739757,3,-1
user_000005,35,<30k,desktop,returning,South,30,True,76,2,0,False,False,False,0,0,0,,76,2
user_000006,57,75k-100k,mobile,new,East,16,True,99,4,0,True,False,True,75,2,0,7.748468876048577,24,2
user_000007,56,30k-50k,desktop,returning,West,47,True,110,3,0,True,False,True,102,2,0,5.593440946104666,8,1
user_000008,22,<30k,mobile,new,East,49,True,197,2,0,False,True,False,0,0,0,,197,2
user_000009,49,100k-150k,mobile,new,East,59,True,138,2,0,False,True,True,100,1,0,5.864212189611879,38,1
user_000010,60,<30k,tablet,returning,West,48,False,0,0,0,True,True,True,101,1,0,6.358553867665483,-101,-1
user_000011,49,75k-100k,mobile,returning,West,74,True,37,2,0,True,True,True,20,3,0,8.03770375509449,17,-1
user_000012,57,30k-50k,mobile,new,East,55,True,122,4,0,False,False,True,110,1,0,5.641536438012751,12,3
user_000013,50,100k-150k,desktop,new,Midwest,83,True,101,1,0,True,True,True,51,1,0,8.539627890384144,50,0
user_000014,46,75k-100k,desktop,returning,East,45,True,93,2,0,True,True,True,67,1,1,8.029569879965536,26,1
user_000015,67,30k-50k,desktop,returning,West,37,True,56,4,0,False,False,True,53,2,0,8.223681440519174,3,2
user_000016,58,30k-50k,mobile,new,West,49,True,146,3,0,True,False,False,0,0,0,,146,3
user_000017,34,100k-150k,mobile,returning,East,80,True,94,7,0,True,True,True,114,3,1,7.2670493554975675,-20,4
user_000018,45,30k-50k,mobile,returning,South,41,True,30,1,0,False,False,True,20,1,1,8.963572663990108,10,0
user_000019,42,50k-75k,mobile,new,East,56,False,0,0,0,False,False,True,116,1,0,8.211780447115789,-116,-1
user_000020,18,50k-75k,desktop,returning,South,64,False,0,0,0,True,True,True,98,1,0,6.825153557669642,-98,-1
user_000021,42,30k-50k,mobile,returning,East,54,True,93,3,0,False,True,True,70,1,0,10.0,23,2
user_000022,62,<30k,desktop,returning,West,46,True,32,5,1,True,False,True,51,5,0,7.063413807120677,-19,0
user_000023,53,30k-50k,desktop,returning,Midwest,77,True,58,1,0,True,True,True,57,1,1,9.252909846999751,1,0
user_000024,46,<30k,desktop,new,West,42,True,134,4,0,True,False,False,0,0,0,,134,4
user_000025,29,75k-100k,mobile,returning,West,87,True,75,3,0,True,True,True,56,4,0,7.4160668797909794,19,-1
user_000026,33,75k-100k,mobile,returning,West,75,True,30,2,0,True,True,True,23,2,0,8.980180318474474,7,0
user_000027,48,100k-150k,desktop,new,Midwest,79,True,78,2,0,False,True,True,40,2,0,7.848330794274199,38,0
user_000028,48,50k-75k,mobile,new,South,56,True,114,2,0,False,False,True,85,2,0,7.635275479879164,29,0
user_000029,48,30k-50k,mobile,returning,South,50,True,95,4,0,True,False,True,79,5,0,6.3050835070672,16,-1
user_000030,49,75k-100k,mobile,new,South,34,True,71,2,0,True,False,True,75,1,0,5.413746433161658,-4,1
user_000031,27,<30k,mobile,returning,Midwest,64,True,67,4,0,True,True,True,41,4,0,7.598028676450177,26,0
user_000032,59,75k-100k,mobile,new,Midwest,36,True,131,7,0,False,False,True,95,5,0,7.359709632905991,36,2
user_000033,31,75k-100k,desktop,new,East,57,True,153,3,0,False,False,True,151,4,0,6.053978755752626,2,-1
user_000034,45,>150k,mobile,returning,Midwest,81,True,129,1,0,True,True,True,97,2,1,7.2910246381282615,32,-1
user_000035,28,50k-75k,desktop,new,Midwest,72,False,0,0,0,True,True,True,96,1,0,9.263001384432044,-96,-1
user_000036,52,100k-150k,tablet,returning,East,63,True,70,5,0,True,True,True,55,2,0,8.430127987672968,15,3
user_000037,38,>150k,desktop,new,East,77,True,97,4,0,False,True,True,64,3,0,9.285680363427332,33,1
user_000038,31,30k-50k,desktop,returning,Midwest,67,False,0,0,0,True,True,False,0,0,0,,0,0
user_000039,50,75k-100k,tablet,new,East,58,True,114,1,0,True,True,True,67,1,0,6.048283089300107,47,0
user_000040,52,75k-100k,desktop,returning,East,57,False,0,0,0,False,True,True,106,2,0,8.433352923967377,-106,-2
user_000041,53,100k-150k,desktop,returning,East,82,True,49,2,0,True,True,True,26,2,0,8.731630525180456,23,0
user_000042,33,75k-100k,desktop,returning,East,66,True,47,3,0,True,True,True,56,1,0,7.798261190480575,-9,2
user_000043,55,50k-75k,mobile,returning,East,25,True,157,4,0,True,True,True,83,2,0,7.473259075401415,74,2
user_000044,45,<30k,mobile,returning,East,23,True,134,4,0,True,False,True,109,3,0,7.5237883588526175,25,1
user_000045,45,75k-100k,mobile,returning,West,50,True,95,1,0,False,False,True,101,1,0,6.961512533477051,-6,0
user_000046,18,50k-75k,desktop,returning,South,67,True,51,2,0,True,True,True,35,5,0,8.141486027652503,16,-3
user_000047,52,75k-100k,mobile,returning,West,72,True,81,1,0,True,True,True,69,1,0,7.854425582416444,12,0
user_000048,71,50k-75k,mobile,new,East,41,False,0,0,0,False,False,True,106,1,0,7.193353974943974,-106,-1
user_000049,76,75k-100k,mobile,returning,Midwest,45,True,78,9,0,True,False,True,107,5,0,7.561882234303638,-29,4
user_000050,51,50k-75k,mobile,returning,South,56,True,95,5,0,False,True,True,78,3,0,9.286887303796192,17,2
user_000051,41,50k-75k,mobile,returning,East,31,False,0,0,0,False,True,True,141,1,0,6.368853138295803,-141,-1
user_000052,66,50k-75k,desktop,returning,West,23,True,74,5,0,False,False,True,107,6,0,7.31249462440229,-33,-1
user_000053,47,50k-75k,desktop,returning,West,50,True,125,1,0,False,False,True,152,3,1,8.333399824348993,-27,-2
user_000054,68,<30k,desktop,returning,Midwest,1,True,121,5,0,False,False,True,129,6,0,6.868966557112536,-8,-1
user_000055,49,50k-75k,desktop,returning,East,40,True,54,2,0,True,True,True,32,1,0,9.058482796787818,22,1
user_000056,36,<30k,mobile,returning,West,62,True,84,4,0,True,True,True,55,5,0,9.352004642320374,29,-1
user_000057,57,<30k,desktop,returning,South,29,False,0,0,0,False,False,False,0,0,0,,0,0
user_000058,44,30k-50k,mobile,returning,South,46,True,57,3,0,False,False,True,49,3,0,6.075879080900387,8,0
user_000059,41,50k-75k,desktop,new,South,61,True,142,2,0,True,False,True,141,4,0,9.889762727858965,1,-2
user_000060,64,75k-100k,desktop,new,South,30,True,162,6,0,False,False,True,148,6,0,7.550233575617585,14,0
user_000061,49,30k-50k,desktop,returning,West,58,False,0,0,0,True,True,True,90,1,0,6.08586113315897,-90,-1
user_000062,29,>150k,desktop,returning,East,66,True,97,2,0,True,True,True,92,2,0,6.694584353820863,5,0
user_000063,44,75k-100k,desktop,returning,South,31,True,74,3,0,True,True,True,23,4,0,7.375403949363829,51,-1
user_000064,32,<30k,desktop,returning,South,50,True,114,2,0,True,True,True,75,2,0,9.45290928754111,39,0
user_000065,48,<30k,desktop,returning,West,42,True,82,4,0,False,True,True,74,3,0,8.377416492563235,8,1
user_000066,23,<30k,desktop,returning,West,48,False,0,0,0,True,True,True,104,3,0,6.303237039911464,-104,-3
user_000067,34,100k-150k,desktop,returning,South,76,True,79,1,0,True,True,True,41,1,0,7.871902410514548,38,0
user_000068,44,75k-100k,desktop,returning,South,29,True,124,4,0,False,False,True,160,6,0,9.532857952562278,-36,-2
user_000069,49,<30k,desktop,new,West,37,False,0,0,0,True,False,True,126,2,0,8.025195148554019,-126,-2
user_000070,55,75k-100k,desktop,returning,East,43,True,73,4,0,False,True,True,43,2,0,8.780643786773123,30,2
user_000071,48,30k-50k,tablet,new,South,45,True,139,1,1,True,True,True,123,1,0,8.273945980832876,16,0
user_000072,66,<30k,desktop,returning,East,39,True,68,5,0,True,False,True,55,2,1,5.564879664300645,13,3
user_000073,77,50k-75k,desktop,returning,South,17,True,126,1,0,True,True,True,77,3,0,9.337061684335177,49,-2
user_000074,33,30k-50k,mobile,returning,East,72,True,30,3,0,True,True,True,31,3,0,7.494351776648139,-1,0
user_000075,59,>150k,tablet,returning,East,41,True,75,1,0,False,False,True,60,1,0,8.571027383404974,15,0
user_000076,25,75k-100k,mobile,returning,South,92,True,79,4,0,False,True,True,72,1,0,8.678109131858845,7,3
user_000077,62,100k-150k,desktop,new,West,52,False,0,0,0,True,False,False,0,0,0,,0,0
user_000078,43,>150k,mobile,returning,East,83,True,82,6,0,True,True,True,88,3,0,8.028699364067512,-6,3
user_000079,45,50k-75k,mobile,new,South,45,True,92,6,0,True,False,True,98,4,0,6.075877679192526,-6,2
user_000080,28,75k-100k,desktop,returning,West,77,True,81,2,0,False,True,True,97,3,0,8.634916804665853,-16,-1
user_000081,21,>150k,desktop,new,Midwest,99,True,102,4,0,False,True,True,36,1,0,9.40347265623539,66,3
user_000082,62,<30k,desktop,returning,South,21,False,0,0,0,True,False,True,136,1,0,7.30762391994529,-136,-1
user_000083,54,50k-75k,desktop,returning,East,70,True,82,4,0,False,False,True,98,3,1,8.106400732648838,-16,1
user_000084,60,75k-100k,mobile,new,West,18,True,145,6,1,True,False,True,126,7,0,7.291340768708233,19,-1
user_000085,67,50k-75k,mobile,returning,East,36,True,102,3,0,False,False,True,88,4,0,7.447883616173484,14,-1
user_000086,19,50k-75k,desktop,returning,South,64,True,57,3,0,True,True,True,46,1,0,9.454235396781309,11,2
user_000087,25,50k-75k,tablet,returning,East,80,False,0,0,0,False,True,True,68,1,0,5.711019404975145,-68,-1
user_000088,50,<30k,mobile,new,West,35,True,132,2,0,False,False,True,136,2,0,9.398313707920046,-4,0
user_000089,30,30k-50k,mobile,returning,East,77,True,55,1,0,True,True,True,37,1,0,6.944028955058702,18,0
user_000090,43,30k-50k,mobile,new,East,34,True,103,5,1,True,False,True,110,4,0,9.182906734029242,-7,1
user_000091,34,30k-50k,mobile,returning,Midwest,68,True,72,1,0,False,True,True,39,1,0,6.638396728357072,33,0
user_000092,54,100k-150k,desktop,new,East,76,True,134,1,0,True,True,True,99,1,1,10.0,35,0
user_000093,22,30k-50k,mobile,returning,East,90,True,97,2,0,True,True,True,80,1,0,7.570113880114773,17,1
user_000094,53,50k-75k,desktop,new,East,54,True,119,1,1,False,True,True,108,2,0,7.302323725489244,11,-1
user_000095,20,50k-75k,desktop,new,East,73,True,90,3,0,False,False,True,91,2,0,6.69116814327608,-1,1
user_000096,35,30k-50k,mobile,new,East,33,False,0,0,0,False,False,False,0,0,0,,0,0
user_000097,44,<30k,desktop,returning,Midwest,57,False,0,0,0,True,True,True,122,1,0,9.237055997214528,-122,-1
user_000098,29,<30k,desktop,returning,Midwest,52,True,110,1,0,True,True,True,103,1,0,7.975158796259765,7,0
user_000099,24,30k-50k,mobile,returning,Midwest,73,True,99,2,0,False,True,True,103,1,0,7.597024033708996,-4,1
user_000100,36,<30k,mobile,new,West,37,True,141,8,1,False,True,True,104,7,0,7.924268137988563,37,1
user_000101,49,30k-50k,desktop,new,East,49,True,79,2,0,False,False,True,53,2,0,5.23987510632167,26,0
user_000102,36,<30k,mobile,returning,South,46,True,62,2,0,False,False,False,0,0,0,,62,2
user_000103,19,30k-50k,desktop,returning,Midwest,73,True,53,1,1,True,True,True,61,1,0,8.913179386451544,-8,0
user_000104,20,75k-100k,mobile,new,East,70,True,95,1,0,True,True,True,81,1,1,9.507602682926155,14,0
user_000105,44,<30k,desktop,new,Midwest,16,True,159,8,0,True,False,True,191,4,0,4.904070578884092,-32,4
user_000106,60,50k-75k,mobile,new,West,36,True,88,4,0,False,False,True,115,3,0,7.801763129043911,-27,1
user_000107,18,30k-50k,desktop,returning,Midwest,53,True,83,2,1,True,False,False,0,0,0,,83,2
user_000108,50,30k-50k,desktop,returning,South,35,True,58,6,0,True,False,True,76,4,0,5.5403807935299785,-18,2
user_000109,62,100k-150k,mobile,new,Midwest,48,True,87,2,0,False,True,True,52,1,0,5.918111028018361,35,1
user_000110,50,<30k,desktop,new,West,43,False,0,0,0,False,False,False,0,0,0,,0,0
user_000111,63,75k-100k,desktop,returning,South,23,True,192,1,1,True,False,True,176,1,0,5.404752984831214,16,0
user_000112,45,50k-75k,mobile,returning,East,75,True,56,6,0,True,True,True,20,3,0,7.4623621944308445,36,3
user_000113,48,30k-50k,desktop,returning,East,61,False,0,0,0,True,True,False,0,0,0,,0,0
user_000114,50,<30k,desktop,returning,East,33,True,103,4,0,True,True,True,98,3,0,8.160493920385608,5,1
user_000115,38,75k-100k,desktop,returning,South,32,True,125,4,0,False,False,True,96,5,0,7.9526470765977795,29,-1
user_000116,52,30k-50k,desktop,new,Midwest,50,False,0,0,0,False,False,True,130,1,0,5.39971032998081,-130,-1
user_000117,40,30k-50k,desktop,new,South,30,True,125,1,0,False,False,True,130,1,0,8.67722646082867,-5,0
user_000118,58,75k-100k,mobile,new,Midwest,50,True,86,2,1,True,True,True,88,1,0,5.645035588409261,-2,1
user_000119,18,75k-100k,desktop,new,East,92,True,87,2,0,True,True,True,68,1,0,7.745528635066032,19,1
user_000120,80,50k-75k,desktop,new,Midwest,31,True,165,3,2,False,True,True,89,3,1,5.828480834893659,76,0
user_000121,52,<30k,desktop,returning,Midwest,38,False,0,0,0,False,True,True,84,1,0,10.0,-84,-1
user_000122,68,75k-100k,mobile,returning,Midwest,22,True,124,5,1,False,True,True,57,3,0,5.870611192040047,67,2
user_000123,45,100k-150k,desktop,returning,West,91,True,47,2,0,False,True,True,47,1,0,7.307554921958255,0,1
user_000124,29,50k-75k,mobile,new,East,45,False,0,0,0,False,False,True,120,1,0,9.098257349709904,-120,-1
user_000125,39,50k-75k,desktop,new,East,75,True,49,1,0,True,True,True,34,2,0,10.0,15,-1
user_000126,18,30k-50k,desktop,new,West,79,False,0,0,0,True,True,False,0,0,0,,0,0
user_000127,40,100k-150k,mobile,returning,Midwest,43,True,119,2,0,True,True,True,112,1,0,9.11715096657786,7,1
user_000128,45,<30k,tablet,returning,Midwest,34,True,94,3,1,True,True,True,100,2,0,7.809377646305987,-6,1
user_000129,44,30k-50k,desktop,new,West,51,True,97,1,0,False,True,True,74,2,0,9.259238716421175,23,-1
user_000130,18,50k-75k,mobile,returning,East,86,True,113,6,0,False,True,True,81,3,0,8.965718946910794,32,3
user_000131,23,50k-75k,desktop,new,West,68,True,69,3,0,True,True,True,23,1,0,10.0,46,2
user_000132,59,75k-100k,mobile,new,West,64,True,159,1,0,True,True,True,75,1,0,6.899969364872881,84,0
user_000133,37,<30k,mobile,new,Midwest,42,True,82,5,0,False,False,True,104,6,0,7.680082417608285,-22,-1
user_000134,55,75k-100k,mobile,new,West,66,True,100,2,0,False,True,True,75,1,0,9.647828008929263,25,1
user_000135,53,100k-150k,mobile,returning,West,70,True,95,4,0,True,True,True,77,7,0,8.581142175322588,18,-3
user_000136,49,<30k,mobile,new,West,31,False,0,0,0,False,True,True,99,2,0,8.511179746142044,-99,-2
user_000137,34,50k-75k,desktop,returning,East,48,False,0,0,0,False,False,True,101,2,0,5.348259774226621,-101,-2
user_000138,18,50k-75k,mobile,returning,East,95,False,0,0,0,True,True,False,0,0,0,,0,0
user_000139,44,30k-50k,desktop,returning,West,76,True,84,3,0,True,True,True,45,7,0,8.089366324883542,39,-4
user_000140,49,100k-150k,desktop,returning,West,49,True,99,3,0,True,True,True,33,2,0,8.604508776099445,66,1
user_000141,45,75k-100k,mobile,new,South,50,True,135,2,0,False,True,True,124,1,0,9.367440514847791,11,1
user_000142,47,30k-50k,mobile,new,South,30,True,103,1,1,False,False,True,60,1,0,8.307504859738755,43,0
user_000143,48,30k-50k,desktop,returning,South,59,False,0,0,0,False,False,True,143,3,0,6.510243244503684,-143,-3
user_000144,18,75k-100k,desktop,new,South,45,True,132,5,0,True,False,True,145,3,0,7.7409851851476965,-13,2
user_000145,47,50k-75k,mobile,new,Midwest,33,True,121,4,0,False,True,True,80,4,0,7.308991745362388,41,0
user_000146,30,30k-50k,mobile,new,East,85,True,66,2,0,True,True,True,46,1,1,9.226673721698708,20,1
user_000147,32,50k-75k,desktop,returning,South,75,True,30,4,0,True,True,True,37,1,0,9.843863745103796,-7,3
user_000148,80,<30k,mobile,returning,West,33,True,44,4,0,False,False,True,49,3,0,6.324761579236864,-5,1
user_000149,44,30k-50k,desktop,new,West,86,True,41,4,0,True,True,True,20,2,0,9.164196119321923,21,2
user_000150,54,75k-100k,mobile,new,South,59,True,132,3,0,False,False,True,136,2,0,6.850449856036654,-4,1
user_000151,43,30k-50k,desktop,returning,West,69,True,59,1,0,True,True,True,60,1,0,5.804494256849078,-1,0
user_000152,53,30k-50k,desktop,returning,Midwest,61,True,89,3,0,False,False,True,102,5,0,10.0,-13,-2
user_000153,51,75k-100k,desktop,new,East,53,True,96,6,0,True,True,True,104,3,0,8.342584331839,-8,3
user_000154,28,30k-50k,desktop,returning,West,95,True,59,4,0,True,True,True,20,5,0,6.7073476707121955,39,-1
user_000155,45,100k-150k,tablet,returning,East,65,True,115,2,0,True,True,True,57,1,0,9.324709306434418,58,1
user_000156,38,30k-50k,desktop,new,Midwest,40,True,134,6,1,True,False,True,133,6,0,7.791351006997076,1,0
user_000157,42,<30k,desktop,new,Midwest,28,True,210,4,0,True,False,True,196,2,1,6.3577699317092975,14,2
user_000158,49,50k-75k,desktop,new,Midwest,58,True,177,4,0,True,False,True,180,9,0,9.085063768794031,-3,-5
user_000159,46,30k-50k,mobile,returning,West,75,True,66,1,0,True,True,True,63,1,0,9.728005487737214,3,0
user_000160,37,100k-150k,desktop,returning,East,86,True,67,2,1,True,True,True,88,3,1,7.190535510767687,-21,-1
user_000161,38,50k-75k,desktop,returning,South,66,True,95,1,0,True,True,True,102,1,0,8.183513815821737,-7,0
user_000162,24,50k-75k,desktop,new,West,66,False,0,0,0,True,False,False,0,0,0,,0,0
user_000163,44,30k-50k,mobile,new,West,63,False,0,0,0,True,True,True,93,1,0,8.10103997827639,-93,-1
user_000164,59,50k-75k,desktop,new,South,26,False,0,0,0,False,False,True,121,1,0,7.231759307538811,-121,-1
user_000165,47,100k-150k,desktop,returning,West,82,True,76,1,0,False,True,True,60,1,0,8.044660984733492,16,0
user_000166,35,75k-100k,desktop,new,West,51,True,117,4,1,False,False,True,118,6,0,4.904685410326667,-1,-2
user_000167,66,75k-100k,mobile,new,South,21,True,146,2,0,False,False,True,76,2,0,8.890626369801447,70,0
user_000168,48,75k-100k,mobile,returning,West,37,True,58,6,0,False,True,True,33,3,0,8.543807418015612,25,3
user_000169,35,50k-75k,desktop,new,South,39,True,141,1,0,False,False,True,163,2,0,5.6377513777526564,-22,-1
user_000170,54,100k-150k,tablet,returning,South,90,True,93,1,0,True,True,False,0,0,0,,93,1
user_000171,44,<30k,mobile,returning,East,66,True,80,1,0,True,True,False,0,0,0,,80,1
user_000172,44,<30k,mobile,returning,West,67,True,79,3,0,False,False,True,98,3,0,5.713214996834489,-19,0
user_000173,55,50k-75k,desktop,returning,East,77,True,105,4,0,True,True,True,87,3,0,7.9051468457091385,18,1
user_000174,57,30k-50k,desktop,returning,Midwest,37,True,145,1,0,False,True,True,97,1,0,8.531265670647999,48,0
user_000175,42,75k-100k,desktop,returning,South,47,True,31,1,2,True,True,True,20,1,1,7.425993479583757,11,0
user_000176,45,30k-50k,desktop,new,South,64,True,105,1,0,True,False,True,102,1,0,8.978855040020749,3,0
user_000177,24,<30k,mobile,returning,South,66,True,68,8,0,True,True,True,21,5,0,7.325409963738118,47,3
user_000178,48,75k-100k,desktop,returning,West,83,False,0,0,0,False,True,True,137,1,0,9.796294313891812,-137,-1
user_000179,38,>150k,mobile,returning,South,62,False,0,0,0,False,False,True,141,2,0,7.030403513725362,-141,-2
user_000180,62,30k-50k,desktop,new,Midwest,7,False,0,0,0,False,False,True,115,1,0,7.800157980986819,-115,-1
user_000181,36,<30k,desktop,returning,South,40,False,0,0,0,False,True,False,0,0,0,,0,0
user_000182,68,75k-100k,mobile,new,East,34,False,0,0,0,False,False,True,111,3,0,7.920519692077202,-111,-3
user_000183,23,75k-100k,mobile,new,South,32,False,0,0,0,False,True,True,67,1,0,9.332368610897747,-67,-1
user_000184,48,30k-50k,desktop,returning,West,51,True,82,1,1,True,True,False,0,0,0,,82,1
user_000185,54,75k-100k,mobile,returning,West,58,True,100,4,0,True,True,True,87,1,0,7.0673347405439,13,3
user_000186,44,50k-75k,desktop,returning,East,53,True,100,3,0,True,True,True,72,2,0,7.812998611991599,28,1
user_000187,26,100k-150k,mobile,new,West,100,True,79,2,0,False,True,True,109,2,0,8.003533604725828,-30,0
user_000188,50,100k-150k,desktop,returning,West,81,True,66,4,0,True,True,True,57,4,0,7.160943823091982,9,0
user_000189,47,75k-100k,desktop,returning,Midwest,55,True,100,3,0,True,True,True,81,2,0,8.974446828557388,19,1
user_000190,34,75k-100k,desktop,new,West,100,True,102,1,0,True,True,True,76,1,0,7.5976719321546256,26,0
user_000191,57,30k-50k,desktop,new,Midwest,20,False,0,0,0,False,False,True,100,1,0,8.274867278608346,-100,-1
user_000192,38,30k-50k,desktop,new,West,23,True,199,4,0,False,False,False,0,0,0,,199,4
user_000193,30,75k-100k,mobile,returning,South,64,True,63,6,0,False,True,True,70,6,0,7.442514249389109,-7,0
user_000194,67,30k-50k,tablet,new,East,48,True,84,2,1,True,False,False,0,0,0,,84,2
user_000195,41,50k-75k,mobile,new,East,39,True,105,5,2,False,True,False,0,0,0,,105,5
user_000196,71,<30k,mobile,returning,West,44,True,115,3,0,True,True,True,117,3,0,9.228208930166446,-2,0
user_000197,65,100k-150k,mobile,new,West,73,True,101,1,0,False,True,True,84,3,0,10.0,17,-2
user_000198,55,<30k,desktop,new,East,45,True,144,2,0,False,False,False,0,0,0,,144,2
user_000199,64,75k-100k,desktop,new,South,32,True,108,5,0,True,True,True,105,5,1,9.511541587002672,3,0
user_000200,35,50k-75k,desktop,returning,Midwest,37,True,80,5,0,True,True,True,67,3,0,8.963656500409481,13,2
user_000201,52,100k-150k,mobile,returning,East,56,True,115,6,0,True,True,True,87,1,0,8.318996629558196,28,5
user_000202,45,75k-100k,desktop,returning,Midwest,46,True,122,3,0,False,False,True,161,3,1,7.169189687574616,-39,0
user_000203,41,30k-50k,desktop,new,West,34,True,106,4,0,True,False,True,80,1,0,4.295739034248354,26,3
user_000204,26,100k-150k,desktop,returning,East,63,True,35,4,0,False,True,True,20,2,0,8.205302549033998,15,2
user_000205,70,>150k,mobile,returning,Midwest,38,True,59,5,0,True,False,True,78,4,1,9.367582312605077,-19,1
user_000206,54,50k-75k,desktop,returning,East,26,True,124,5,1,False,False,True,129,3,0,7.496450192241133,-5,2
user_000207,35,100k-150k,mobile,returning,Midwest,65,True,128,3,0,True,False,True,129,4,0,6.85547230150394,-1,-1
user_000208,44,75k-100k,desktop,new,West,77,True,30,3,0,True,True,True,20,6,0,7.242874381670395,10,-3
user_000209,62,30k-50k,desktop,returning,East,8,True,96,9,0,True,False,True,80,5,0,6.220339736353015,16,4
user_000210,25,30k-50k,mobile,returning,East,87,True,86,6,0,True,True,False,0,0,0,,86,6
user_000211,46,75k-100k,mobile,returning,East,30,True,102,5,0,False,True,True,71,4,0,5.170114161917919,31,1
user_000212,67,30k-50k,desktop,returning,West,57,True,30,2,1,True,True,True,40,1,0,9.524028879650869,-10,1
user_000213,40,30k-50k,mobile,new,Midwest,76,True,106,2,0,False,False,True,119,1,0,5.40494470645008,-13,1
user_000214,41,100k-150k,desktop,returning,South,57,True,136,5,0,False,True,True,125,3,0,7.190966937194282,11,2
user_000215,55,30k-50k,mobile,returning,South,43,True,95,5,0,True,True,True,92,7,0,6.5914183528282475,3,-2
user_000216,58,30k-50k,desktop,new,West,50,False,0,0,0,False,False,True,151,1,0,5.1528717003376805,-151,-1
user_000217,61,50k-75k,desktop,returning,Midwest,14,True,142,2,0,False,False,True,136,1,0,8.109632854512565,6,1
user_000218,35,30k-50k,desktop,returning,West,88,True,30,2,0,True,True,False,0,0,0,,30,2
user_000219,47,100k-150k,mobile,returning,South,65,True,107,3,0,True,True,True,56,3,1,9.97219435645703,51,0
user_000220,61,50k-75k,desktop,returning,Midwest,47,True,69,1,0,False,False,True,71,1,0,8.443718826894202,-2,0
user_000221,49,30k-50k,desktop,returning,Midwest,33,True,76,4,0,True,False,True,80,8,0,5.9777456466936805,-4,-4
user_000222,49,>150k,mobile,returning,East,71,True,83,1,0,True,True,True,89,2,0,6.225229279754255,-6,-1
user_000223,62,50k-75k,desktop,returning,East,16,False,0,0,0,False,False,True,94,1,0,5.429343868145174,-94,-1
user_000224,42,100k-150k,desktop,returning,East,66,True,37,1,0,True,True,True,23,1,0,8.32700881922121,14,0
user_000225,68,50k-75k,mobile,new,East,22,True,153,5,0,False,False,True,157,4,0,6.775054517187179,-4,1
user_000226,69,50k-75k,mobile,new,East,50,True,81,7,0,False,True,True,73,3,0,10.0,8,4
user_000227,18,75k-100k,desktop,returning,South,99,True,47,1,0,False,True,True,23,1,0,9.293073241171848,24,0
user_000228,60,<30k,mobile,returning,East,61,False,0,0,0,True,False,True,147,1,0,7.098358238428363,-147,-1
user_000229,56,75k-100k,desktop,returning,Midwest,34,True,128,2,0,False,True,True,87,3,1,7.989479259632538,41,-1
user_000230,33,30k-50k,desktop,new,South,60,True,131,2,0,False,False,True,153,4,0,6.475327618625155,-22,-2
user_000231,47,50k-75k,mobile,new,East,70,True,122,2,0,False,True,True,84,1,0,8.824997955690147,38,1
user_000232,30,30k-50k,desktop,returning,East,66,True,136,3,1,True,True,True,102,1,0,8.73101273648391,34,2
user_000233,35,30k-50k,desktop,new,East,54,False,0,0,0,False,True,True,85,1,0,8.060489095054496,-85,-1
user_000234,48,50k-75k,mobile,returning,East,70,True,127,2,0,False,False,False,0,0,0,,127,2
user_000235,45,<30k,desktop,returning,Midwest,35,False,0,0,0,False,True,True,77,1,0,7.1182200566642955,-77,-1
user_000236,26,30k-50k,mobile,returning,East,59,True,91,5,1,True,True,True,89,1,0,7.206383302237634,2,4
user_000237,34,75k-100k,mobile,returning,East,74,True,37,2,0,False,True,True,34,1,1,10.0,3,1
user_000238,54,75k-100k,desktop,returning,West,66,False,0,0,0,False,True,True,126,2,0,7.57672478146355,-126,-2
user_000239,59,30k-50k,mobile,new,Midwest,63,False,0,0,0,True,True,True,123,1,0,7.028482993987251,-123,-1
user_000240,32,30k-50k,mobile,returning,East,94,True,89,5,0,True,True,True,62,3,0,7.41021832944796,27,2
user_000241,53,50k-75k,desktop,returning,South,69,True,50,2,0,True,False,True,82,6,0,8.51622443207902,-32,-4
user_000242,36,30k-50k,mobile,new,South,29,True,223,3,0,False,False,True,236,4,0,6.843066294426921,-13,-1
user_000243,48,30k-50k,mobile,new,East,26,True,153,6,0,False,True,True,167,4,1,8.32041240011621,-14,2
user_000244,63,100k-150k,desktop,returning,East,31,True,131,4,0,False,True,True,144,5,0,5.909156928498501,-13,-1
user_000245,34,>150k,desktop,returning,Midwest,79,True,104,3,1,False,True,True,58,3,0,7.162421016808905,46,0
user_000246,47,50k-75k,tablet,new,Midwest,23,True,149,3,0,False,False,True,159,3,0,8.777924454408355,-10,0
user_000247,61,<30k,desktop,returning,East,34,True,64,2,0,True,False,True,46,2,0,6.107977609138662,18,0
user_000248,63,100k-150k,mobile,returning,West,62,True,142,2,1,True,False,True,152,4,1,5.908624463240836,-10,-2
user_000249,47,50k-75k,desktop,new,South,42,False,0,0,0,True,True,True,59,1,0,7.377499327645758,-59,-1
user_000250,33,75k-100k,desktop,new,East,50,True,46,2,2,False,True,True,39,1,0,8.426163600329016,7,1
user_000251,28,<30k,desktop,returning,East,27,True,99,2,0,True,False,True,95,2,0,5.765226682818211,4,0
user_000252,46,75k-100k,desktop,returning,East,48,True,57,1,0,False,False,True,37,1,0,7.095876228799785,20,0
user_000253,34,50k-75k,desktop,returning,South,79,True,63,2,0,True,True,True,76,1,0,7.814660381037068,-13,1
user_000254,45,<30k,mobile,new,Midwest,34,True,139,3,0,False,False,True,144,1,0,6.099168581895792,-5,2
user_000255,44,75k-100k,desktop,new,South,57,True,164,4,1,True,False,False,0,0,0,,164,4
user_000256,29,75k-100k,desktop,new,East,65,True,120,2,1,False,True,True,95,1,0,8.139671455810696,25,1
user_000257,45,50k-75k,mobile,new,West,67,True,87,3,0,True,True,True,41,2,0,8.65584299835052,46,1
user_000258,30,>150k,mobile,new,East,82,False,0,0,0,True,True,True,107,1,0,8.22760073309592,-107,-1
user_000259,41,75k-100k,mobile,returning,Midwest,67,True,34,3,0,False,False,True,47,4,0,7.1297117319362915,-13,-1
user_000260,35,<30k,tablet,new,Midwest,30,False,0,0,0,False,True,True,95,1,0,8.594703371011649,-95,-1
user_000261,51,75k-100k,mobile,returning,South,62,True,76,4,0,False,True,True,42,3,0,7.9767072580008,34,1
user_000262,24,30k-50k,desktop,returning,East,66,True,62,3,0,True,True,False,0,0,0,,62,3
user_000263,36,50k-75k,mobile,returning,Midwest,6,True,77,4,0,False,False,True,47,8,0,4.882726209559185,30,-4
user_000264,22,<30k,mobile,returning,West,72,True,61,6,0,False,False,True,78,6,0,7.9601128423705765,-17,0
user_000265,44,<30k,mobile,returning,South,43,True,137,1,0,True,False,True,154,3,0,9.261990708175885,-17,-2
user_000266,44,<30k,desktop,returning,South,21,True,142,1,0,True,False,False,0,0,0,,142,1
user_000267,24,30k-50k,mobile,returning,East,45,True,137,2,0,False,True,True,107,1,0,10.0,30,1
user_000268,34,50k-75k,desktop,returning,South,80,True,126,2,0,True,True,True,114,3,1,8.957450284393643,12,-1
user_000269,77,75k-100k,mobile,new,South,20,True,163,3,0,False,False,False,0,0,0,,163,3
user_000270,45,75k-100k,desktop,returning,Midwest,33,True,95,5,0,True,True,True,96,7,0,9.42353392547827,-1,-2
user_000271,39,30k-50k,desktop,returning,Midwest,47,True,112,2,0,True,True,True,43,1,0,8.160181394497414,69,1
user_000272,24,<30k,mobile,returning,Midwest,40,True,100,2,0,True,True,True,71,2,0,8.803494116606101,29,0
user_000273,62,30k-50k,desktop,returning,West,55,True,103,2,0,True,False,False,0,0,0,,103,2
user_000274,59,30k-50k,mobile,new,South,18,True,168,1,0,False,True,True,116,1,0,6.754880365330523,52,0
user_000275,64,75k-100k,mobile,new,West,53,False,0,0,0,True,False,True,101,1,0,7.98508890573985,-101,-1
user_000276,35,75k-100k,desktop,new,South,58,True,101,1,1,True,True,True,98,3,0,9.646427599499736,3,-2
user_000277,53,>150k,desktop,returning,Midwest,76,True,64,3,0,True,True,True,30,1,0,8.081996516459732,34,2
user_000278,29,<30k,mobile,returning,West,40,False,0,0,0,True,True,True,72,2,0,6.9858232967077925,-72,-2
user_000279,41,50k-75k,desktop,returning,West,55,True,68,1,0,False,True,True,61,1,0,9.038041376758512,7,0
user_000280,42,100k-150k,desktop,new,South,64,True,112,3,0,True,True,True,84,3,0,10.0,28,0
user_000281,54,75k-100k,desktop,returning,Midwest,62,True,167,3,0,True,True,True,147,5,0,6.815728174915144,20,-2
user_000282,50,30k-50k,desktop,returning,South,35,True,113,1,0,False,True,True,87,1,0,7.7549198167221665,26,0
user_000283,49,100k-150k,mobile,returning,South,85,True,95,2,0,True,True,True,72,2,0,5.809823640598655,23,0
user_000284,56,50k-75k,desktop,new,Midwest,35,True,83,4,0,False,True,True,58,3,0,6.634601419048436,25,1
user_000285,41,75k-100k,desktop,new,East,37,False,0,0,0,True,True,True,105,1,0,8.154926888506745,-105,-1
user_000286,27,100k-150k,mobile,returning,Midwest,86,True,83,1,0,True,True,True,45,2,0,7.689662127093612,38,-1
user_000287,33,50k-75k,desktop,returning,West,89,True,50,5,0,False,True,False,0,0,0,,50,5
user_000288,55,>150k,mobile,new,West,69,False,0,0,0,True,True,True,112,1,0,8.877266868970153,-112,-1
user_000289,48,>150k,mobile,returning,Midwest,73,True,119,3,0,True,True,True,98,3,0,8.299717418102261,21,0
user_000290,22,50k-75k,mobile,returning,West,98,True,57,1,0,True,True,True,56,1,0,6.936332779121203,1,0
user_000291,36,75k-100k,mobile,returning,East,52,True,30,2,0,True,False,True,61,2,0,7.863202760427317,-31,0
user_000292,60,50k-75k,desktop,returning,Midwest,38,False,0,0,0,False,True,True,117,1,0,6.106619265152573,-117,-1
user_000293,42,30k-50k,desktop,returning,West,53,True,96,1,0,True,True,True,103,1,0,9.08745904304672,-7,0
user_000294,27,75k-100k,desktop,returning,East,67,True,34,1,0,True,True,True,20,1,0,8.021429776126261,14,0
user_000295,67,30k-50k,mobile,new,West,54,True,127,2,0,True,True,True,93,2,0,8.60022010584191,34,0
user_000296,63,>150k,desktop,returning,East,58,True,46,3,0,False,True,True,55,2,0,7.165822195967522,-9,1
user_000297,73,<30k,mobile,returning,East,48,True,88,3,0,False,True,True,39,1,0,8.567843333687314,49,2
user_000298,47,30k-50k,mobile,new,West,33,True,78,3,0,True,False,True,52,2,1,7.9518543224161755,26,1
user_000299,52,30k-50k,desktop,new,East,42,True,150,3,0,True,True,True,129,1,0,9.774953466146531,21,2
user_000300,44,50k-75k,desktop,new,West,86,True,92,4,0,True,True,True,85,1,0,7.072666110814698,7,3
user_000301,30,50k-75k,desktop,returning,West,84,True,105,1,1,True,True,True,80,1,0,9.5803508923984,25,0
user_000302,43,75k-100k,desktop,returning,West,56,False,0,0,0,True,True,True,126,1,0,8.200190685757155,-126,-1
user_000303,58,30k-50k,mobile,returning,West,32,True,33,4,0,True,False,True,23,2,0,7.346161586776044,10,2
user_000304,18,50k-75k,desktop,new,East,83,False,0,0,0,False,True,True,104,1,1,9.983147543992924,-104,-1
user_000305,46,30k-50k,desktop,new,Midwest,52,False,0,0,0,False,False,True,121,1,0,5.023341035436587,-121,-1
user_000306,56,100k-150k,mobile,returning,East,31,True,106,6,0,True,False,True,147,2,1,8.012234564801295,-41,4
user_000307,20,30k-50k,desktop,returning,South,82,True,104,1,0,True,True,True,113,1,0,8.134989506683068,-9,0
user_000308,48,<30k,mobile,new,East,57,False,0,0,0,False,False,True,98,1,0,8.027388236089587,-98,-1
user_000309,47,50k-75k,mobile,returning,Midwest,39,True,142,12,0,False,False,True,133,11,0,8.39986645518273,9,1
user_000310,51,50k-75k,mobile,returning,East,63,True,57,4,0,False,True,True,50,5,0,7.1448444464320255,7,-1
user_000311,45,50k-75k,mobile,returning,East,39,True,72,5,1,True,True,True,75,1,0,7.610636299905277,-3,4
user_000312,35,100k-150k,desktop,new,South,48,True,80,2,0,False,True,True,20,1,0,7.209436608353869,60,1
user_000313,49,30k-50k,mobile,returning,East,46,True,111,1,0,False,False,True,120,3,0,6.293591016327329,-9,-2
user_000314,58,100k-150k,desktop,new,East,48,True,144,2,0,False,True,True,98,6,0,10.0,46,-4
user_000315,38,50k-75k,desktop,new,Midwest,62,True,127,1,0,True,True,True,163,1,0,8.809889159041273,-36,0
user_000316,58,75k-100k,tablet,new,East,24,True,216,3,0,False,False,True,215,2,0,7.807709396336816,1,1
user_000317,46,50k-75k,desktop,returning,East,62,True,45,1,0,True,True,True,49,1,0,8.167484575117083,-4,0
user_000318,39,30k-50k,desktop,returning,East,43,False,0,0,0,True,True,True,69,2,0,9.737215988565342,-69,-2
user_000319,75,30k-50k,desktop,returning,West,28,True,140,5,0,True,False,False,0,0,0,,140,5
user_000320,43,<30k,desktop,returning,East,46,False,0,0,0,True,True,True,103,1,0,8.197863160164328,-103,-1
user_000321,42,>150k,desktop,returning,West,89,True,66,1,0,False,False,True,94,1,0,7.779624194202711,-28,0
user_000322,53,30k-50k,mobile,returning,East,54,True,89,1,0,False,False,True,94,1,0,9.303319063408404,-5,0
user_000323,47,<30k,desktop,new,South,54,False,0,0,0,False,False,True,145,1,0,7.630833326887176,-145,-1
user_000324,18,75k-100k,mobile,returning,South,55,True,80,1,0,False,True,False,0,0,0,,80,1
user_000325,57,50k-75k,desktop,new,West,53,True,141,1,0,False,True,True,117,1,0,7.839138276563587,24,0
user_000326,69,<30k,mobile,new,East,20,True,143,8,1,False,False,True,147,8,0,7.23072222683153,-4,0
user_000327,51,75k-100k,desktop,returning,South,44,True,115,2,0,False,True,True,100,1,0,9.615455319335144,15,1
user_000328,38,75k-100k,mobile,returning,East,53,True,79,3,0,True,True,True,63,1,0,6.905309297618511,16,2
user_000329,58,30k-50k,desktop,new,South,9,True,181,6,1,False,False,True,197,5,1,6.936831502190708,-16,1
user_000330,52,75k-100k,desktop,new,West,62,False,0,0,0,False,True,True,131,2,0,8.50240131202315,-131,-2
user_000331,51,100k-150k,desktop,returning,Midwest,56,True,69,1,0,True,True,True,50,1,0,7.55496556663399,19,0
user_000332,61,75k-100k,desktop,new,East,33,False,0,0,0,True,False,False,0,0,0,,0,0
user_000333,36,50k-75k,mobile,returning,West,58,True,87,3,0,True,True,True,76,2,0,6.5810504633056,11,1
user_000334,52,75k-100k,desktop,new,South,41,True,74,3,1,False,True,True,86,3,0,8.348282736752305,-12,0
user_000335,30,75k-100k,desktop,new,South,81,True,111,2,0,False,True,True,99,1,0,7.443732210873496,12,1
user_000336,50,100k-150k,mobile,returning,West,100,True,77,2,0,True,True,True,62,2,1,7.5225818569393335,15,0
user_000337,56,<30k,mobile,new,East,0,True,183,3,1,False,False,True,188,2,0,6.275379767725868,-5,1
user_000338,59,30k-50k,mobile,returning,West,70,True,134,3,0,False,True,True,112,2,1,7.254548764027259,22,1
user_000339,46,100k-150k,mobile,new,West,92,True,122,2,0,False,True,True,96,3,0,8.072054811251798,26,-1
user_000340,59,<30k,desktop,returning,West,42,True,59,5,0,True,True,False,0,0,0,,59,5
user_000341,35,100k-150k,desktop,returning,East,37,True,132,3,0,True,True,True,98,1,0,7.9640678635307,34,2
user_000342,69,75k-100k,desktop,returning,East,54,True,93,2,0,False,True,True,44,1,0,6.5223596886873985,49,1
user_000343,41,50k-75k,desktop,new,East,37,True,155,3,1,False,True,True,97,1,0,7.729274180737565,58,2
user_000344,45,50k-75k,desktop,returning,Midwest,70,True,43,1,0,False,False,False,0,0,0,,43,1
user_000345,35,75k-100k,mobile,new,East,49,True,172,2,0,False,True,True,141,2,0,8.099601262463418,31,0
user_000346,23,<30k,mobile,returning,East,58,True,123,7,0,True,True,True,122,5,0,6.877453922727448,1,2
user_000347,40,75k-100k,mobile,new,East,38,True,103,4,1,True,False,True,112,6,0,6.121584881643232,-9,-2
user_000348,42,100k-150k,desktop,returning,East,75,True,131,4,0,True,True,True,92,2,0,10.0,39,2
user_000349,61,<30k,desktop,new,East,25,True,145,2,0,False,False,True,148,2,0,7.498389507314498,-3,0
user_000350,34,50k-75k,desktop,returning,West,57,True,119,1,0,False,True,True,137,1,0,4.082202223975771,-18,0
user_000351,21,50k-75k,mobile,returning,Midwest,78,True,108,3,0,True,True,True,67,2,0,6.850098259042982,41,1
user_000352,37,100k-150k,tablet,returning,West,77,True,90,4,0,False,True,True,95,5,0,6.633271377124335,-5,-1
user_000353,40,30k-50k,mobile,returning,Midwest,31,True,121,8,0,False,False,True,129,11,0,8.60069651213484,-8,-3
user_000354,43,50k-75k,mobile,new,East,51,False,0,0,0,False,True,True,83,2,0,5.713115353169781,-83,-2
user_000355,28,<30k,mobile,returning,Midwest,76,True,34,3,0,True,True,True,46,2,0,7.732146573859525,-12,1
user_000356,59,50k-75k,mobile,returning,South,34,False,0,0,0,False,False,False,0,0,0,,0,0
user_000357,27,75k-100k,mobile,returning,West,81,True,30,3,1,False,True,True,20,2,0,8.066109295720068,10,1
user_000358,36,<30k,mobile,new,East,41,True,142,2,0,False,False,True,125,1,0,4.879302225987081,17,1
user_000359,59,<30k,desktop,new,Midwest,26,True,138,2,0,False,False,True,108,1,0,8.103858043198738,30,1
user_000360,60,75k-100k,mobile,returning,East,24,True,135,2,0,False,True,True,82,2,0,7.720293389578406,53,0
user_000361,42,50k-75k,desktop,returning,South,57,True,129,6,0,True,False,True,97,8,0,7.396711144120046,32,-2
user_000362,60,30k-50k,desktop,returning,Midwest,46,True,113,3,1,False,True,True,99,3,0,7.823758889469585,14,0
user_000363,40,50k-75k,mobile,returning,West,71,True,93,1,0,False,True,True,66,3,0,8.703536996908827,27,-2
user_000364,36,30k-50k,mobile,returning,Midwest,41,True,87,1,0,True,True,True,79,2,0,9.655272945494163,8,-1
user_000365,26,50k-75k,mobile,returning,Midwest,56,True,161,2,0,False,True,True,145,2,0,8.453787122728356,16,0
user_000366,37,>150k,desktop,returning,West,74,True,49,2,0,True,True,True,42,1,0,6.060876529692822,7,1
user_000367,43,50k-75k,tablet,returning,West,54,False,0,0,0,True,False,True,113,1,0,8.509881047069387,-113,-1
user_000368,53,30k-50k,mobile,returning,East,45,True,128,3,0,False,True,True,92,4,0,7.667254898295617,36,-1
user_000369,62,<30k,tablet,new,South,25,True,91,3,0,False,False,True,93,3,0,5.206136869869653,-2,0
user_000370,21,>150k,mobile,returning,East,68,False,0,0,0,False,True,True,88,1,0,5.832833133568697,-88,-1
user_000371,54,50k-75k,mobile,returning,East,57,True,93,2,0,True,True,True,91,1,0,9.0136893333481,2,1
user_000372,42,50k-75k,mobile,new,West,52,True,104,5,0,True,True,True,110,2,0,7.11604135736035,-6,3
user_000373,28,30k-50k,tablet,returning,East,73,True,97,1,0,True,True,True,51,1,0,9.507046362489946,46,0
user_000374,61,50k-75k,desktop,returning,East,64,True,118,2,0,False,True,True,97,1,0,8.385110036843384,21,1
user_000375,80,75k-100k,mobile,returning,West,22,False,0,0,0,False,False,True,133,1,0,6.7378735477866565,-133,-1
user_000376,61,30k-50k,tablet,returning,Midwest,31,False,0,0,0,False,False,True,105,1,0,7.975969988079697,-105,-1
user_000377,54,<30k,desktop,new,South,29,True,224,3,0,False,False,False,0,0,0,,224,3
user_000378,61,100k-150k,mobile,returning,South,44,True,66,4,0,True,False,True,43,3,0,7.338350723484231,23,1
user_000379,36,50k-75k,mobile,new,West,80,True,64,2,0,True,True,True,55,3,0,6.520077211461867,9,-1
user_000380,44,50k-75k,desktop,returning,South,49,True,43,1,0,False,False,True,40,1,0,9.020764773906864,3,0
user_000381,42,100k-150k,desktop,returning,South,57,True,155,1,0,False,True,True,106,1,0,7.320001273509245,49,0
user_000382,53,100k-150k,mobile,returning,South,15,True,174,3,0,False,True,True,121,1,0,6.076491304170813,53,2
user_000383,61,75k-100k,desktop,new,East,49,True,88,1,0,True,False,True,81,2,0,7.332244379215564,7,-1
user_000384,35,75k-100k,mobile,new,East,62,True,112,3,0,False,True,True,94,5,0,9.888356202265916,18,-2
user_000385,59,30k-50k,tablet,new,South,37,False,0,0,0,False,False,False,0,0,0,,0,0
user_000386,35,30k-50k,mobile,returning,South,51,False,0,0,0,False,True,True,103,2,0,8.51045069750781,-103,-2
user_000387,50,75k-100k,desktop,returning,South,61,True,85,3,0,False,False,True,55,2,0,8.396474700108815,30,1
user_000388,34,<30k,desktop,new,East,57,False,0,0,0,True,True,False,0,0,0,,0,0
user_000389,18,30k-50k,mobile,returning,South,68,True,105,2,0,False,True,True,97,5,0,8.399173447838804,8,-3
user_000390,20,<30k,desktop,returning,Midwest,43,True,59,1,0,True,True,True,20,1,0,9.292153390358783,39,0
user_000391,57,30k-50k,mobile,returning,South,27,False,0,0,0,False,False,True,92,1,0,7.437826313141279,-92,-1
user_000392,45,30k-50k,desktop,new,Midwest,49,True,96,4,0,False,True,True,41,2,0,6.722559895565946,55,2
user_000393,18,50k-75k,desktop,new,South,67,True,123,2,0,True,True,True,113,1,0,8.202889326849686,10,1
user_000394,57,50k-75k,desktop,new,Midwest,15,True,160,3,0,False,False,True,164,1,0,7.0854895108899845,-4,2
user_000395,50,100k-150k,desktop,returning,East,57,True,74,1,0,False,False,True,90,1,0,6.347970903954912,-16,0
user_000396,37,30k-50k,desktop,new,West,62,True,98,2,0,True,True,True,46,1,0,9.786111587252917,52,1
user_000397,40,75k-100k,mobile,new,East,52,True,73,2,0,False,True,True,73,1,0,9.336434814062029,0,1
user_000398,35,100k-150k,mobile,new,Midwest,55,True,100,4,0,True,True,True,99,2,0,8.249198684374871,1,2
user_000399,48,50k-75k,mobile,returning,East,52,True,67,6,1,False,True,True,42,5,0,9.35084516692666,25,1
user_000400,48,50k-75k,desktop,returning,South,36,True,78,2,0,True,True,True,64,1,0,10.0,14,1
user_000401,59,50k-75k,mobile,returning,Midwest,48,True,86,1,1,True,False,True,69,1,0,4.895121289751712,17,0
user_000402,35,>150k,desktop,returning,Midwest,55,True,77,3,0,False,False,True,92,2,0,6.957986366986668,-15,1
user_000403,45,75k-100k,desktop,new,East,59,True,100,2,0,False,True,True,57,3,0,8.05626303082207,43,-1
user_000404,37,50k-75k,desktop,new,East,47,True,99,3,0,False,True,True,67,2,0,7.7754579312336,32,1
user_000405,54,75k-100k,mobile,returning,South,27,True,131,4,1,False,True,True,115,2,1,6.863581418360993,16,2
user_000406,21,50k-75k,desktop,new,Midwest,77,False,0,0,0,True,True,False,0,0,0,,0,0
user_000407,27,<30k,desktop,returning,East,84,False,0,0,0,True,False,True,120,2,0,6.806508610017791,-120,-2
user_000408,36,75k-100k,mobile,returning,East,47,True,115,5,0,False,True,True,89,4,0,8.192834730388302,26,1
user_000409,41,<30k,desktop,new,South,20,True,170,4,0,False,False,False,0,0,0,,170,4
user_000410,44,50k-75k,mobile,returning,Midwest,41,True,85,1,0,True,False,True,111,1,0,9.262705888467615,-26,0
user_000411,55,>150k,desktop,returning,East,75,True,30,2,0,False,True,True,20,1,0,8.532054501609553,10,1
user_000412,55,50k-75k,tablet,new,West,68,True,177,1,0,False,True,True,140,1,0,9.277308986291244,37,0
user_000413,46,<30k,mobile,new,East,63,False,0,0,0,False,True,True,100,1,0,8.077986947001737,-100,-1
user_000414,47,30k-50k,mobile,new,East,50,True,116,4,0,False,True,True,42,1,1,8.636387457724267,74,3
user_000415,41,100k-150k,mobile,returning,South,82,True,80,1,1,False,False,True,130,1,0,6.1337457581709005,-50,0
user_000416,43,50k-75k,mobile,new,West,35,True,158,6,0,False,False,True,148,6,0,8.609617359033638,10,0
user_000417,45,75k-100k,desktop,new,South,48,True,99,2,0,True,True,True,58,1,0,8.16357083074581,41,1
user_000418,39,>150k,mobile,returning,West,70,True,127,1,0,True,True,True,109,1,0,8.41674159815151,18,0
user_000419,52,75k-100k,desktop,returning,West,77,True,85,4,0,False,True,True,48,2,0,6.992183617258129,37,2
user_000420,41,50k-75k,desktop,new,East,56,True,71,2,1,False,False,True,84,1,0,5.663710077992593,-13,1
user_000421,32,50k-75k,desktop,returning,West,100,True,80,4,2,True,True,True,90,2,1,6.239343205611584,-10,2
user_000422,75,<30k,tablet,returning,West,35,True,116,2,0,True,False,True,89,3,0,6.853759068978629,27,-1
user_000423,18,<30k,mobile,returning,East,83,False,0,0,0,True,True,True,79,1,0,7.262586769810138,-79,-1
user_000424,38,<30k,mobile,returning,West,58,True,80,6,0,True,True,True,47,6,0,6.499001952218714,33,0
user_000425,21,>150k,mobile,returning,South,86,True,36,3,0,False,True,True,20,1,0,8.476743540831205,16,2
user_000426,51,50k-75k,desktop,new,Midwest,45,True,116,3,0,False,False,True,109,6,1,7.667134477826085,7,-3
user_000427,55,75k-100k,mobile,returning,Midwest,25,True,156,4,2,True,True,True,146,6,0,8.22246302785215,10,-2
user_000428,40,75k-100k,mobile,returning,South,44,True,59,5,0,True,True,True,39,4,0,6.716677789578119,20,1
user_000429,26,<30k,mobile,returning,West,79,True,110,2,0,True,True,True,101,4,0,8.713594765572779,9,-2
user_000430,38,30k-50k,desktop,returning,West,59,True,125,4,0,False,True,True,102,4,1,8.998771863504938,23,0
user_000431,56,50k-75k,desktop,new,East,32,False,0,0,0,False,False,True,119,1,0,6.212808592573527,-119,-1
user_000432,66,>150k,mobile,returning,East,40,True,81,3,1,True,True,True,69,1,0,5.895071601809038,12,2
user_000433,34,100k-150k,tablet,returning,East,96,True,82,4,0,False,True,True,72,3,0,8.36741782013689,10,1
user_000434,45,50k-75k,mobile,returning,West,45,True,65,3,0,False,True,True,60,1,0,8.35013626523922,5,2
user_000435,38,30k-50k,mobile,new,West,70,True,98,4,0,True,True,True,56,5,0,8.59415625623607,42,-1
user_000436,69,>150k,desktop,returning,Midwest,46,False,0,0,0,True,True,True,113,1,0,9.159079117392297,-113,-1
user_000437,42,30k-50k,mobile,returning,South,58,True,111,3,0,False,False,True,130,2,1,5.387604276702839,-19,1
user_000438,26,75k-100k,desktop,returning,West,85,True,58,2,1,False,True,True,25,1,2,8.21173279611764,33,1
user_000439,18,30k-50k,desktop,new,West,82,True,128,2,0,True,True,True,124,1,1,10.0,4,1
user_000440,55,100k-150k,desktop,new,Midwest,77,True,71,5,0,False,True,True,58,6,0,8.394156672138099,13,-1
user_000441,37,30k-50k,desktop,returning,East,48,True,94,3,0,True,True,True,82,5,0,9.660968148855757,12,-2
user_000442,34,<30k,desktop,new,East,60,True,105,3,0,False,True,True,89,5,0,8.526840601634364,16,-2
user_000443,55,>150k,mobile,new,East,47,True,171,5,0,True,False,True,140,4,0,5.271274925272436,31,1
user_000444,62,75k-100k,desktop,returning,East,20,True,90,5,0,False,False,True,103,2,0,6.566803217825199,-13,3
user_000445,36,100k-150k,mobile,returning,South,81,True,73,1,0,True,True,True,33,1,0,7.56133419956272,40,0
user_000446,32,50k-75k,desktop,new,East,77,True,111,2,1,False,True,True,64,1,0,6.973898068452641,47,1
user_000447,54,75k-100k,desktop,returning,West,37,True,100,5,0,True,True,True,67,1,0,9.65694294403642,33,4
user_000448,74,30k-50k,desktop,returning,West,91,True,91,1,0,True,True,True,88,1,0,7.603572349614352,3,0
user_000449,40,50k-75k,desktop,returning,Midwest,71,True,76,2,0,False,True,True,41,1,0,7.930810470558903,35,1
user_000450,57,100k-150k,desktop,returning,South,35,True,84,1,0,False,True,True,78,1,0,8.929305684326586,6,0
user_000451,51,30k-50k,mobile,new,South,56,True,128,6,0,False,True,True,137,6,1,7.890791128535549,-9,0
user_000452,28,75k-100k,desktop,returning,East,64,True,117,3,0,True,True,True,61,1,0,10.0,56,2
user_000453,22,75k-100k,desktop,returning,West,74,True,95,1,0,True,True,True,96,1,0,7.234524377969917,-1,0
user_000454,45,75k-100k,desktop,returning,South,35,False,0,0,0,False,False,True,139,1,0,8.766953721282286,-139,-1
user_000455,18,75k-100k,desktop,new,South,81,False,0,0,0,True,True,False,0,0,0,,0,0
user_000456,55,<30k,desktop,new,East,34,True,149,4,0,False,False,True,119,4,0,8.538785846000193,30,0
user_000457,63,75k-100k,desktop,new,Midwest,33,True,107,1,0,False,False,True,112,1,0,9.28979426723719,-5,0
user_000458,18,100k-150k,mobile,returning,West,100,True,45,1,0,True,True,True,21,1,0,7.896577035653658,24,0
user_000459,35,30k-50k,mobile,returning,East,73,False,0,0,0,True,True,True,98,2,0,5.669403291199237,-98,-2
user_000460,28,<30k,desktop,new,East,78,True,95,3,0,False,True,True,95,1,0,8.446155968502646,0,2
user_000461,61,<30k,mobile,returning,Midwest,41,True,118,2,0,False,False,True,121,1,0,6.685348994083518,-3,1
user_000462,30,30k-50k,mobile,returning,West,65,True,44,7,0,True,True,True,45,6,0,7.5171224971885025,-1,1
user_000463,41,50k-75k,tablet,new,East,36,False,0,0,0,False,True,True,77,1,0,8.568452965889087,-77,-1
user_000464,22,75k-100k,desktop,returning,East,60,True,118,5,0,True,True,True,102,3,0,8.727909033851434,16,2
user_000465,48,30k-50k,desktop,new,East,51,True,141,3,0,False,False,True,122,4,0,6.922243400977256,19,-1
user_000466,36,75k-100k,mobile,new,South,40,True,150,3,0,False,False,True,127,4,1,8.939230766020168,23,-1
user_000467,57,50k-75k,desktop,returning,East,17,True,100,3,0,True,True,True,92,4,0,9.344540589812638,8,-1
user_000468,60,75k-100k,desktop,new,East,39,False,0,0,0,False,False,False,0,0,0,,0,0
user_000469,53,100k-150k,mobile,new,South,65,True,114,2,0,True,True,True,96,1,0,9.192346498128517,18,1
user_000470,41,30k-50k,desktop,returning,Midwest,44,False,0,0,0,False,False,True,136,1,0,7.828257189445567,-136,-1
user_000471,61,50k-75k,mobile,returning,South,24,True,154,2,1,False,True,True,131,1,0,5.814123962949429,23,1
user_000472,44,30k-50k,desktop,returning,West,57,True,89,2,0,False,False,True,112,1,0,7.19731781986624,-23,1
user_000473,38,<30k,desktop,returning,East,15,True,107,3,0,True,True,True,79,5,0,7.963174856739079,28,-2
user_000474,25,75k-100k,mobile,returning,Midwest,75,True,107,1,0,True,True,True,44,1,0,8.879664285981734,63,0
user_000475,33,75k-100k,mobile,new,South,54,True,103,4,0,False,True,True,62,1,0,7.667743490568699,41,3
user_000476,55,30k-50k,mobile,new,East,72,True,95,1,0,False,True,True,82,2,0,8.731618032895236,13,-1
user_000477,52,75k-100k,mobile,returning,South,52,True,63,3,0,False,True,True,51,1,0,6.951757649303797,12,2
user_000478,58,100k-150k,desktop,new,Midwest,58,True,109,5,0,False,False,False,0,0,0,,109,5
user_000479,61,50k-75k,mobile,returning,South,65,True,82,1,0,False,False,True,62,2,0,6.867746932848579,20,-1
user_000480,41,30k-50k,mobile,returning,Midwest,66,True,152,2,1,True,True,True,141,1,0,6.320804947879493,11,1
user_000481,74,75k-100k,mobile,returning,East,23,True,155,4,0,False,False,True,140,4,0,7.381986326281897,15,0
user_000482,39,100k-150k,mobile,returning,East,64,True,137,4,0,True,True,True,102,2,0,7.783189845805958,35,2
user_000483,37,30k-50k,desktop,new,East,71,True,90,1,2,False,True,True,94,1,0,4.188790628780192,-4,0
user_000484,56,75k-100k,mobile,new,West,50,True,133,1,0,False,True,True,90,1,0,9.091062705299047,43,0
user_000485,28,100k-150k,desktop,new,East,72,True,134,5,0,True,False,True,108,9,0,8.202910272194668,26,-4
user_000486,52,50k-75k,desktop,returning,East,58,False,0,0,0,False,True,True,51,1,0,6.524431892274973,-51,-1
user_000487,46,30k-50k,desktop,returning,East,16,True,187,5,0,True,True,True,191,4,0,8.196327091541345,-4,1
user_000488,47,100k-150k,desktop,new,East,100,True,101,4,0,True,True,True,65,4,0,8.617661441736162,36,0
user_000489,51,30k-50k,desktop,returning,South,54,True,127,4,0,False,True,True,97,2,0,6.2381810106956275,30,2
user_000490,53,50k-75k,desktop,new,Midwest,31,False,0,0,0,True,True,True,77,1,0,8.431880669213902,-77,-1
user_000491,59,30k-50k,mobile,new,West,58,True,139,2,0,False,True,True,68,1,0,8.613641517634978,71,1
user_000492,34,50k-75k,mobile,new,West,61,True,103,1,1,False,True,True,52,1,0,9.705070670107146,51,0
user_000493,24,<30k,mobile,returning,Midwest,46,True,60,6,0,False,True,True,84,6,0,8.683109426269041,-24,0
user_000494,21,30k-50k,tablet,returning,Midwest,36,True,83,3,0,False,True,True,77,2,0,8.372865108001074,6,1
user_000495,18,50k-75k,desktop,returning,West,80,True,45,5,0,True,True,True,37,6,0,8.892802000763622,8,-1
user_000496,31,100k-150k,desktop,returning,West,98,True,68,4,0,True,True,True,38,2,0,8.181867430316133,30,2
user_000497,57,30k-50k,mobile,returning,West,41,True,81,3,0,False,True,True,102,3,1,6.347076020140525,-21,0
user_000498,80,30k-50k,desktop,returning,West,28,False,0,0,0,False,False,True,100,1,1,7.285794410949034,-100,-1
user_000499,49,75k-100k,desktop,new,West,86,True,49,5,0,True,True,True,62,2,0,6.612856803697193,-13,3
user_000500,61,100k-150k,desktop,returning,East,40,False,0,0,0,False,False,True,150,2,0,8.998821179150587,-150,-2
user_000501,32,50k-75k,mobile,returning,South,64,True,113,3,0,True,True,True,79,4,0,8.944246595167815,34,-1
user_000502,57,50k-75k,desktop,returning,West,11,True,100,5,0,True,False,True,50,2,0,6.139845965900915,50,3
user_000503,63,>150k,mobile,returning,West,52,True,124,1,0,False,False,True,102,1,0,6.4813176772266985,22,0
user_000504,35,50k-75k,tablet,returning,East,32,True,77,6,0,True,True,True,81,10,0,7.31620489089074,-4,-4
user_000505,58,50k-75k,mobile,returning,East,54,True,163,4,0,True,True,True,148,2,0,9.369797402160755,15,2
user_000506,41,75k-100k,mobile,new,Midwest,44,True,125,1,0,False,False,True,125,3,0,8.168004188951873,0,-2
user_000507,51,100k-150k,desktop,returning,West,96,True,113,5,1,False,True,True,76,4,0,6.816349438527897,37,1
user_000508,51,75k-100k,desktop,returning,East,37,True,126,2,0,False,False,True,96,2,0,8.105967989364952,30,0
user_000509,49,75k-100k,desktop,new,West,66,True,122,4,0,False,True,True,102,2,0,9.130999657165503,20,2
user_000510,47,100k-150k,desktop,returning,Midwest,74,True,112,2,0,True,True,True,86,2,0,7.524278428669745,26,0
user_000511,32,75k-100k,mobile,returning,Midwest,55,True,93,7,0,True,True,True,86,7,0,8.799659427053069,7,0
user_000512,45,30k-50k,mobile,new,East,63,True,119,6,0,False,True,True,101,9,0,5.617088043263277,18,-3
user_000513,52,30k-50k,mobile,returning,East,65,True,66,1,0,True,True,True,50,1,1,7.775520215967663,16,0
user_000514,47,75k-100k,mobile,returning,East,58,True,92,8,0,False,True,True,97,8,0,8.239194626833775,-5,0
user_000515,51,30k-50k,mobile,new,Midwest,24,False,0,0,0,False,True,True,75,1,0,8.538397646052818,-75,-1
user_000516,34,30k-50k,desktop,returning,South,73,True,97,1,0,True,True,True,60,1,1,6.792583967933857,37,0
user_000517,50,<30k,desktop,returning,East,16,True,114,2,0,True,False,True,74,1,1,6.391885641752296,40,1
user_000518,40,<30k,desktop,new,South,45,True,136,1,0,False,True,True,74,1,0,10.0,62,0
user_000519,52,100k-150k,tablet,returning,South,36,True,92,5,0,False,False,True,68,1,1,7.077374664339467,24,4
user_000520,56,<30k,mobile,returning,East,34,False,0,0,0,False,False,False,0,0,0,,0,0
user_000521,29,100k-150k,tablet,new,West,91,True,87,4,0,False,True,True,73,4,0,10.0,14,0
user_000522,61,<30k,mobile,returning,Midwest,0,True,134,3,1,True,False,True,171,2,0,5.425692200035787,-37,1
user_000523,50,30k-50k,mobile,returning,Midwest,61,True,92,2,0,False,True,True,74,1,0,7.056051006575922,18,1
user_000524,47,50k-75k,desktop,returning,Midwest,45,True,109,2,0,False,False,True,123,1,0,6.2594877967557965,-14,1
user_000525,52,75k-100k,mobile,returning,East,29,True,96,2,0,False,True,True,95,1,0,9.035005680042373,1,1
user_000526,54,100k-150k,desktop,new,East,78,True,116,4,0,False,True,True,102,4,0,9.631674170521444,14,0
user_000527,29,50k-75k,mobile,returning,Midwest,87,True,115,1,0,False,True,True,93,2,0,7.771929472352094,22,-1
user_000528,60,100k-150k,mobile,returning,Midwest,65,True,84,3,0,True,True,True,60,2,0,10.0,24,1
user_000529,53,30k-50k,mobile,returning,Midwest,31,True,71,4,1,False,True,True,69,4,0,8.077744926975768,2,0
user_000530,68,50k-75k,desktop,returning,West,57,True,89,4,0,False,True,True,102,2,0,6.434031402937716,-13,2
user_000531,18,100k-150k,desktop,returning,East,80,True,52,2,0,True,True,True,42,1,0,8.728008130462314,10,1
user_000532,71,30k-50k,desktop,new,South,53,False,0,0,0,False,True,False,0,0,0,,0,0
user_000533,47,50k-75k,mobile,new,East,38,True,114,5,0,False,True,True,80,3,0,9.958389208535156,34,2
user_000534,54,100k-150k,desktop,returning,West,62,True,52,3,0,False,False,True,38,1,0,6.670452307909114,14,2
user_000535,48,30k-50k,desktop,returning,West,72,True,76,2,0,False,False,True,74,1,0,7.856177072298078,2,1
user_000536,37,>150k,desktop,returning,West,72,True,71,6,0,False,True,True,57,5,0,9.675880203563647,14,1
user_000537,41,>150k,desktop,returning,South,48,True,117,3,0,False,True,True,97,3,0,6.642225483349927,20,0
user_000538,37,<30k,mobile,new,East,35,True,101,6,0,True,False,False,0,0,0,,101,6
user_000539,44,30k-50k,mobile,returning,South,52,False,0,0,0,False,False,True,146,1,0,6.636994491600806,-146,-1
user_000540,37,30k-50k,desktop,new,East,44,True,196,1,0,False,False,True,211,2,0,6.530427732696236,-15,-1
user_000541,53,30k-50k,mobile,returning,West,51,True,44,4,0,False,True,True,41,1,0,7.817332094384211,3,3
user_000542,44,<30k,mobile,returning,West,37,False,0,0,0,True,False,True,161,1,0,9.783625666761441,-161,-1
user_000543,47,30k-50k,desktop,returning,West,100,True,74,3,0,False,False,True,63,7,1,6.3736945523001785,11,-4
user_000544,43,<30k,desktop,new,East,27,True,169,3,0,False,True,True,85,3,0,8.1841291437104,84,0
user_000545,71,30k-50k,desktop,new,East,30,True,100,6,1,False,False,True,47,5,0,8.812193290186373,53,1
user_000546,50,50k-75k,desktop,returning,South,16,True,161,4,0,False,False,True,189,3,0,6.779707998110563,-28,1
user_000547,44,100k-150k,tablet,returning,East,43,True,142,2,0,True,True,True,145,2,0,6.647949249981832,-3,0
user_000548,59,75k-100k,desktop,returning,South,24,True,184,1,0,False,False,True,188,1,0,5.915003687742295,-4,0
user_000549,41,50k-75k,mobile,returning,South,40,False,0,0,0,False,True,True,110,1,0,7.753285482745595,-110,-1
user_000550,78,>150k,mobile,returning,Midwest,42,True,110,1,1,False,False,True,101,2,0,7.608250318555984,9,-1
user_000551,48,30k-50k,desktop,returning,Midwest,28,False,0,0,0,False,False,False,0,0,0,,0,0
user_000552,36,30k-50k,mobile,new,West,72,False,0,0,0,True,True,True,83,1,0,8.051485828859262,-83,-1
user_000553,63,100k-150k,tablet,returning,West,52,True,56,3,0,True,True,True,37,2,0,6.615414936027682,19,1
user_000554,37,50k-75k,mobile,returning,South,52,True,87,3,0,False,False,True,91,3,0,5.465040117304389,-4,0
user_000555,32,75k-100k,mobile,new,South,51,True,145,2,0,False,False,True,131,2,0,8.129224434024255,14,0
user_000556,35,<30k,desktop,returning,Midwest,41,True,65,1,0,False,True,True,38,3,0,8.461084923525627,27,-2
user_000557,30,50k-75k,mobile,new,East,59,True,142,1,0,False,True,True,92,1,0,8.91312149289635,50,0
user_000558,35,30k-50k,desktop,returning,East,56,False,0,0,0,False,False,False,0,0,0,,0,0
user_000559,37,50k-75k,mobile,returning,South,65,True,111,4,0,True,True,True,99,2,0,9.388949482865154,12,2
user_000560,47,100k-150k,mobile,new,West,43,True,160,2,0,False,False,True,192,1,0,7.212125461267116,-32,1
user_000561,18,75k-100k,desktop,returning,East,95,True,56,3,0,True,True,True,65,3,0,6.671853165948467,-9,0
user_000562,36,100k-150k,mobile,new,East,69,False,0,0,0,False,True,True,105,1,0,7.236302153991886,-105,-1
user_000563,38,75k-100k,mobile,new,East,68,True,93,9,0,True,True,True,79,6,0,9.971280942506032,14,3
user_000564,55,75k-100k,mobile,returning,West,87,True,30,7,0,True,True,True,20,10,0,9.572723603093083,10,-3
user_000565,46,100k-150k,mobile,new,West,94,True,112,8,0,True,True,False,0,0,0,,112,8
user_000566,46,75k-100k,mobile,new,West,63,True,103,6,0,True,True,True,75,1,0,7.614365388905866,28,5
user_000567,58,100k-150k,mobile,returning,Midwest,38,True,139,1,0,True,True,True,144,1,0,7.902545588298638,-5,0
user_000568,58,100k-150k,desktop,returning,East,72,True,51,1,0,True,True,True,20,1,0,6.2092892366239765,31,0
user_000569,20,>150k,mobile,new,West,89,True,37,5,0,False,True,False,0,0,0,,37,5
user_000570,54,30k-50k,desktop,returning,West,57,True,111,2,0,False,True,True,115,2,0,7.08577574718749,-4,0
user_000571,46,<30k,mobile,new,Midwest,0,True,175,4,0,False,False,True,166,8,0,7.463905337875095,9,-4
user_000572,52,30k-50k,desktop,returning,South,67,True,131,1,0,True,True,True,101,3,0,7.393230916307788,30,-2
user_000573,30,100k-150k,desktop,returning,West,100,True,79,4,0,False,True,True,46,3,0,7.279613162218259,33,1
user_000574,62,50k-75k,desktop,returning,South,13,True,72,3,1,False,True,True,47,6,0,6.630613366340149,25,-3
user_000575,63,30k-50k,mobile,new,East,31,True,130,5,1,False,False,True,153,6,0,8.035404092259347,-23,-1
user_000576,18,<30k,desktop,returning,East,58,False,0,0,0,True,True,True,69,1,0,7.853337165143261,-69,-1
user_000577,58,50k-75k,mobile,new,West,46,False,0,0,0,False,False,True,126,2,0,8.16777267590775,-126,-2
user_000578,48,30k-50k,desktop,returning,South,64,False,0,0,0,True,True,True,57,4,0,7.599444360975095,-57,-4
user_000579,43,75k-100k,desktop,returning,East,51,True,32,4,0,True,True,True,27,5,0,7.025325803850233,5,-1
user_000580,67,50k-75k,desktop,new,South,39,True,136,2,0,False,True,True,119,1,0,10.0,17,1
user_000581,48,<30k,desktop,returning,West,31,True,71,4,0,False,False,True,90,2,0,8.786368413026215,-19,2
user_000582,18,30k-50k,desktop,returning,South,52,True,121,7,0,True,True,True,75,2,0,3.9146162168817766,46,5
user_000583,53,<30k,mobile,returning,East,19,True,143,1,0,False,False,True,177,1,0,7.212435735731858,-34,0
user_000584,43,30k-50k,desktop,returning,South,64,True,74,4,0,False,False,True,56,3,0,6.073189583718403,18,1
user_000585,22,50k-75k,mobile,returning,East,27,True,119,5,0,False,False,True,96,6,0,8.105978332932896,23,-1
user_000586,38,100k-150k,mobile,returning,South,77,True,72,3,0,True,True,True,67,1,0,8.886558369683653,5,2
user_000587,47,50k-75k,mobile,returning,West,66,True,117,4,0,True,True,True,75,1,0,10.0,42,3
user_000588,51,50k-75k,mobile,returning,East,35,True,122,4,0,True,False,True,115,4,0,6.381212665718024,7,0
user_000589,30,>150k,desktop,returning,West,91,True,85,3,0,False,True,True,72,4,0,8.044792571972579,13,-1
user_000590,55,75k-100k,desktop,returning,West,29,True,164,3,0,True,True,True,178,3,0,7.873594252650168,-14,0
user_000591,24,50k-75k,desktop,returning,Midwest,54,True,113,3,0,False,True,True,106,5,0,8.98194411051381,7,-2
user_000592,36,<30k,mobile,returning,Midwest,38,True,72,6,0,False,True,True,36,3,0,5.922420877026785,36,3
user_000593,43,50k-75k,mobile,new,South,37,False,0,0,0,False,False,True,92,1,0,7.677413298624851,-92,-1
user_000594,71,30k-50k,desktop,returning,West,45,True,88,3,0,True,False,True,82,2,0,5.951242404373719,6,1
user_000595,48,>150k,mobile,returning,South,70,True,94,4,0,True,True,True,73,3,0,9.36070820147497,21,1
user_000596,34,75k-100k,mobile,returning,East,97,True,55,2,0,True,False,True,54,1,0,8.60352885795498,1,1
user_000597,63,75k-100k,desktop,new,South,32,True,102,4,0,True,True,True,82,5,0,6.957903836485696,20,-1
user_000598,44,50k-75k,mobile,returning,East,68,True,77,1,0,True,True,True,46,1,1,9.284658360080387,31,0
user_000599,43,50k-75k,mobile,returning,East,56,True,92,4,0,True,True,True,77,3,0,8.22672009237712,15,1
user_000600,43,75k-100k,mobile,returning,South,53,True,30,3,0,True,True,True,33,2,0,9.387193344406779,-3,1
user_000601,69,75k-100k,mobile,returning,West,61,True,94,2,0,True,True,True,80,2,0,9.985765462322627,14,0
user_000602,25,75k-100k,mobile,returning,West,88,True,50,3,1,False,True,True,20,4,0,6.5676931496601005,30,-1
user_000603,40,30k-50k,desktop,returning,West,41,True,95,2,0,True,True,True,59,1,0,7.295227762582175,36,1
user_000604,60,75k-100k,desktop,new,East,59,False,0,0,0,False,True,True,95,4,0,8.156436871954192,-95,-4
user_000605,52,30k-50k,mobile,new,South,39,True,147,4,0,False,True,True,134,4,0,10.0,13,0
user_000606,18,100k-150k,mobile,new,West,100,False,0,0,0,False,True,True,78,3,0,8.11220396409426,-78,-3
user_000607,43,<30k,desktop,new,South,34,True,126,2,0,False,True,True,74,3,0,7.306290876109221,52,-1
user_000608,59,50k-75k,mobile,returning,East,19,True,152,3,0,False,False,False,0,0,0,,152,3
user_000609,43,30k-50k,desktop,returning,East,40,True,88,3,0,True,True,True,129,1,0,7.95103174416328,-41,2
user_000610,43,100k-150k,desktop,new,West,61,True,133,5,0,False,False,True,100,9,0,6.86236814210776,33,-4
user_000611,18,30k-50k,desktop,new,West,74,True,105,6,0,False,False,False,0,0,0,,105,6
user_000612,64,30k-50k,mobile,returning,West,49,False,0,0,0,False,False,True,153,1,0,9.162703198771535,-153,-1
user_000613,27,75k-100k,mobile,new,East,43,True,129,7,0,False,False,True,119,6,0,8.178609868964505,10,1
user_000614,30,75k-100k,mobile,new,East,79,True,32,4,0,False,False,True,20,11,0,8.894301205455472,12,-7
user_000615,29,75k-100k,mobile,returning,South,53,False,0,0,0,False,True,True,110,1,0,6.987034731566999,-110,-1
user_000616,59,50k-75k,mobile,returning,South,37,True,64,9,0,False,False,True,75,8,0,5.595441659184621,-11,1
user_000617,27,50k-75k,mobile,returning,East,83,True,73,1,0,True,False,True,24,3,0,7.811563398382032,49,-2
user_000618,58,<30k,tablet,new,South,47,True,129,2,0,False,False,True,118,4,0,7.058490744541363,11,-2
user_000619,21,100k-150k,mobile,returning,Midwest,51,True,74,2,0,False,True,True,72,1,0,8.899352647628993,2,1
user_000620,47,30k-50k,desktop,returning,West,66,True,87,4,0,True,True,True,109,2,0,5.837044750908534,-22,2
user_000621,30,100k-150k,desktop,returning,West,84,True,67,1,0,True,True,True,81,1,0,8.97456874756494,-14,0
user_000622,58,75k-100k,mobile,returning,West,51,True,86,4,0,False,True,True,83,2,0,8.71325884492867,3,2
user_000623,56,30k-50k,desktop,returning,Midwest,56,True,77,1,0,False,True,True,59,1,0,8.99668521610569,18,0
user_000624,29,50k-75k,mobile,returning,West,91,False,0,0,0,True,True,True,128,1,0,6.891560428667009,-128,-1
user_000625,49,75k-100k,desktop,new,West,45,True,143,5,0,False,True,True,131,4,0,7.241046311089449,12,1
user_000626,56,100k-150k,mobile,returning,East,49,True,150,3,0,True,False,True,114,4,0,7.446480927122292,36,-1
user_000627,28,30k-50k,desktop,new,West,100,True,106,3,0,False,True,True,105,4,0,8.325019520302869,1,-1
user_000628,47,50k-75k,mobile,new,Midwest,59,True,108,1,1,False,True,True,87,1,1,6.791370516192692,21,0
user_000629,19,50k-75k,desktop,new,West,95,True,113,2,0,False,True,True,79,1,0,8.156201836179841,34,1
user_000630,48,100k-150k,mobile,new,Midwest,32,True,118,1,0,False,False,True,86,2,0,8.242467907408761,32,-1
user_000631,50,75k-100k,desktop,returning,Midwest,47,True,143,1,0,True,False,True,130,1,0,7.685761636727742,13,0
user_000632,62,30k-50k,mobile,new,West,66,True,174,3,1,False,True,True,142,3,0,7.9968041923674695,32,0
user_000633,54,50k-75k,mobile,returning,East,79,True,47,3,0,True,True,True,29,2,0,8.912579311793227,18,1
user_000634,48,30k-50k,mobile,new,South,54,True,148,3,0,False,True,True,138,4,0,8.028551414983236,10,-1
user_000635,31,<30k,mobile,returning,South,75,True,89,3,0,True,True,True,91,3,0,7.414678723215079,-2,0
user_000636,46,30k-50k,mobile,returning,South,53,True,102,3,0,False,True,True,58,3,0,9.440627710344105,44,0
user_000637,21,50k-75k,mobile,returning,East,92,True,74,3,0,False,True,True,47,4,0,7.855290423278681,27,-1
user_000638,66,30k-50k,mobile,new,West,7,True,125,4,0,False,False,True,114,7,0,7.602415028708133,11,-3
user_000639,26,100k-150k,tablet,returning,South,63,True,77,2,0,False,True,True,43,1,0,8.366042982836655,34,1
user_000640,50,50k-75k,desktop,returning,East,35,True,86,2,0,False,False,True,32,5,0,7.445837169702825,54,-3
user_000641,52,<30k,desktop,returning,Midwest,40,True,123,2,0,True,True,True,104,1,0,7.588432921344608,19,1
user_000642,76,50k-75k,desktop,returning,West,29,True,145,5,2,True,True,True,113,3,0,5.9656652103484955,32,2
user_000643,44,100k-150k,mobile,new,South,45,True,111,2,0,True,False,True,135,1,0,8.397249083941844,-24,1
user_000644,47,50k-75k,desktop,new,West,46,True,124,2,1,False,False,True,126,1,0,6.769794054045018,-2,1
user_000645,44,50k-75k,mobile,returning,South,36,True,154,5,1,True,True,True,124,5,0,9.043085904798346,30,0
user_000646,68,75k-100k,mobile,new,Midwest,38,True,89,3,0,True,False,True,124,2,0,7.332013519307869,-35,1
user_000647,52,50k-75k,desktop,returning,West,86,True,67,4,0,True,True,True,35,6,0,8.45275746047112,32,-2
user_000648,29,50k-75k,desktop,new,East,88,True,68,2,0,False,True,True,42,1,0,9.399878267329383,26,1
user_000649,55,75k-100k,mobile,returning,East,47,True,30,1,0,False,True,True,25,1,0,8.94041833884364,5,0
user_000650,36,30k-50k,mobile,returning,South,42,True,59,1,1,False,True,True,46,1,0,6.035551616308536,13,0
user_000651,27,30k-50k,desktop,new,Midwest,39,True,55,6,1,False,True,True,27,1,0,6.814871520608809,28,5
user_000652,34,<30k,desktop,returning,East,89,True,57,3,0,False,True,True,20,1,0,8.667012441535311,37,2
user_000653,51,75k-100k,mobile,returning,South,46,True,82,2,2,False,False,True,94,1,0,7.4010762482484775,-12,1
user_000654,19,30k-50k,desktop,returning,Midwest,49,True,75,1,0,True,False,True,51,1,0,8.337276135280929,24,0
user_000655,77,<30k,mobile,new,Midwest,37,True,117,4,1,False,False,True,106,1,0,5.210220296871389,11,3
user_000656,32,100k-150k,desktop,new,South,81,True,141,3,0,False,True,True,117,1,1,8.308086254368513,24,2
user_000657,43,50k-75k,desktop,returning,East,48,True,72,2,0,False,False,True,51,3,0,7.554100214696359,21,-1
user_000658,52,50k-75k,desktop,new,South,67,True,115,3,0,False,False,True,130,3,0,7.702040719784894,-15,0
user_000659,52,100k-150k,mobile,returning,Midwest,68,True,84,4,1,False,False,True,83,3,1,6.999684158479789,1,1
user_000660,51,30k-50k,desktop,new,South,7,True,152,2,0,False,False,True,149,4,0,6.424623807736618,3,-2
user_000661,34,50k-75k,desktop,returning,East,63,True,170,3,0,False,True,True,126,1,0,8.03399183344988,44,2
user_000662,57,50k-75k,desktop,returning,West,48,False,0,0,0,False,False,True,115,1,1,6.185279367688827,-115,-1
user_000663,51,50k-75k,mobile,returning,West,66,True,109,3,0,True,True,True,76,2,0,6.81283498247161,33,1
user_000664,51,50k-75k,mobile,returning,Midwest,61,True,116,1,0,False,True,True,101,1,0,6.669884905871327,15,0
user_000665,79,75k-100k,desktop,returning,South,43,True,66,2,1,True,True,True,42,2,0,8.41243026391029,24,0
user_000666,47,30k-50k,desktop,returning,West,50,True,107,4,0,False,True,True,85,4,0,10.0,22,0
user_000667,43,75k-100k,desktop,new,Midwest,32,True,55,4,0,False,False,True,68,4,0,5.07900991766087,-13,0
user_000668,43,30k-50k,mobile,new,East,41,True,133,3,0,False,False,True,151,6,0,6.501875154005624,-18,-3
user_000669,45,50k-75k,desktop,returning,South,27,True,108,2,0,False,False,True,140,1,0,6.483053915026527,-32,1
user_000670,47,<30k,mobile,returning,Midwest,50,True,113,6,0,True,True,True,100,2,0,7.003305118222258,13,4
user_000671,47,>150k,mobile,new,West,54,False,0,0,0,False,True,True,119,1,0,7.490944448557373,-119,-1
user_000672,38,75k-100k,mobile,returning,South,41,True,117,6,1,True,True,True,97,3,0,6.694695361916337,20,3
user_000673,34,30k-50k,mobile,new,East,50,True,147,8,0,True,True,True,104,2,0,10.0,43,6
user_000674,59,>150k,desktop,returning,West,28,True,100,8,1,False,False,True,119,13,0,6.41671620446196,-19,-5
user_000675,40,<30k,mobile,returning,Midwest,0,True,140,6,0,True,False,True,154,3,0,6.308961487436259,-14,3
user_000676,67,50k-75k,mobile,new,West,54,False,0,0,0,False,False,True,108,1,0,7.13183112394145,-108,-1
user_000677,52,30k-50k,mobile,new,West,51,False,0,0,0,False,False,False,0,0,0,,0,0
user_000678,42,75k-100k,desktop,returning,South,39,True,78,8,0,False,False,True,87,7,0,6.42701073813492,-9,1
user_000679,45,30k-50k,desktop,returning,West,60,True,94,4,0,True,True,True,87,2,1,8.25796729120158,7,2
user_000680,52,30k-50k,mobile,returning,South,36,True,78,4,0,False,False,True,83,2,0,7.151833192815655,-5,2
user_000681,51,30k-50k,desktop,returning,Midwest,52,True,94,1,0,False,False,True,95,1,0,7.964591692261194,-1,0
user_000682,64,100k-150k,mobile,returning,West,26,True,107,3,0,True,True,True,73,3,0,7.578141829034741,34,0
user_000683,30,50k-75k,desktop,returning,West,100,True,58,8,0,False,True,True,23,9,0,9.803373134460383,35,-1
user_000684,36,<30k,mobile,returning,South,17,False,0,0,0,False,False,True,120,1,0,6.73865789064454,-120,-1
user_000685,67,75k-100k,desktop,returning,East,62,True,83,3,0,False,True,True,77,3,0,9.868866584605072,6,0
user_000686,55,30k-50k,desktop,returning,Midwest,32,True,81,4,0,True,True,True,55,3,0,10.0,26,1
user_000687,58,<30k,mobile,returning,Midwest,3,False,0,0,0,True,True,True,92,1,0,7.245652620124454,-92,-1
user_000688,28,50k-75k,desktop,returning,Midwest,64,True,102,4,0,True,True,True,85,5,0,9.234079845416522,17,-1
user_000689,18,30k-50k,mobile,returning,East,69,True,110,7,0,False,False,True,101,5,0,6.714441544670102,9,2
user_000690,43,75k-100k,mobile,returning,South,25,True,163,1,2,True,True,True,165,1,0,6.197109214839684,-2,0
user_000691,59,<30k,desktop,returning,East,25,True,153,1,0,True,True,True,116,1,0,7.053388101679386,37,0
user_000692,48,30k-50k,mobile,returning,Midwest,58,True,79,1,0,False,False,True,104,1,0,6.118496759797537,-25,0
user_000693,25,100k-150k,mobile,returning,South,84,True,36,4,0,True,True,True,20,1,0,8.67127759777923,16,3
user_000694,76,30k-50k,mobile,new,East,54,False,0,0,0,False,True,False,0,0,0,,0,0
user_000695,46,50k-75k,desktop,new,West,40,False,0,0,0,False,False,True,128,1,0,5.298879977032153,-128,-1
user_000696,61,30k-50k,mobile,returning,South,39,True,110,5,0,True,True,True,68,2,0,7.60746061245126,42,3
user_000697,79,100k-150k,mobile,new,South,22,True,126,2,1,False,True,True,94,1,0,6.101567880187894,32,1
user_000698,30,75k-100k,desktop,returning,South,80,True,106,2,0,False,False,True,86,1,0,6.0407201772883115,20,1
user_000699,32,100k-150k,mobile,new,South,69,True,100,3,0,True,True,True,62,3,0,10.0,38,0
user_000700,56,<30k,desktop,returning,Midwest,8,True,112,2,0,True,False,False,0,0,0,,112,2
user_000701,45,75k-100k,mobile,returning,West,61,True,119,2,0,True,False,True,139,1,0,7.518085463138655,-20,1
user_000702,30,100k-150k,mobile,returning,South,75,True,31,3,0,True,True,True,20,3,0,9.173820455707435,11,0
user_000703,18,75k-100k,desktop,returning,West,80,True,46,1,1,False,True,True,56,1,0,6.940690715283977,-10,0
user_000704,21,50k-75k,desktop,returning,West,70,True,40,1,0,True,True,False,0,0,0,,40,1
user_000705,51,30k-50k,desktop,returning,East,54,True,127,2,0,True,True,True,111,3,0,7.757495712274485,16,-1
user_000706,37,100k-150k,mobile,returning,East,62,True,107,2,0,False,True,True,97,1,0,9.021073625949318,10,1
user_000707,48,50k-75k,mobile,new,East,53,True,114,5,0,False,False,True,114,4,0,4.19060875673392,0,1
user_000708,51,30k-50k,desktop,returning,South,32,True,94,3,1,False,False,True,88,1,0,5.668717362719581,6,2
user_000709,47,100k-150k,desktop,new,East,98,True,95,3,0,False,True,True,98,2,0,6.571119914040366,-3,1
user_000710,62,<30k,mobile,returning,South,1,False,0,0,0,True,False,True,126,1,0,8.535546405852804,-126,-1
user_000711,60,75k-100k,desktop,returning,East,48,False,0,0,0,False,False,True,122,1,0,8.425087060229863,-122,-1
user_000712,46,75k-100k,mobile,returning,West,57,True,142,3,0,True,True,True,109,1,0,6.937877169535537,33,2
user_000713,47,50k-75k,desktop,returning,West,78,True,102,2,0,False,True,True,62,2,0,9.048307645030684,40,0
user_000714,64,30k-50k,desktop,returning,Midwest,27,True,150,3,0,False,True,True,111,1,0,8.001514461620989,39,2
user_000715,63,100k-150k,desktop,new,South,60,True,155,4,1,False,False,True,145,5,3,7.496304351038915,10,-1
user_000716,58,50k-75k,desktop,returning,West,41,True,90,2,0,True,True,True,60,1,0,6.865991804993964,30,1
user_000717,31,<30k,tablet,returning,Midwest,42,True,46,1,0,False,True,True,20,2,0,5.556106041397588,26,-1
user_000718,51,100k-150k,mobile,returning,East,65,True,129,6,1,True,True,False,0,0,0,,129,6
user_000719,60,50k-75k,mobile,new,East,32,True,104,5,0,False,False,True,105,3,0,7.373301946407547,-1,2
user_000720,42,50k-75k,desktop,new,South,43,True,125,2,0,True,True,True,100,1,0,8.910963946811071,25,1
user_000721,35,75k-100k,desktop,returning,East,58,True,45,1,0,False,True,True,20,1,0,8.386894226491428,25,0
user_000722,57,100k-150k,desktop,returning,East,37,False,0,0,0,False,False,True,121,1,0,8.554135992442934,-121,-1
user_000723,56,50k-75k,mobile,returning,South,28,True,92,3,0,False,False,True,100,2,0,7.08190069368622,-8,1
user_000724,34,30k-50k,mobile,new,East,77,False,0,0,0,False,False,True,117,1,0,8.778933235382233,-117,-1
user_000725,30,<30k,mobile,returning,South,52,False,0,0,0,False,True,True,108,1,0,8.631402298046755,-108,-1
user_000726,36,50k-75k,mobile,returning,Midwest,49,False,0,0,0,True,True,True,107,1,0,8.501971669407991,-107,-1
user_000727,63,<30k,tablet,new,West,28,False,0,0,0,False,False,True,89,1,0,7.7794118775416825,-89,-1
user_000728,49,30k-50k,mobile,returning,East,49,False,0,0,0,False,True,True,108,2,0,7.523035832337191,-108,-2
user_000729,48,50k-75k,tablet,returning,West,60,True,139,2,0,True,False,True,118,1,0,7.1430202024578575,21,1
user_000730,54,100k-150k,mobile,returning,East,56,True,115,2,0,False,True,True,98,1,0,10.0,17,1
user_000731,33,30k-50k,desktop,new,East,58,True,159,3,1,False,True,True,178,4,1,7.524624803489931,-19,-1
user_000732,18,<30k,mobile,returning,East,41,True,41,2,0,True,True,True,37,2,0,9.08516831751513,4,0
user_000733,42,100k-150k,desktop,returning,East,60,True,75,2,0,False,True,True,47,1,0,6.502803275564947,28,1
user_000734,49,30k-50k,mobile,new,South,31,True,125,3,0,False,False,True,153,5,0,5.789489129118285,-28,-2
user_000735,47,<30k,mobile,returning,West,69,True,81,3,0,False,False,True,59,4,0,7.520723431206779,22,-1
user_000736,48,<30k,tablet,new,South,31,True,94,4,2,False,True,True,73,3,1,5.457742386580483,21,1
user_000737,42,<30k,desktop,returning,South,38,True,72,4,0,False,False,True,73,3,0,7.766269798404162,-1,1
user_000738,26,30k-50k,mobile,returning,East,72,False,0,0,0,False,True,True,99,1,0,9.888364732444327,-99,-1
user_000739,54,75k-100k,mobile,new,East,62,True,91,1,0,True,True,True,25,1,0,8.15950542750767,66,0
user_000740,26,75k-100k,mobile,returning,West,53,True,141,3,0,False,True,True,119,2,0,5.795100023679225,22,1
user_000741,39,<30k,mobile,returning,South,33,True,51,6,0,True,True,True,20,4,0,6.396954026545293,31,2
user_000742,39,30k-50k,mobile,returning,West,64,True,107,3,0,False,True,True,96,2,0,7.848434691783166,11,1
user_000743,27,>150k,mobile,returning,East,92,True,68,2,0,True,True,True,20,3,0,7.5426579514478815,48,-1
user_000744,62,<30k,desktop,returning,South,27,True,120,7,0,False,False,True,136,9,1,6.566394027179598,-16,-2
user_000745,30,<30k,mobile,new,Midwest,49,True,138,6,0,False,True,False,0,0,0,,138,6
user_000746,35,50k-75k,desktop,returning,West,49,False,0,0,0,False,False,True,150,1,0,6.613290708024467,-150,-1
user_000747,61,30k-50k,desktop,returning,Midwest,23,True,121,5,0,True,False,True,138,4,0,7.288718820211089,-17,1
user_000748,64,30k-50k,desktop,returning,West,28,True,103,4,0,True,True,True,57,4,0,7.6039470265195925,46,0
user_000749,24,<30k,desktop,new,West,78,True,80,4,0,True,True,True,37,3,1,8.70340559877397,43,1
user_000750,44,50k-75k,mobile,new,East,46,True,130,4,0,True,True,True,117,1,0,6.418313276465417,13,3
user_000751,49,<30k,mobile,returning,West,74,True,42,2,0,True,True,True,22,1,0,9.3208458603186,20,1
user_000752,28,100k-150k,desktop,returning,West,72,True,33,3,0,True,True,True,30,8,0,6.631885504100628,3,-5
user_000753,59,75k-100k,mobile,returning,Midwest,33,True,105,5,0,False,False,True,152,1,0,8.71599271094149,-47,4
user_000754,49,<30k,mobile,returning,West,52,False,0,0,0,False,False,True,105,1,0,6.0423668312515435,-105,-1
user_000755,18,50k-75k,mobile,returning,East,67,True,130,4,0,False,False,True,113,2,0,7.1179786347541745,17,2
user_000756,33,100k-150k,desktop,returning,South,51,True,153,6,0,False,True,False,0,0,0,,153,6
user_000757,65,100k-150k,mobile,returning,South,55,True,115,2,0,True,True,True,115,4,0,8.415887681350783,0,-2
user_000758,70,100k-150k,desktop,returning,West,45,False,0,0,0,False,True,True,106,2,0,9.918706537030491,-106,-2
user_000759,53,50k-75k,desktop,returning,Midwest,33,True,122,6,0,False,False,True,126,7,0,4.958095402385396,-4,-1
user_000760,22,50k-75k,mobile,new,Midwest,63,True,131,7,0,False,True,True,117,10,0,8.837746702148271,14,-3
user_000761,59,>150k,desktop,returning,East,49,False,0,0,0,False,True,True,109,1,0,7.494437388337909,-109,-1
user_000762,41,50k-75k,desktop,new,East,44,True,136,1,0,True,True,True,115,1,0,5.142449126341433,21,0
user_000763,59,<30k,mobile,returning,West,41,False,0,0,0,True,True,True,79,1,0,9.31805879527678,-79,-1
user_000764,58,50k-75k,mobile,returning,Midwest,41,True,65,4,0,True,False,True,54,2,0,7.013022432462152,11,2
user_000765,39,>150k,desktop,new,Midwest,48,True,84,3,0,True,True,True,74,2,0,6.356677266054286,10,1
user_000766,38,100k-150k,desktop,returning,East,78,True,44,5,1,True,False,True,33,5,0,5.563411095169575,11,0
user_000767,40,100k-150k,mobile,returning,South,40,True,79,6,0,True,True,True,49,5,1,7.984641596154699,30,1
user_000768,36,30k-50k,desktop,returning,Midwest,35,True,90,6,1,True,True,True,81,1,0,5.817392977657952,9,5
user_000769,34,<30k,mobile,returning,South,83,False,0,0,0,True,True,True,83,1,0,7.965614323530089,-83,-1
user_000770,35,>150k,desktop,returning,East,70,True,125,1,1,True,True,True,94,1,0,9.487113484167674,31,0
user_000771,39,30k-50k,desktop,returning,Midwest,28,True,92,2,0,True,False,True,106,3,0,6.056704084837284,-14,-1
user_000772,52,75k-100k,tablet,returning,South,66,True,69,3,0,True,True,True,91,3,0,8.204370438825332,-22,0
user_000773,80,30k-50k,desktop,returning,Midwest,13,True,109,9,0,False,False,False,0,0,0,,109,9
user_000774,73,30k-50k,desktop,new,South,18,True,179,3,1,False,False,False,0,0,0,,179,3
user_000775,18,50k-75k,mobile,returning,East,70,True,107,7,0,False,True,True,71,4,0,8.63785161045423,36,3
user_000776,69,75k-100k,mobile,returning,East,40,False,0,0,0,False,False,True,90,1,0,9.233374540533223,-90,-1
user_000777,24,50k-75k,mobile,returning,East,78,False,0,0,0,True,True,True,95,1,0,7.2256977686373975,-95,-1
user_000778,37,50k-75k,mobile,new,West,69,False,0,0,0,True,True,False,0,0,0,,0,0
user_000779,30,30k-50k,desktop,returning,West,82,True,92,2,0,True,True,True,65,2,0,6.088388384853423,27,0
user_000780,43,<30k,mobile,returning,West,41,False,0,0,0,True,False,True,97,1,1,7.628742696070827,-97,-1
user_000781,77,100k-150k,mobile,returning,West,38,True,72,2,0,True,True,True,57,1,0,6.677567981888047,15,1
user_000782,33,50k-75k,mobile,new,West,76,True,127,8,1,False,True,True,136,3,0,7.747960680541997,-9,5
user_000783,68,75k-100k,tablet,returning,South,42,True,86,5,0,False,False,True,80,8,0,7.67201581923173,6,-3
user_000784,32,30k-50k,desktop,returning,East,84,True,87,3,0,True,True,True,101,2,0,8.025540791163248,-14,1
user_000785,48,30k-50k,desktop,new,East,61,True,158,3,0,True,True,True,123,3,0,6.541254435362275,35,0
user_000786,55,50k-75k,mobile,new,South,87,True,77,2,0,True,True,True,80,3,0,10.0,-3,-1
user_000787,33,<30k,mobile,returning,East,62,True,107,4,1,True,True,True,80,1,0,8.61982599175125,27,3
user_000788,66,75k-100k,desktop,returning,West,51,True,142,3,0,False,False,True,148,3,0,7.5957334299463675,-6,0
user_000789,30,50k-75k,desktop,returning,South,69,True,52,2,0,True,True,True,20,2,1,6.589449098490831,32,0
user_000790,27,30k-50k,mobile,returning,South,80,True,99,2,0,False,True,True,51,2,0,8.199211732013234,48,0
user_000791,38,30k-50k,desktop,returning,West,61,True,145,1,0,False,True,True,123,1,0,9.071760709611775,22,0
user_000792,39,30k-50k,desktop,new,South,40,True,70,5,0,False,False,True,20,4,0,7.752307067181278,50,1
user_000793,64,30k-50k,desktop,returning,Midwest,26,True,132,3,0,True,True,True,98,4,0,8.228177590550256,34,-1
user_000794,62,100k-150k,mobile,returning,South,39,True,88,1,0,False,True,True,39,1,0,6.885717425839631,49,0
user_000795,28,<30k,desktop,returning,South,76,True,121,4,0,True,True,True,115,2,0,8.529002357368709,6,2
user_000796,53,100k-150k,mobile,new,Midwest,51,True,114,3,0,False,True,True,100,2,0,6.635500459614937,14,1
user_000797,65,75k-100k,mobile,returning,East,48,True,64,4,1,False,False,False,0,0,0,,64,4
user_000798,41,>150k,mobile,returning,East,68,True,101,2,0,True,True,True,46,2,1,6.089792510510866,55,0
user_000799,68,100k-150k,mobile,new,South,22,True,189,4,1,False,False,True,178,4,0,7.166395614795031,11,0
user_000800,41,50k-75k,desktop,new,West,31,False,0,0,0,False,False,True,120,1,0,8.201714921628104,-120,-1
user_000801,59,30k-50k,mobile,returning,West,48,True,96,1,0,False,False,True,120,1,0,7.526969155315779,-24,0
user_000802,33,30k-50k,desktop,returning,East,94,True,77,1,0,True,True,True,50,3,0,8.558442052993392,27,-2
user_000803,43,50k-75k,mobile,returning,Midwest,39,True,91,2,0,True,True,True,92,1,0,7.359562014998941,-1,1
user_000804,54,>150k,mobile,returning,South,84,True,98,2,0,False,True,True,79,1,0,9.623245587757967,19,1
user_000805,50,75k-100k,desktop,returning,East,48,True,117,1,0,False,False,True,112,3,0,7.203204107647832,5,-2
user_000806,46,75k-100k,mobile,returning,East,38,True,124,1,0,True,True,True,85,2,0,7.917751956407341,39,-1
user_000807,35,50k-75k,desktop,new,South,46,True,90,2,1,False,False,True,49,1,0,7.886706417721472,41,1
user_000808,38,>150k,desktop,new,East,76,True,93,1,0,False,True,True,91,1,1,6.548846938237438,2,0
user_000809,21,30k-50k,mobile,new,South,62,True,113,4,0,False,False,False,0,0,0,,113,4
user_000810,44,30k-50k,mobile,returning,East,54,True,106,2,0,True,True,True,96,3,0,7.3426303357694875,10,-1
user_000811,49,30k-50k,desktop,returning,Midwest,37,True,39,1,2,False,False,True,77,1,0,5.561183642391293,-38,0
user_000812,37,30k-50k,mobile,new,West,65,True,94,1,1,False,False,True,113,1,0,7.961513855242979,-19,0
user_000813,50,50k-75k,desktop,returning,West,63,False,0,0,0,True,True,True,125,1,0,7.915411921953611,-125,-1
user_000814,61,50k-75k,desktop,returning,East,11,True,119,1,0,True,True,True,67,1,0,7.391643255565137,52,0
user_000815,48,100k-150k,tablet,returning,East,48,True,51,3,0,False,True,True,28,1,0,9.320059929971626,23,2
user_000816,46,30k-50k,mobile,returning,South,35,True,68,7,0,True,False,False,0,0,0,,68,7
user_000817,32,<30k,mobile,returning,East,43,True,110,4,0,False,False,True,110,4,0,7.030746756328036,0,0
user_000818,56,<30k,mobile,returning,South,0,True,79,3,1,False,False,True,63,4,0,5.948818247795876,16,-1
user_000819,45,100k-150k,mobile,returning,South,68,True,121,3,0,True,True,True,115,3,0,7.229769115542299,6,0
user_000820,49,<30k,mobile,returning,Midwest,7,True,123,1,2,False,False,True,137,3,0,7.570116226138411,-14,-2
user_000821,44,50k-75k,mobile,new,South,62,True,126,3,0,False,True,True,95,2,0,6.888394624111942,31,1
user_000822,49,75k-100k,mobile,returning,Midwest,45,True,46,1,1,False,False,True,38,1,0,6.383253460525218,8,0
user_000823,21,75k-100k,mobile,returning,West,62,True,113,2,0,False,True,True,105,2,0,8.33951404010834,8,0
user_000824,18,50k-75k,desktop,returning,South,78,True,71,1,0,False,True,True,36,1,0,8.398537844960718,35,0
user_000825,47,100k-150k,mobile,new,East,97,True,124,2,0,False,True,True,123,1,0,8.070380301972435,1,1
user_000826,48,50k-75k,tablet,returning,South,28,True,99,2,0,True,True,True,103,1,0,6.3274885568997625,-4,1
user_000827,43,100k-150k,desktop,returning,East,51,True,94,3,0,True,True,True,73,4,0,7.855983996045784,21,-1
user_000828,56,50k-75k,desktop,new,South,25,True,162,9,0,False,False,True,179,3,0,8.019496973488708,-17,6
user_000829,28,>150k,mobile,new,East,98,False,0,0,0,False,True,True,83,1,0,9.364561134985697,-83,-1
user_000830,24,75k-100k,mobile,new,East,53,True,114,3,0,True,True,True,119,7,0,5.602422318549158,-5,-4
user_000831,43,50k-75k,mobile,new,East,55,True,145,1,0,False,False,True,148,4,0,7.277886618711343,-3,-3
user_000832,62,50k-75k,desktop,returning,West,59,False,0,0,0,False,False,True,92,1,0,6.199539265765523,-92,-1
user_000833,67,75k-100k,mobile,returning,West,54,True,78,1,0,False,False,True,75,1,0,7.43502077232894,3,0
user_000834,22,30k-50k,desktop,new,South,61,True,87,3,0,False,False,True,81,4,0,5.623103773306019,6,-1
user_000835,63,<30k,tablet,new,West,12,False,0,0,0,False,False,False,0,0,0,,0,0
user_000836,38,50k-75k,mobile,new,West,39,True,120,3,0,False,True,True,101,5,0,8.01454546771054,19,-2
user_000837,35,75k-100k,mobile,returning,East,60,True,111,3,1,False,True,True,88,3,0,6.994222826812193,23,0
user_000838,52,<30k,mobile,new,East,45,True,63,5,1,False,False,False,0,0,0,,63,5
user_000839,47,100k-150k,mobile,returning,East,59,True,78,2,0,True,False,False,0,0,0,,78,2
user_000840,33,<30k,mobile,new,Midwest,70,True,61,3,1,True,True,True,57,4,0,6.665512032965795,4,-1
user_000841,55,100k-150k,mobile,returning,Midwest,42,True,125,2,0,True,True,True,122,3,0,5.729827355950159,3,-1
user_000842,20,75k-100k,desktop,new,South,72,True,120,2,0,True,True,False,0,0,0,,120,2
user_000843,74,50k-75k,mobile,returning,South,45,False,0,0,0,False,True,True,127,1,0,8.271475457138619,-127,-1
user_000844,30,50k-75k,mobile,new,East,61,True,148,7,1,True,True,True,150,5,0,7.680494134550485,-2,2
user_000845,51,50k-75k,mobile,new,East,60,True,142,5,0,False,False,True,136,6,0,7.975247240824115,6,-1
user_000846,49,<30k,desktop,returning,South,22,True,165,3,1,False,False,True,188,4,0,7.181690351181475,-23,-1
user_000847,37,100k-150k,desktop,returning,East,65,False,0,0,0,False,False,True,125,2,0,7.605073167991745,-125,-2
user_000848,28,75k-100k,mobile,returning,East,72,True,80,2,0,False,True,True,80,1,0,8.122744190779967,0,1
user_000849,18,75k-100k,desktop,new,West,100,True,76,1,0,False,True,False,0,0,0,,76,1
user_000850,34,<30k,desktop,returning,South,57,False,0,0,0,False,True,True,101,1,1,7.308572351472564,-101,-1
user_000851,34,<30k,mobile,new,West,48,False,0,0,0,False,False,False,0,0,0,,0,0
user_000852,49,100k-150k,desktop,returning,Midwest,52,True,92,6,0,True,True,True,43,2,0,7.1681470069606,49,4
user_000853,31,30k-50k,desktop,new,South,50,True,114,5,0,False,False,True,96,2,0,7.5707351991003815,18,3
user_000854,52,100k-150k,mobile,returning,Midwest,76,True,48,4,0,True,True,True,82,2,0,9.397934315033973,-34,2
user_000855,43,75k-100k,mobile,returning,South,57,True,65,5,0,False,True,True,57,5,0,7.90671121660244,8,0
user_000856,34,<30k,mobile,returning,Midwest,54,True,125,6,0,False,False,False,0,0,0,,125,6
user_000857,48,50k-75k,desktop,returning,Midwest,15,True,138,7,0,False,False,True,112,10,0,6.37248318465612,26,-3
user_000858,65,<30k,tablet,returning,East,8,False,0,0,0,True,False,False,0,0,0,,0,0
user_000859,50,75k-100k,desktop,new,East,37,True,91,3,0,False,True,True,70,7,0,9.259681227427091,21,-4
user_000860,18,<30k,desktop,returning,South,21,True,57,4,0,False,False,True,93,4,0,8.282540595973842,-36,0
user_000861,62,<30k,desktop,returning,West,30,True,122,2,0,True,False,True,102,3,0,6.248299090148074,20,-1
user_000862,53,100k-150k,mobile,returning,West,85,True,51,3,0,False,False,True,72,4,0,5.068582374877498,-21,-1
user_000863,31,<30k,desktop,returning,East,61,True,32,2,0,True,True,True,41,1,0,8.007908784746622,-9,1
user_000864,62,75k-100k,desktop,new,West,49,False,0,0,0,False,False,True,131,2,0,6.5111731872604,-131,-2
user_000865,27,<30k,mobile,returning,South,35,True,68,4,0,True,True,True,74,1,1,9.313787542915735,-6,3
user_000866,62,50k-75k,mobile,new,Midwest,57,True,76,1,0,False,True,True,29,1,0,8.569465714829555,47,0
user_000867,57,75k-100k,desktop,new,East,41,True,106,3,0,False,True,True,94,2,0,8.126917308344552,12,1
user_000868,49,>150k,desktop,new,West,94,True,122,2,0,True,True,True,118,1,0,9.44218646366194,4,1
user_000869,38,75k-100k,desktop,returning,South,56,True,78,1,1,True,False,True,76,1,2,5.180524565116932,2,0
user_000870,27,75k-100k,mobile,returning,West,84,False,0,0,0,True,True,True,65,2,0,8.07784276029157,-65,-2
user_000871,51,75k-100k,mobile,new,East,41,True,145,5,0,False,True,True,105,1,1,8.654102907693453,40,4
user_000872,36,50k-75k,desktop,new,Midwest,38,False,0,0,0,False,False,True,104,2,0,8.421127781546252,-104,-2
user_000873,18,75k-100k,desktop,returning,East,52,True,82,3,0,False,True,True,75,1,0,9.303397595226864,7,2
user_000874,21,>150k,mobile,new,East,91,False,0,0,0,False,True,True,84,1,0,6.204330895742078,-84,-1
user_000875,55,100k-150k,mobile,returning,West,78,True,33,6,0,False,False,True,20,5,0,7.081640975085232,13,1
user_000876,27,30k-50k,tablet,returning,South,80,False,0,0,0,False,False,True,135,3,0,8.344335940892215,-135,-3
user_000877,42,30k-50k,mobile,new,West,46,True,160,6,0,False,True,True,112,4,0,7.709192401689096,48,2
user_000878,37,75k-100k,mobile,new,Midwest,61,True,96,4,1,True,True,True,94,5,0,8.318488152564935,2,-1
user_000879,24,75k-100k,desktop,returning,Midwest,76,True,30,3,1,False,True,True,20,2,0,7.9097278838522715,10,1
user_000880,52,<30k,desktop,returning,Midwest,21,True,185,3,0,True,False,True,187,5,0,6.065679504632062,-2,-2
user_000881,56,75k-100k,tablet,returning,Midwest,20,True,113,3,0,False,False,True,49,3,0,6.24627229532307,64,0
user_000882,29,<30k,desktop,returning,East,89,False,0,0,0,False,True,True,102,1,0,7.789363915126277,-102,-1
user_000883,50,50k-75k,mobile,returning,South,53,True,59,3,0,True,True,True,63,5,0,9.061466006076454,-4,-2
user_000884,65,30k-50k,mobile,new,South,42,True,169,1,0,False,False,True,177,1,0,8.231006127208532,-8,0
user_000885,29,30k-50k,desktop,new,East,75,False,0,0,0,False,True,True,99,1,0,9.296662845777114,-99,-1
user_000886,31,100k-150k,mobile,returning,East,88,True,68,2,0,True,True,True,20,1,0,8.934558036992922,48,1
user_000887,57,<30k,desktop,new,South,1,True,188,1,0,False,False,True,193,1,0,5.521246278819823,-5,0
user_000888,36,>150k,desktop,returning,South,55,False,0,0,0,True,False,True,119,1,0,8.133595494586087,-119,-1
user_000889,27,30k-50k,desktop,returning,West,100,False,0,0,0,True,True,True,113,2,0,8.693329027910496,-113,-2
user_000890,48,30k-50k,tablet,returning,East,35,True,122,2,0,True,True,True,87,2,0,8.822178310751964,35,0
user_000891,60,100k-150k,desktop,returning,East,63,True,101,4,0,False,False,True,86,1,1,8.198067148857021,15,3
user_000892,53,30k-50k,mobile,returning,West,27,True,95,4,0,True,True,True,77,6,0,5.657044096048032,18,-2
user_000893,51,>150k,desktop,returning,East,84,True,30,2,0,True,True,True,20,2,0,7.17633131805717,10,0
user_000894,28,100k-150k,mobile,returning,Midwest,76,True,76,5,0,True,True,True,55,5,0,8.143270150514295,21,0
user_000895,55,<30k,mobile,returning,West,37,True,85,7,1,True,True,True,68,7,0,8.462435922325149,17,0
user_000896,66,30k-50k,desktop,new,South,22,True,103,3,0,False,False,True,91,2,0,6.5267512243636965,12,1
user_000897,62,<30k,mobile,new,Midwest,0,False,0,0,0,False,False,True,115,1,0,6.118884937840555,-115,-1
user_000898,31,<30k,mobile,returning,East,71,True,30,3,1,True,True,True,20,2,1,5.064252212443281,10,1
user_000899,61,100k-150k,desktop,new,West,66,True,132,2,0,True,True,True,104,1,0,6.434454651468952,28,1
user_000900,34,50k-75k,mobile,returning,Midwest,21,True,111,1,0,False,True,True,88,1,0,10.0,23,0
user_000901,18,30k-50k,desktop,returning,South,22,True,124,5,0,False,False,True,128,4,0,7.540480043772365,-4,1
user_000902,54,50k-75k,desktop,returning,East,74,False,0,0,0,True,True,True,130,1,0,9.456145610278767,-130,-1
user_000903,41,50k-75k,mobile,returning,West,69,True,65,2,0,True,True,True,62,1,1,5.769129076374945,3,1
user_000904,40,>150k,desktop,returning,East,50,True,87,1,0,False,True,True,86,1,0,7.268931823683725,1,0
user_000905,36,<30k,desktop,returning,South,27,True,77,4,0,False,False,False,0,0,0,,77,4
user_000906,32,50k-75k,desktop,returning,East,70,True,99,3,0,True,True,False,0,0,0,,99,3
user_000907,52,>150k,desktop,new,Midwest,44,True,153,2,0,False,True,True,133,3,0,9.469825713635036,20,-1
user_000908,57,30k-50k,desktop,returning,Midwest,33,False,0,0,0,False,False,True,135,2,0,7.3770650319259525,-135,-2
user_000909,67,<30k,mobile,new,South,9,False,0,0,0,False,False,False,0,0,0,,0,0
user_000910,23,75k-100k,mobile,new,East,62,False,0,0,0,False,True,True,96,1,0,8.319816814159067,-96,-1
user_000911,59,<30k,desktop,returning,East,32,False,0,0,0,True,True,True,129,1,0,7.109278771049269,-129,-1
user_000912,46,<30k,mobile,returning,Midwest,27,True,160,5,0,False,False,True,184,7,0,9.635465746105359,-24,-2
user_000913,53,30k-50k,mobile,returning,South,43,False,0,0,0,False,True,True,100,1,0,8.084237349829404,-100,-1
user_000914,35,50k-75k,desktop,returning,South,53,True,57,1,0,True,True,True,34,1,0,7.383757633541707,23,0
user_000915,80,100k-150k,desktop,new,South,62,False,0,0,0,False,True,True,106,1,0,7.512329134876953,-106,-1
user_000916,55,75k-100k,mobile,returning,West,61,True,45,5,0,True,True,True,61,9,0,7.8174916886990085,-16,-4
user_000917,43,75k-100k,desktop,new,East,2,True,224,2,0,True,False,True,220,1,0,8.467947837024576,4,1
user_000918,27,<30k,desktop,returning,South,54,True,133,1,0,False,False,False,0,0,0,,133,1
user_000919,33,75k-100k,mobile,returning,Midwest,65,True,101,2,0,True,True,True,113,4,0,8.666250850501422,-12,-2
user_000920,45,75k-100k,mobile,returning,South,51,True,80,2,0,False,True,True,75,3,0,7.807455364263486,5,-1
user_000921,31,50k-75k,desktop,new,East,71,True,110,3,0,True,True,True,70,3,1,8.388682241118852,40,0
user_000922,41,50k-75k,desktop,returning,West,53,True,35,4,0,False,True,True,20,2,1,8.558326515052581,15,2
user_000923,22,100k-150k,mobile,returning,West,100,True,53,3,0,True,True,True,53,3,0,9.680607890678655,0,0
user_000924,55,75k-100k,mobile,returning,West,65,True,113,6,0,True,True,True,121,6,0,8.570736160950265,-8,0
user_000925,27,<30k,desktop,returning,West,66,True,63,1,0,True,True,True,22,1,0,7.907356399529757,41,0
user_000926,54,75k-100k,desktop,new,East,50,True,72,1,0,False,True,True,77,1,0,9.782186676450994,-5,0
user_000927,28,50k-75k,mobile,returning,East,22,True,136,6,0,False,True,True,108,4,0,5.5038758606322,28,2
user_000928,80,100k-150k,desktop,returning,East,45,True,93,2,0,True,True,False,0,0,0,,93,2
user_000929,41,30k-50k,desktop,returning,East,44,True,67,4,0,False,True,True,58,7,0,9.45605495911893,9,-3
user_000930,52,100k-150k,mobile,new,East,35,True,119,3,0,True,True,True,125,2,1,8.78686066528592,-6,1
user_000931,24,50k-75k,mobile,returning,South,54,True,64,3,0,True,False,False,0,0,0,,64,3
user_000932,66,30k-50k,desktop,returning,West,38,True,117,2,0,False,False,True,118,2,0,9.175861704747652,-1,0
user_000933,49,30k-50k,desktop,new,Midwest,41,True,91,2,0,False,False,True,56,3,1,7.9903036135879635,35,-1
user_000934,42,50k-75k,desktop,new,South,42,True,122,4,0,True,True,False,0,0,0,,122,4
user_000935,44,50k-75k,mobile,new,South,48,True,147,3,0,False,True,True,98,6,0,9.329591968746282,49,-3
user_000936,58,100k-150k,desktop,new,Midwest,27,True,135,1,0,False,False,True,141,1,0,7.095036392366345,-6,0
user_000937,53,<30k,mobile,new,South,44,False,0,0,0,False,True,True,73,1,0,7.10459311199384,-73,-1
user_000938,65,50k-75k,mobile,new,East,25,True,136,6,2,False,False,True,146,7,0,7.91580555717695,-10,-1
user_000939,55,50k-75k,mobile,new,West,57,True,104,4,0,False,True,True,84,5,0,9.516101047955361,20,-1
user_000940,36,75k-100k,desktop,returning,East,57,True,134,6,0,True,True,True,67,4,0,8.565879352705048,67,2
user_000941,62,50k-75k,desktop,returning,South,65,True,118,4,1,False,False,True,98,4,0,4.984120910213545,20,0
user_000942,58,<30k,mobile,new,West,49,True,123,2,1,True,False,True,106,3,0,6.991984829703074,17,-1
user_000943,34,<30k,desktop,new,East,39,True,138,3,0,False,False,True,128,1,0,5.62161767562552,10,2
user_000944,47,30k-50k,desktop,returning,South,37,True,100,2,0,True,False,True,84,5,0,6.643712584594652,16,-3
user_000945,26,<30k,desktop,returning,East,63,True,70,5,0,True,True,True,44,4,0,7.230912314699011,26,1
user_000946,34,30k-50k,mobile,returning,West,94,True,30,1,0,True,True,False,0,0,0,,30,1
user_000947,32,<30k,mobile,returning,Midwest,62,False,0,0,0,True,True,True,89,1,0,9.08643574552983,-89,-1
user_000948,33,30k-50k,desktop,new,West,100,True,118,1,0,False,True,True,79,1,0,10.0,39,0
user_000949,32,100k-150k,desktop,new,South,61,True,139,2,0,True,True,True,124,1,0,6.211728102559613,15,1
user_000950,19,50k-75k,mobile,returning,West,63,True,67,2,0,True,True,True,38,2,0,7.6316848635241055,29,0
user_000951,29,75k-100k,desktop,new,East,64,True,104,6,0,True,False,True,107,10,0,7.302479810791489,-3,-4
user_000952,49,75k-100k,desktop,new,East,37,True,107,3,0,False,True,True,98,1,0,5.540673810021712,9,2
user_000953,57,<30k,tablet,returning,East,27,False,0,0,0,False,False,False,0,0,0,,0,0
user_000954,65,50k-75k,mobile,returning,South,49,True,131,3,0,True,True,True,142,1,0,7.159918195976748,-11,2
user_000955,69,100k-150k,desktop,returning,West,64,True,77,1,0,True,True,True,20,1,0,7.8967052439838765,57,0
user_000956,38,75k-100k,desktop,new,South,48,True,145,3,0,False,True,True,105,1,1,8.968706513522442,40,2
user_000957,61,50k-75k,mobile,new,West,12,True,187,2,0,False,False,True,232,2,0,6.512750405057166,-45,0
user_000958,45,75k-100k,desktop,returning,West,78,True,52,6,0,True,True,True,31,3,0,10.0,21,3
user_000959,53,>150k,mobile,new,Midwest,56,True,182,5,0,True,True,True,143,1,0,9.685856096813758,39,4
user_000960,33,<30k,desktop,returning,Midwest,34,True,53,2,0,True,True,True,33,1,0,9.710688689799479,20,1
user_000961,56,100k-150k,mobile,returning,Midwest,59,True,122,2,0,True,True,True,94,1,0,7.573722767773668,28,1
user_000962,44,30k-50k,desktop,returning,East,57,True,122,3,1,True,True,True,105,3,0,10.0,17,0
user_000963,35,<30k,mobile,returning,East,36,True,129,3,0,True,False,True,111,1,0,6.217599915359843,18,2
user_000964,67,75k-100k,mobile,returning,East,33,True,106,6,2,True,False,True,111,9,0,7.49472669722897,-5,-3
user_000965,65,50k-75k,mobile,returning,East,36,True,94,3,0,True,True,True,82,3,0,6.015234105544277,12,0
user_000966,49,50k-75k,desktop,returning,East,47,False,0,0,0,False,True,True,92,2,0,9.831325186075539,-92,-2
user_000967,47,75k-100k,desktop,returning,West,95,True,69,1,0,False,True,True,72,1,0,10.0,-3,0
user_000968,43,50k-75k,mobile,new,West,68,True,134,1,0,False,True,True,99,1,0,7.5955659124488974,35,0
user_000969,55,50k-75k,mobile,new,Midwest,91,True,104,3,0,True,True,True,83,1,0,7.976845728958048,21,2
user_000970,18,30k-50k,desktop,new,West,75,True,141,4,0,True,True,True,82,3,0,9.500657990841846,59,1
user_000971,33,30k-50k,desktop,returning,South,62,True,68,4,1,False,False,True,82,5,0,8.253636602041771,-14,-1
user_000972,45,30k-50k,tablet,returning,Midwest,41,True,53,3,0,False,True,True,20,4,0,7.593024036882936,33,-1
user_000973,18,<30k,desktop,returning,South,85,False,0,0,0,False,True,False,0,0,0,,0,0
user_000974,42,100k-150k,desktop,new,East,41,True,135,1,0,False,True,True,81,1,0,7.449610392768179,54,0
user_000975,64,50k-75k,desktop,returning,West,45,False,0,0,0,True,True,True,111,1,0,6.137136669814034,-111,-1
user_000976,55,75k-100k,mobile,returning,South,53,True,108,5,0,False,False,True,110,5,1,7.381129625043291,-2,0
user_000977,77,>150k,desktop,returning,East,39,True,78,4,1,False,False,True,90,6,0,7.598856585380349,-12,-2
user_000978,42,50k-75k,desktop,new,Midwest,32,False,0,0,0,False,True,True,125,1,0,7.281053128753351,-125,-1
user_000979,18,75k-100k,desktop,returning,East,69,True,123,1,0,True,True,True,116,1,0,7.976996803404932,7,0
user_000980,50,50k-75k,desktop,returning,South,40,True,30,5,0,True,True,True,36,2,0,7.596043235061317,-6,3
user_000981,55,<30k,desktop,new,East,40,False,0,0,0,True,True,True,132,2,0,8.214304647744516,-132,-2
user_000982,39,<30k,mobile,returning,East,19,True,117,6,0,False,True,True,111,6,0,8.19449461950276,6,0
user_000983,44,50k-75k,desktop,returning,East,54,True,92,2,0,False,True,True,99,1,0,5.960024232050785,-7,1
user_000984,54,<30k,mobile,returning,West,26,False,0,0,0,True,False,True,118,2,0,9.341018358376498,-118,-2
user_000985,50,75k-100k,desktop,returning,East,72,True,110,2,0,False,True,True,123,1,0,8.676628694928944,-13,1
user_000986,59,50k-75k,mobile,new,East,69,True,125,3,1,True,False,True,105,5,0,8.791306424358428,20,-2
user_000987,18,>150k,desktop,new,Midwest,69,True,75,3,0,True,True,True,31,3,0,6.016450600311578,44,0
user_000988,43,100k-150k,mobile,returning,East,59,True,65,3,0,False,True,True,35,2,0,7.985590116035793,30,1
user_000989,33,30k-50k,desktop,returning,East,71,True,40,3,0,True,True,True,38,3,0,7.5659575103245835,2,0
user_000990,48,100k-150k,desktop,returning,South,61,False,0,0,0,False,True,True,112,1,0,7.856930140177404,-112,-1
user_000991,28,75k-100k,desktop,returning,West,81,True,48,3,1,True,True,True,45,1,0,8.028163493882472,3,2
user_000992,44,50k-75k,desktop,returning,West,38,True,87,6,0,False,False,True,141,4,0,4.007284669783194,-54,2
user_000993,21,>150k,mobile,returning,Midwest,92,True,81,2,0,True,True,True,62,3,2,8.414795675231938,19,-1
user_000994,41,50k-75k,mobile,returning,West,58,True,74,4,0,True,True,True,52,4,0,7.710555555829204,22,0
user_000995,40,30k-50k,desktop,new,West,59,False,0,0,0,False,True,True,80,1,0,6.358198483170839,-80,-1
user_000996,51,<30k,desktop,returning,South,47,True,61,3,1,True,False,True,87,2,0,7.572603066044251,-26,1
user_000997,21,<30k,desktop,returning,South,55,True,48,2,0,True,True,True,26,3,0,7.788826002251875,22,-1
user_000998,34,100k-150k,desktop,returning,West,85,True,81,4,0,False,True,True,39,4,0,8.156180380058968,42,0
user_000999,60,75k-100k,mobile,new,South,23,True,192,5,0,True,True,True,149,5,0,6.513358060911393,43,0
user_001000,43,50k-75k,desktop,returning,West,56,True,63,5,0,True,True,True,20,7,0,8.11110730311312,43,-2
user_001001,52,75k-100k,desktop,returning,Midwest,37,True,39,6,0,True,True,True,43,3,0,8.399078427403571,-4,3
user_001002,47,>150k,mobile,returning,West,100,True,51,2,0,True,True,True,91,2,0,10.0,-40,0
user_001003,43,<30k,mobile,new,East,40,True,95,8,0,False,True,True,65,4,0,9.965456780059231,30,4
user_001004,33,75k-100k,desktop,returning,West,63,True,57,1,1,True,False,True,87,1,0,6.377824064184652,-30,0
user_001005,53,30k-50k,desktop,new,East,77,False,0,0,0,True,True,True,118,1,1,7.589262684710905,-118,-1
user_001006,48,50k-75k,mobile,returning,West,53,True,92,1,0,True,True,True,68,1,0,8.308595533004194,24,0
user_001007,39,100k-150k,mobile,returning,Midwest,63,True,100,2,0,True,True,True,86,2,0,10.0,14,0
user_001008,53,75k-100k,mobile,returning,West,51,True,128,3,0,False,True,True,127,3,0,8.385207919205936,1,0
user_001009,32,50k-75k,mobile,returning,South,78,True,74,3,0,True,True,False,0,0,0,,74,3
user_001010,80,<30k,mobile,returning,Midwest,32,True,69,2,0,False,False,False,0,0,0,,69,2
user_001011,46,50k-75k,desktop,returning,West,43,True,74,1,0,False,True,True,58,1,0,8.968353267372182,16,0
user_001012,49,100k-150k,mobile,returning,South,52,True,73,5,0,False,False,True,87,3,0,7.184035207428455,-14,2
user_001013,41,30k-50k,mobile,returning,Midwest,31,True,109,5,0,True,False,True,110,3,0,8.748841530644826,-1,2
user_001014,54,50k-75k,desktop,returning,West,74,True,86,2,0,True,True,True,61,2,0,8.991811943307297,25,0
user_001015,49,50k-75k,desktop,returning,West,91,True,53,1,0,False,False,True,55,2,1,7.567492494747381,-2,-1
user_001016,43,75k-100k,mobile,returning,Midwest,32,True,95,3,0,True,True,True,99,2,0,6.408483155028069,-4,1
user_001017,36,75k-100k,desktop,returning,South,21,True,172,2,0,True,False,True,178,4,0,7.567012373297013,-6,-2
user_001018,30,100k-150k,desktop,returning,South,71,True,55,5,0,True,True,True,47,8,0,8.973273650570759,8,-3
user_001019,38,30k-50k,mobile,new,East,38,True,138,7,0,False,True,True,108,3,0,8.223849282663737,30,4
user_001020,49,50k-75k,mobile,new,Midwest,51,False,0,0,0,False,False,True,138,1,0,5.683728066476539,-138,-1
user_001021,61,30k-50k,desktop,new,West,36,True,124,6,0,False,False,True,128,4,0,6.894385716877136,-4,2
user_001022,24,30k-50k,mobile,new,South,75,True,86,4,0,False,True,True,79,1,1,8.648405162289965,7,3
user_001023,38,50k-75k,desktop,returning,West,71,True,95,4,0,True,False,True,65,2,0,6.6399273793445746,30,2
user_001024,33,75k-100k,mobile,returning,East,71,False,0,0,0,True,True,True,86,1,0,8.091030592162086,-86,-1
user_001025,69,75k-100k,mobile,returning,South,36,True,120,3,4,False,False,True,111,1,0,6.1511299238081465,9,2
user_001026,68,75k-100k,mobile,returning,East,41,True,89,2,1,False,False,True,66,1,1,9.89423133288957,23,1
user_001027,46,50k-75k,mobile,returning,South,56,True,53,1,0,False,False,True,62,1,0,5.66178940661088,-9,0
user_001028,57,75k-100k,desktop,new,West,53,True,79,1,0,False,False,True,107,1,0,7.623709892796415,-28,0
user_001029,33,100k-150k,mobile,new,East,70,True,82,3,0,True,True,True,45,2,0,7.2102656417109445,37,1
user_001030,32,75k-100k,mobile,returning,East,72,True,54,2,1,False,True,True,32,1,0,7.321346692549861,22,1
user_001031,22,30k-50k,mobile,returning,South,61,True,46,1,0,True,False,False,0,0,0,,46,1
user_001032,61,100k-150k,mobile,new,Midwest,48,True,163,2,0,True,True,True,153,3,0,7.704851538359121,10,-1
user_001033,52,50k-75k,tablet,returning,West,33,True,73,4,0,False,False,True,34,1,0,8.060692152820854,39,3
user_001034,48,30k-50k,mobile,new,East,67,True,46,6,1,False,True,True,42,3,0,7.886494848110823,4,3
user_001035,37,>150k,mobile,new,West,62,True,144,7,0,False,True,True,141,1,0,8.793995560323616,3,6
user_001036,39,75k-100k,desktop,returning,West,71,True,64,1,0,False,False,True,72,1,0,6.423063842957258,-8,0
user_001037,19,<30k,desktop,returning,West,61,True,76,2,1,True,True,True,76,4,0,8.229437467611529,0,-2
user_001038,40,75k-100k,desktop,returning,West,26,False,0,0,0,False,False,True,117,3,0,4.971135712934248,-117,-3
user_001039,47,50k-75k,mobile,returning,South,62,False,0,0,0,True,True,True,97,1,0,7.076728017291668,-97,-1
user_001040,18,100k-150k,mobile,returning,East,80,True,98,3,0,True,True,True,105,4,0,8.474683376527691,-7,-1
user_001041,42,>150k,mobile,new,East,42,True,128,5,0,False,False,True,158,5,0,6.454518762081359,-30,0
user_001042,26,50k-75k,desktop,returning,East,53,False,0,0,0,False,False,True,135,2,0,8.69213408237964,-135,-2
user_001043,28,75k-100k,mobile,new,South,63,True,150,3,1,False,False,True,177,3,0,8.839664419126546,-27,0
user_001044,80,30k-50k,desktop,returning,Midwest,0,True,128,6,0,True,False,False,0,0,0,,128,6
user_001045,36,>150k,tablet,new,South,50,True,94,3,0,False,True,True,40,2,0,8.072764985881664,54,1
user_001046,57,75k-100k,mobile,returning,West,45,False,0,0,0,False,True,True,125,2,0,8.689948019399903,-125,-2
user_001047,25,100k-150k,mobile,returning,Midwest,47,True,105,2,0,True,True,True,95,1,0,8.07996800260211,10,1
user_001048,46,50k-75k,mobile,new,South,47,False,0,0,0,True,False,True,124,1,0,7.8568953504769565,-124,-1
user_001049,48,<30k,mobile,returning,East,50,False,0,0,0,False,False,False,0,0,0,,0,0
user_001050,18,<30k,desktop,returning,West,74,True,49,5,0,False,True,True,108,4,0,8.799157251604539,-59,1
user_001051,32,50k-75k,mobile,returning,South,65,True,99,4,0,True,True,True,83,6,0,8.827529041126617,16,-2
user_001052,37,75k-100k,mobile,returning,East,42,True,36,2,0,True,True,True,21,2,0,6.868146692956974,15,0
user_001053,39,75k-100k,mobile,returning,West,30,True,161,8,0,True,True,True,143,7,0,6.791386263191737,18,1
user_001054,45,100k-150k,desktop,new,East,47,True,126,3,1,False,True,True,94,3,0,7.872998674939392,32,0
user_001055,59,50k-75k,desktop,returning,East,34,False,0,0,0,False,False,False,0,0,0,,0,0
user_001056,34,100k-150k,mobile,new,East,75,True,105,2,0,False,True,True,104,2,0,8.211155592482484,1,0
user_001057,55,<30k,desktop,new,West,40,False,0,0,0,False,False,True,98,1,0,7.958880053945973,-98,-1
user_001058,35,100k-150k,desktop,returning,South,50,True,44,3,0,True,True,True,25,4,0,8.82239300504192,19,-1
user_001059,24,30k-50k,mobile,returning,South,91,False,0,0,0,True,True,True,145,1,0,7.914216785158753,-145,-1
user_001060,38,100k-150k,mobile,new,Midwest,61,True,120,2,0,True,True,True,50,1,0,7.10195486763441,70,1
user_001061,35,50k-75k,desktop,returning,Midwest,40,True,122,3,0,False,False,True,86,2,0,7.327094368677979,36,1
user_001062,61,50k-75k,mobile,returning,East,23,True,161,2,1,False,True,True,119,4,0,7.182814852979591,42,-2
user_001063,40,50k-75k,mobile,returning,South,46,True,90,2,0,False,True,True,66,2,0,9.76727895742734,24,0
user_001064,42,50k-75k,desktop,new,West,84,True,100,2,0,False,False,True,102,1,0,7.535324028890865,-2,1
user_001065,74,50k-75k,mobile,returning,East,41,False,0,0,0,False,True,False,0,0,0,,0,0
user_001066,47,75k-100k,tablet,returning,East,56,True,44,1,0,False,True,True,27,1,0,6.889199428055249,17,0
user_001067,39,30k-50k,mobile,returning,East,81,True,69,4,1,True,True,True,47,7,0,8.561614901023308,22,-3
user_001068,18,30k-50k,desktop,new,East,93,True,88,3,0,True,True,True,118,3,0,5.474418454887362,-30,0
user_001069,47,75k-100k,desktop,returning,West,39,True,144,1,0,True,True,True,115,1,0,7.366162113730884,29,0
user_001070,29,100k-150k,desktop,returning,East,47,True,124,1,0,False,True,True,136,1,0,8.173887121207722,-12,0
user_001071,41,30k-50k,mobile,returning,West,57,True,106,3,0,True,False,False,0,0,0,,106,3
user_001072,62,100k-150k,desktop,returning,South,22,False,0,0,0,False,False,True,103,1,0,8.221913155258463,-103,-1
user_001073,26,<30k,mobile,returning,South,32,False,0,0,0,False,True,True,114,1,0,5.847789120372854,-114,-1
user_001074,56,50k-75k,mobile,new,West,35,True,150,6,1,False,True,True,132,6,0,7.584890666149223,18,0
user_001075,42,30k-50k,mobile,returning,South,43,True,85,5,0,True,True,True,20,3,0,6.291809160552383,65,2
user_001076,42,50k-75k,desktop,returning,South,82,True,124,2,1,True,True,True,72,1,0,8.181185866230747,52,1
user_001077,26,<30k,tablet,returning,West,84,False,0,0,0,False,False,False,0,0,0,,0,0
user_001078,39,50k-75k,desktop,returning,South,19,True,135,3,1,False,False,True,139,1,0,6.983365793110268,-4,2
user_001079,30,50k-75k,desktop,returning,East,76,True,108,3,0,True,True,True,87,1,0,8.072839436516594,21,2
user_001080,44,100k-150k,mobile,returning,West,53,True,109,1,0,False,False,True,142,1,1,8.600722246760913,-33,0
user_001081,29,100k-150k,desktop,returning,East,84,True,72,1,0,True,True,True,50,1,0,7.279348630192988,22,0
user_001082,45,100k-150k,mobile,returning,South,70,True,67,4,0,False,True,True,46,3,0,10.0,21,1
user_001083,44,75k-100k,desktop,new,Midwest,37,True,131,4,0,True,False,True,110,6,0,5.562317623236252,21,-2
user_001084,34,30k-50k,mobile,returning,East,72,True,71,2,0,True,True,False,0,0,0,,71,2
user_001085,69,50k-75k,mobile,returning,Midwest,35,False,0,0,0,False,True,True,118,1,0,5.528235232854946,-118,-1
user_001086,62,30k-50k,desktop,returning,East,58,False,0,0,0,False,True,True,73,1,1,8.568790553118633,-73,-1
user_001087,33,30k-50k,mobile,new,South,70,True,78,2,0,True,True,True,67,3,0,7.049408351940202,11,-1
user_001088,51,50k-75k,desktop,returning,West,55,True,163,4,0,False,True,True,138,2,0,7.010355309038546,25,2
user_001089,42,<30k,mobile,returning,Midwest,33,True,57,5,0,True,False,True,54,4,0,6.39781382413871,3,1
user_001090,51,<30k,mobile,returning,East,43,True,112,1,1,True,False,True,102,1,0,9.002610906707194,10,0
user_001091,54,50k-75k,mobile,returning,South,71,False,0,0,0,True,True,False,0,0,0,,0,0
user_001092,37,100k-150k,mobile,returning,South,21,True,93,6,0,False,True,True,58,4,0,7.398660579924991,35,2
user_001093,40,<30k,mobile,new,South,8,True,226,2,0,True,True,True,154,3,0,8.263778377928734,72,-1
user_001094,49,75k-100k,mobile,returning,Midwest,59,True,79,3,1,False,True,True,72,2,0,6.840175672167099,7,1
user_001095,33,75k-100k,mobile,returning,West,92,True,109,3,0,False,True,True,98,2,0,9.105964935597207,11,1
user_001096,76,100k-150k,desktop,returning,West,44,True,79,3,0,False,True,True,96,2,0,7.143427667251861,-17,1
user_001097,56,75k-100k,mobile,returning,South,21,True,189,4,0,False,False,True,203,7,0,7.938294314784444,-14,-3
user_001098,35,50k-75k,desktop,new,Midwest,68,True,95,1,0,False,False,True,87,1,0,9.139044519677817,8,0
user_001099,43,75k-100k,desktop,returning,West,76,True,97,4,0,False,False,True,79,3,0,7.684794636213352,18,1
user_001100,65,30k-50k,mobile,returning,South,19,False,0,0,0,True,True,True,83,1,0,9.101749804367964,-83,-1
user_001101,45,<30k,desktop,returning,South,12,True,98,2,0,True,False,False,0,0,0,,98,2
user_001102,19,30k-50k,mobile,returning,South,85,True,83,3,0,False,True,True,65,1,1,6.905993581766668,18,2
user_001103,25,50k-75k,desktop,returning,East,70,True,79,1,0,True,False,True,85,1,1,8.566975102579852,-6,0
user_001104,30,100k-150k,desktop,new,South,74,True,107,1,0,True,True,True,73,1,0,7.786579601447047,34,0
user_001105,36,50k-75k,mobile,returning,West,37,True,82,1,0,False,False,False,0,0,0,,82,1
user_001106,46,50k-75k,desktop,returning,West,33,True,77,6,0,False,False,False,0,0,0,,77,6
user_001107,39,<30k,desktop,returning,Midwest,23,False,0,0,0,False,True,True,84,1,0,8.054821191872406,-84,-1
user_001108,43,100k-150k,tablet,returning,West,84,True,30,1,0,True,True,True,20,1,0,7.3744033050707465,10,0
user_001109,39,<30k,mobile,new,East,8,True,207,8,1,False,False,True,189,8,0,6.324745147320448,18,0
user_001110,46,75k-100k,desktop,returning,East,34,True,37,3,0,True,True,True,20,2,0,8.953232194350043,17,1
user_001111,50,30k-50k,mobile,returning,South,38,True,114,3,0,True,True,True,73,2,0,6.565977983613374,41,1
user_001112,53,100k-150k,desktop,new,South,31,True,139,1,0,False,True,True,164,1,0,7.383047386224865,-25,0
user_001113,33,<30k,mobile,returning,East,50,False,0,0,0,False,True,True,100,1,1,8.005387557480113,-100,-1
user_001114,38,75k-100k,mobile,returning,West,41,True,77,1,0,False,True,True,89,1,0,8.124505079460143,-12,0
user_001115,42,50k-75k,mobile,new,South,45,True,108,1,0,False,False,True,92,2,0,6.1325508980526084,16,-1
user_001116,53,50k-75k,desktop,new,West,81,False,0,0,0,True,False,False,0,0,0,,0,0
user_001117,45,50k-75k,mobile,new,Midwest,23,True,207,4,0,False,False,True,226,1,2,7.365586564726572,-19,3
user_001118,39,50k-75k,mobile,returning,South,48,True,64,1,0,False,False,True,53,3,0,3.565535859001673,11,-2
user_001119,44,<30k,desktop,new,South,16,True,139,6,0,True,True,True,151,7,0,6.232020516771782,-12,-1
user_001120,53,50k-75k,desktop,new,East,45,False,0,0,0,False,False,True,95,1,1,5.203361571945393,-95,-1
user_001121,45,<30k,desktop,returning,East,47,True,63,2,0,True,True,True,34,4,0,8.182298938360578,29,-2
user_001122,46,30k-50k,mobile,new,South,40,True,123,4,0,True,False,True,159,6,0,8.707003710571144,-36,-2
user_001123,73,50k-75k,desktop,new,East,32,False,0,0,0,False,True,True,114,1,0,9.05872765164089,-114,-1
user_001124,49,<30k,mobile,new,Midwest,15,True,81,6,1,True,False,False,0,0,0,,81,6
user_001125,26,30k-50k,desktop,returning,East,59,True,99,6,0,True,True,True,90,5,0,7.071927870965667,9,1
user_001126,42,<30k,mobile,returning,East,48,True,87,3,0,False,False,True,61,7,0,5.889640991656811,26,-4
user_001127,20,75k-100k,desktop,returning,East,32,True,114,7,0,False,True,True,126,10,0,6.2755533171478515,-12,-3
user_001128,80,75k-100k,desktop,new,West,41,True,182,1,0,False,False,True,199,2,0,5.221554335274852,-17,-1
user_001129,49,30k-50k,desktop,returning,South,41,True,94,2,0,True,True,True,99,1,0,7.65834555673321,-5,1
user_001130,18,75k-100k,desktop,returning,South,59,True,121,3,0,True,True,True,96,2,0,7.926399012391472,25,1
user_001131,61,50k-75k,desktop,new,South,51,True,181,4,0,True,False,True,176,2,0,6.533395519814407,5,2
user_001132,18,<30k,desktop,new,West,80,False,0,0,0,False,True,True,102,1,0,10.0,-102,-1
user_001133,45,50k-75k,mobile,returning,West,64,True,114,1,0,True,True,True,100,1,0,8.5835167243476,14,0
user_001134,36,75k-100k,mobile,new,South,19,True,169,2,1,False,True,True,138,1,1,6.210216753550113,31,1
user_001135,41,75k-100k,mobile,returning,East,48,True,99,2,1,False,False,True,108,1,0,8.225666268350432,-9,1
user_001136,47,30k-50k,desktop,returning,West,53,False,0,0,0,True,True,True,98,1,1,7.222958737631558,-98,-1
user_001137,50,50k-75k,mobile,returning,West,42,False,0,0,0,True,True,True,108,1,0,8.47560579399215,-108,-1
user_001138,80,50k-75k,mobile,new,South,15,False,0,0,0,False,False,False,0,0,0,,0,0
user_001139,54,30k-50k,mobile,new,Midwest,30,True,163,3,0,True,True,True,140,2,0,8.964961570299504,23,1
user_001140,40,50k-75k,mobile,returning,East,40,True,96,5,0,True,False,True,127,5,0,7.22705432046965,-31,0
user_001141,36,75k-100k,desktop,new,East,41,True,101,2,0,False,False,True,99,4,0,7.710993034525076,2,-2
user_001142,35,<30k,desktop,new,West,44,True,149,2,1,False,False,True,131,2,1,7.374823496467396,18,0
user_001143,64,75k-100k,mobile,new,Midwest,15,True,170,8,0,False,False,True,175,5,0,7.648248122857234,-5,3
user_001144,18,50k-75k,mobile,returning,West,100,True,42,1,0,True,True,True,34,1,0,7.070589397347641,8,0
user_001145,22,30k-50k,desktop,returning,South,90,False,0,0,0,True,True,True,63,1,0,8.42166773375588,-63,-1
user_001146,41,30k-50k,mobile,returning,East,60,True,56,1,0,True,True,True,51,1,0,6.717170496974724,5,0
user_001147,21,50k-75k,mobile,returning,Midwest,81,True,44,4,0,False,True,True,50,4,0,9.052308989519332,-6,0
user_001148,43,100k-150k,mobile,returning,East,27,True,163,6,1,True,True,True,131,4,0,9.68750713938516,32,2
user_001149,31,75k-100k,mobile,returning,East,64,True,110,1,0,True,True,True,88,1,0,8.476757682159016,22,0
user_001150,52,50k-75k,desktop,returning,Midwest,43,False,0,0,0,False,True,True,92,2,0,7.457619503673745,-92,-2
user_001151,56,50k-75k,desktop,new,East,6,True,143,4,0,True,True,True,119,6,0,6.9461341026938905,24,-2
user_001152,54,100k-150k,mobile,new,South,43,True,114,1,1,True,True,True,106,1,0,7.760423163355389,8,0
user_001153,54,50k-75k,desktop,new,West,61,True,125,1,0,True,True,True,102,1,0,8.252936867543715,23,0
user_001154,62,50k-75k,mobile,returning,South,36,True,67,2,1,True,True,True,53,2,0,6.764843714770499,14,0
user_001155,46,30k-50k,mobile,returning,West,25,True,147,7,0,False,False,True,104,9,0,7.913699651825332,43,-2
user_001156,63,50k-75k,desktop,returning,Midwest,63,True,114,2,0,True,True,True,67,2,1,8.837232957627394,47,0
user_001157,45,75k-100k,mobile,new,West,36,True,109,3,0,False,False,True,100,1,0,6.234121857836311,9,2
user_001158,19,100k-150k,desktop,returning,East,62,True,120,3,0,False,True,True,139,1,0,9.083291784682544,-19,2
user_001159,34,30k-50k,mobile,returning,South,77,True,71,3,1,True,True,True,63,1,0,5.252522076602414,8,2
user_001160,38,100k-150k,desktop,returning,East,95,True,77,1,0,True,True,True,53,1,0,9.119183261077072,24,0
user_001161,65,75k-100k,mobile,new,East,36,True,131,3,1,False,False,True,151,2,1,6.323791977726708,-20,1
user_001162,59,75k-100k,desktop,new,Midwest,30,False,0,0,0,False,False,True,108,2,0,7.53120086687609,-108,-2
user_001163,55,100k-150k,mobile,returning,West,42,False,0,0,0,False,True,True,106,1,0,6.7400044007637865,-106,-1
user_001164,69,<30k,desktop,new,West,44,False,0,0,0,True,True,True,116,1,0,9.423444283652023,-116,-1
user_001165,74,100k-150k,desktop,returning,East,55,True,53,4,0,False,True,True,20,2,0,9.434059711533184,33,2
user_001166,51,50k-75k,desktop,returning,West,54,True,100,2,0,False,False,True,102,1,0,4.535926198338329,-2,1
user_001167,30,75k-100k,desktop,new,South,72,True,112,3,0,False,True,True,79,2,0,8.847839807895262,33,1
user_001168,52,50k-75k,desktop,new,Midwest,27,False,0,0,0,False,False,True,139,1,0,6.792139156169562,-139,-1
user_001169,41,30k-50k,mobile,new,West,72,False,0,0,0,False,True,True,89,2,0,8.807723662207007,-89,-2
user_001170,44,30k-50k,mobile,new,Midwest,51,True,104,1,0,True,True,True,65,1,0,7.506599941487298,39,0
user_001171,77,100k-150k,desktop,new,Midwest,47,False,0,0,0,True,True,True,60,1,0,9.002747413462581,-60,-1
user_001172,80,100k-150k,mobile,returning,South,40,False,0,0,0,False,False,True,105,1,0,4.943990877157861,-105,-1
user_001173,61,30k-50k,tablet,returning,West,22,True,138,4,1,True,True,True,130,5,0,6.777384779437358,8,-1
user_001174,20,<30k,mobile,returning,East,53,False,0,0,0,False,True,True,93,3,0,8.293050313864502,-93,-3
user_001175,57,30k-50k,desktop,returning,West,19,True,121,1,1,True,True,True,116,1,0,6.993471277298381,5,0
user_001176,57,<30k,mobile,new,South,32,True,125,2,0,False,False,False,0,0,0,,125,2
user_001177,46,75k-100k,desktop,returning,Midwest,38,True,72,6,0,False,False,True,71,5,0,5.1578019968487885,1,1
user_001178,65,75k-100k,desktop,returning,East,50,True,53,3,0,True,True,False,0,0,0,,53,3
user_001179,46,100k-150k,mobile,returning,Midwest,75,True,73,4,0,False,True,True,60,3,0,8.17675744411412,13,1
user_001180,45,50k-75k,desktop,returning,South,55,True,99,3,2,False,False,True,102,4,0,7.313010375354245,-3,-1
user_001181,32,75k-100k,desktop,new,South,81,True,91,5,0,True,True,True,64,4,0,8.73140000855919,27,1
user_001182,53,30k-50k,desktop,new,South,22,True,178,4,0,False,True,True,139,1,0,9.093144803664144,39,3
user_001183,25,100k-150k,desktop,returning,Midwest,66,True,156,2,0,False,False,True,164,1,0,9.067147181757559,-8,1
user_001184,68,>150k,desktop,returning,East,54,True,92,3,0,True,True,True,58,1,0,9.253525351939315,34,2
user_001185,40,50k-75k,desktop,new,East,26,True,192,4,0,True,False,True,207,7,0,9.152065262695897,-15,-3
user_001186,48,<30k,tablet,new,South,34,True,55,3,0,False,False,True,54,2,0,7.942829423003516,1,1
user_001187,42,50k-75k,desktop,new,Midwest,31,True,133,7,0,False,False,True,110,4,0,8.900009808868703,23,3
user_001188,48,100k-150k,desktop,returning,West,64,False,0,0,0,False,True,True,131,1,0,7.918459269216327,-131,-1
user_001189,27,100k-150k,mobile,returning,West,100,True,66,1,0,False,True,True,23,1,0,10.0,43,0
user_001190,53,75k-100k,mobile,returning,Midwest,34,True,109,9,0,False,False,True,107,11,0,6.215629607230985,2,-2
user_001191,41,30k-50k,desktop,new,Midwest,29,False,0,0,0,False,False,True,134,1,0,6.963303585323301,-134,-1
user_001192,43,30k-50k,desktop,new,South,47,True,113,4,0,False,True,True,61,3,0,6.738689399771757,52,1
user_001193,62,75k-100k,mobile,returning,Midwest,52,True,64,1,0,True,True,True,37,1,0,7.277854989367262,27,0
user_001194,73,30k-50k,mobile,new,Midwest,30,True,106,6,1,True,False,True,102,4,0,6.848314995146343,4,2
user_001195,61,30k-50k,mobile,new,West,36,True,127,4,0,False,False,False,0,0,0,,127,4
user_001196,44,100k-150k,desktop,returning,West,85,True,30,4,0,False,True,True,22,5,0,7.619559991389643,8,-1
user_001197,22,30k-50k,desktop,new,Midwest,68,True,149,3,0,True,False,True,143,1,0,7.142425599849563,6,2
user_001198,33,50k-75k,desktop,returning,West,66,True,67,4,0,True,True,True,21,4,0,6.929098859289107,46,0
user_001199,55,<30k,mobile,returning,East,46,True,124,5,0,True,True,True,107,4,0,5.948109866775552,17,1
user_001200,42,30k-50k,mobile,new,West,46,True,168,2,0,True,True,True,162,2,0,9.286141682134955,6,0
user_001201,47,30k-50k,desktop,new,South,58,True,123,3,0,False,False,True,132,3,0,8.94167421017054,-9,0
user_001202,62,50k-75k,mobile,returning,Midwest,27,True,94,3,2,False,False,True,97,2,0,4.9188082769370896,-3,1
user_001203,39,100k-150k,mobile,returning,West,55,True,92,4,0,True,False,True,114,9,1,8.890906764673705,-22,-5
user_001204,68,30k-50k,desktop,new,East,48,True,94,4,0,False,True,True,65,1,0,6.859900192030337,29,3
user_001205,44,50k-75k,desktop,returning,East,38,True,92,3,0,False,False,True,113,2,0,6.665048741409669,-21,1
user_001206,61,100k-150k,desktop,returning,East,33,True,95,2,0,False,False,True,92,4,0,5.072598257641696,3,-2
user_001207,23,75k-100k,mobile,returning,East,62,False,0,0,0,True,True,True,114,1,0,9.123080429701155,-114,-1
user_001208,36,<30k,mobile,new,West,33,False,0,0,0,False,True,True,70,1,1,7.80611225936132,-70,-1
user_001209,79,50k-75k,mobile,returning,West,73,True,43,4,0,False,True,True,20,4,0,8.593742105559887,23,0
user_001210,44,75k-100k,mobile,returning,West,50,True,89,8,0,False,True,False,0,0,0,,89,8
user_001211,37,50k-75k,desktop,new,South,25,True,156,7,0,False,False,True,164,7,0,8.457265816039687,-8,0
user_001212,41,30k-50k,mobile,new,East,70,False,0,0,0,False,False,False,0,0,0,,0,0
user_001213,52,50k-75k,desktop,returning,East,45,True,67,2,1,True,False,False,0,0,0,,67,2
user_001214,49,50k-75k,mobile,new,South,39,True,171,7,0,False,False,True,170,4,0,6.877926214949997,1,3
user_001215,35,50k-75k,desktop,returning,East,50,True,134,4,0,True,True,True,126,6,0,10.0,8,-2
user_001216,41,<30k,mobile,returning,West,35,True,106,8,0,False,True,True,85,4,0,9.2426468213305,21,4
user_001217,35,75k-100k,desktop,new,West,67,True,156,4,0,False,True,True,124,5,0,7.031985050111377,32,-1
user_001218,36,100k-150k,desktop,returning,East,59,True,91,3,0,False,False,True,88,4,0,8.738495688532453,3,-1
user_001219,65,50k-75k,desktop,returning,East,14,False,0,0,0,False,False,True,112,1,0,8.465296812179725,-112,-1
user_001220,66,100k-150k,mobile,returning,West,71,True,42,2,0,False,False,True,20,2,0,8.300714816717925,22,0
user_001221,35,100k-150k,mobile,returning,West,77,True,53,2,0,False,True,True,51,1,0,8.140169805033729,2,1
user_001222,39,100k-150k,desktop,returning,South,71,True,120,3,0,True,True,True,92,4,0,7.355967609281965,28,-1
user_001223,58,<30k,desktop,returning,West,32,True,85,3,0,False,True,True,66,2,0,8.869247045784421,19,1
user_001224,26,>150k,desktop,new,South,80,True,123,4,0,True,True,True,130,2,0,9.688408037378736,-7,2
user_001225,36,100k-150k,desktop,returning,Midwest,50,True,78,3,1,False,False,True,37,4,0,6.1290460352329275,41,-1
user_001226,41,75k-100k,mobile,returning,South,67,True,114,4,0,True,True,True,112,2,0,7.94304299041129,2,2
user_001227,31,75k-100k,desktop,returning,West,62,True,41,5,0,False,True,True,53,2,0,9.118892652274031,-12,3
user_001228,59,<30k,mobile,new,East,41,True,104,2,0,False,False,True,97,4,0,8.450752168443062,7,-2
user_001229,32,<30k,desktop,returning,East,72,True,57,7,0,False,True,True,33,12,0,10.0,24,-5
user_001230,26,75k-100k,mobile,returning,East,79,True,36,3,0,False,True,True,50,1,1,9.652162309147611,-14,2
user_001231,59,75k-100k,desktop,returning,Midwest,28,True,163,2,0,True,False,True,170,3,2,6.923364705983211,-7,-1
user_001232,37,50k-75k,desktop,returning,East,28,True,119,4,0,False,True,True,36,2,0,6.855256520098018,83,2
user_001233,64,100k-150k,mobile,returning,South,24,False,0,0,0,True,False,True,140,2,0,5.901687161644442,-140,-2
user_001234,55,30k-50k,mobile,returning,West,53,True,131,4,1,False,True,True,123,5,0,9.313591182940083,8,-1
user_001235,31,30k-50k,tablet,returning,East,68,True,105,3,0,True,True,True,91,2,0,7.0842078792554695,14,1
user_001236,42,75k-100k,mobile,returning,West,57,True,56,3,0,False,True,True,52,4,0,6.240186098304933,4,-1
user_001237,27,>150k,desktop,returning,East,74,True,61,1,1,False,True,True,50,1,0,8.662115795745809,11,0
user_001238,18,50k-75k,desktop,returning,East,66,True,126,3,1,True,True,True,113,3,1,8.732626485207446,13,0
user_001239,58,50k-75k,desktop,returning,East,51,True,65,1,0,False,False,True,86,2,0,7.358927165230925,-21,-1
user_001240,41,100k-150k,mobile,returning,Midwest,25,True,176,2,0,False,False,True,175,3,0,9.06723292439299,1,-1
user_001241,61,30k-50k,mobile,new,West,64,True,78,1,0,False,False,True,75,1,0,7.54297519586302,3,0
user_001242,42,>150k,desktop,new,South,76,True,40,4,0,False,True,True,23,2,0,10.0,17,2
user_001243,75,50k-75k,tablet,returning,South,8,False,0,0,0,True,True,True,79,1,0,7.884817884823743,-79,-1
user_001244,51,100k-150k,tablet,returning,West,94,True,63,1,0,True,False,True,75,1,0,6.345083553221465,-12,0
user_001245,18,30k-50k,desktop,returning,South,64,True,79,1,0,True,True,True,97,1,0,8.018204247891305,-18,0
user_001246,31,>150k,desktop,returning,East,97,True,98,3,1,True,True,True,43,6,0,8.688994770995903,55,-3
user_001247,49,30k-50k,desktop,new,Midwest,32,False,0,0,0,True,True,True,102,1,0,8.663574604575066,-102,-1
user_001248,39,30k-50k,mobile,new,South,52,False,0,0,0,False,False,False,0,0,0,,0,0
user_001249,38,75k-100k,desktop,returning,East,52,True,94,2,1,False,True,True,78,1,0,7.629077801243755,16,1
user_001250,50,50k-75k,tablet,returning,East,39,True,65,1,0,True,True,True,37,1,1,7.160020512809479,28,0
user_001251,52,75k-100k,mobile,returning,West,56,True,107,2,0,False,True,True,40,2,0,5.400804119286092,67,0
user_001252,36,30k-50k,mobile,returning,South,52,True,103,2,1,False,True,True,67,4,0,5.802782711831977,36,-2
user_001253,35,75k-100k,mobile,returning,South,5,True,133,6,0,False,True,True,133,3,0,7.030796879733885,0,3
user_001254,24,50k-75k,mobile,new,Midwest,60,False,0,0,0,False,False,True,107,1,0,6.121102877210736,-107,-1
user_001255,24,100k-150k,desktop,returning,East,98,True,91,2,0,True,True,True,68,1,0,5.239356525293169,23,1
user_001256,33,30k-50k,desktop,new,West,73,True,125,2,0,True,True,True,92,2,0,6.190042294283809,33,0
user_001257,40,30k-50k,desktop,returning,East,64,True,119,3,1,True,True,True,85,1,0,6.824307280197978,34,2
user_001258,27,30k-50k,mobile,returning,East,84,True,71,4,0,True,True,True,57,1,0,10.0,14,3
user_001259,42,50k-75k,mobile,new,East,58,False,0,0,0,True,True,True,58,1,0,6.986289022860853,-58,-1
user_001260,32,75k-100k,mobile,new,West,72,True,68,4,1,True,True,True,68,3,0,6.988384809030988,0,1
user_001261,46,30k-50k,desktop,new,Midwest,9,True,151,4,0,False,False,True,123,4,0,7.551178869573279,28,0
user_001262,41,50k-75k,mobile,new,Midwest,49,True,147,5,0,False,True,True,88,1,0,7.501695730589788,59,4
user_001263,31,<30k,desktop,new,Midwest,50,True,162,5,1,True,True,True,100,2,0,6.827329131976066,62,3
user_001264,51,50k-75k,desktop,new,East,69,False,0,0,0,True,False,True,118,1,1,7.721360302478515,-118,-1
user_001265,29,<30k,desktop,returning,South,60,False,0,0,0,False,True,True,103,1,0,7.369779972074647,-103,-1
user_001266,63,75k-100k,desktop,new,East,16,True,172,1,2,False,False,True,185,1,0,7.659942915659369,-13,0
user_001267,60,30k-50k,desktop,returning,South,26,True,146,2,0,False,False,True,136,1,1,7.271344373919517,10,1
user_001268,26,30k-50k,tablet,returning,South,86,True,37,1,0,False,True,True,30,1,0,7.277896994512851,7,0
user_001269,47,75k-100k,desktop,new,West,49,True,121,1,0,True,False,True,157,1,0,6.231593046814594,-36,0
user_001270,39,50k-75k,desktop,returning,East,48,True,97,3,0,False,False,True,67,2,0,4.945377658610078,30,1
user_001271,61,30k-50k,tablet,returning,East,39,True,95,5,0,False,True,True,109,4,1,7.185960544169538,-14,1
user_001272,53,50k-75k,mobile,new,East,56,True,148,1,0,False,True,True,111,1,0,9.073502639202411,37,0
user_001273,34,75k-100k,desktop,new,South,77,True,41,2,0,True,True,True,40,2,0,9.181169348743706,1,0
user_001274,37,75k-100k,mobile,new,West,44,False,0,0,0,False,False,False,0,0,0,,0,0
user_001275,46,50k-75k,desktop,returning,East,44,False,0,0,0,True,False,True,121,1,1,6.377211309621151,-121,-1
user_001276,44,50k-75k,mobile,returning,Midwest,62,True,89,3,1,True,True,True,95,1,0,7.832876322250756,-6,2
user_001277,43,<30k,desktop,new,East,56,False,0,0,0,False,False,True,86,1,0,7.632461124466046,-86,-1
user_001278,42,75k-100k,desktop,returning,East,72,True,51,4,1,False,True,False,0,0,0,,51,4
user_001279,48,100k-150k,desktop,returning,South,79,True,30,4,0,False,True,True,50,3,0,8.42592603143598,-20,1
user_001280,77,30k-50k,desktop,returning,South,22,True,154,5,0,False,False,True,143,3,0,6.11847369880408,11,2
user_001281,35,100k-150k,mobile,returning,East,49,True,148,3,0,False,True,False,0,0,0,,148,3
user_001282,40,30k-50k,desktop,new,West,63,False,0,0,0,False,False,False,0,0,0,,0,0
user_001283,66,30k-50k,desktop,returning,South,26,False,0,0,0,False,True,True,77,1,0,6.019134639731154,-77,-1
user_001284,67,75k-100k,mobile,new,East,25,True,181,8,0,False,False,True,162,15,0,8.428290714681903,19,-7
user_001285,18,50k-75k,mobile,new,West,100,True,88,4,0,True,True,True,72,1,0,9.881146795171542,16,3
user_001286,44,50k-75k,mobile,returning,South,19,False,0,0,0,False,False,True,74,1,0,10.0,-74,-1
user_001287,33,>150k,mobile,returning,West,98,True,59,4,0,True,True,True,54,4,0,7.125309107963429,5,0
user_001288,26,>150k,desktop,returning,Midwest,100,True,94,1,0,False,True,True,71,2,0,6.675323045992838,23,-1
user_001289,61,100k-150k,tablet,returning,South,80,True,49,5,0,False,True,True,35,2,0,5.248977161227327,14,3
user_001290,18,50k-75k,mobile,new,West,82,True,116,7,0,True,True,True,60,5,0,7.0234963653758875,56,2
user_001291,50,50k-75k,tablet,returning,East,71,True,117,3,0,True,True,False,0,0,0,,117,3
user_001292,39,75k-100k,mobile,returning,East,38,True,76,6,0,True,True,True,41,5,0,7.256096874711009,35,1
user_001293,50,<30k,tablet,new,West,30,True,180,2,0,False,False,True,161,4,0,4.8739426331016915,19,-2
user_001294,39,<30k,desktop,returning,West,49,True,105,2,0,False,False,True,106,4,0,5.42149639612734,-1,-2
user_001295,30,75k-100k,mobile,new,West,100,True,72,5,0,True,True,True,42,3,0,9.464062864550716,30,2
user_001296,48,30k-50k,desktop,returning,South,39,False,0,0,0,False,True,True,90,1,0,6.945044758415452,-90,-1
user_001297,25,75k-100k,mobile,returning,East,93,True,30,5,1,False,True,True,20,5,0,9.27538281816804,10,0
user_001298,57,>150k,mobile,returning,South,35,True,90,2,0,True,True,False,0,0,0,,90,2
user_001299,34,>150k,mobile,returning,East,71,True,30,2,0,False,True,False,0,0,0,,30,2
user_001300,48,50k-75k,mobile,returning,Midwest,35,True,157,2,0,False,True,True,139,1,0,5.122898351582833,18,1
user_001301,59,75k-100k,tablet,new,West,56,False,0,0,0,False,False,True,108,3,0,7.630655196535894,-108,-3
user_001302,40,<30k,desktop,new,West,54,True,122,2,0,True,True,True,85,1,0,7.426943943284557,37,1
user_001303,45,50k-75k,desktop,new,South,47,True,76,1,0,True,False,True,76,2,1,6.293282101987201,0,-1
user_001304,52,30k-50k,mobile,returning,East,39,False,0,0,0,True,False,False,0,0,0,,0,0
user_001305,52,<30k,desktop,returning,East,23,True,137,1,0,False,False,True,111,3,0,6.213127410241088,26,-2
user_001306,62,75k-100k,desktop,new,East,32,False,0,0,0,False,False,True,135,1,0,8.011966835035787,-135,-1
user_001307,38,50k-75k,mobile,new,East,50,True,100,3,0,False,True,True,87,5,0,5.605542620301076,13,-2
user_001308,66,50k-75k,desktop,returning,Midwest,34,False,0,0,0,True,False,True,137,1,0,4.99348076110467,-137,-1
user_001309,60,50k-75k,mobile,new,South,28,False,0,0,0,False,False,True,127,2,0,7.397620963860895,-127,-2
user_001310,50,50k-75k,desktop,returning,Midwest,7,True,99,5,0,True,True,True,47,2,0,6.49572416937167,52,3
user_001311,29,100k-150k,mobile,returning,West,100,True,102,3,0,False,True,True,48,2,0,8.5261386123312,54,1
user_001312,54,50k-75k,desktop,new,Midwest,52,True,140,1,0,False,False,True,139,1,0,7.445036962336904,1,0
user_001313,80,30k-50k,desktop,returning,South,14,False,0,0,0,False,False,False,0,0,0,,0,0
user_001314,21,100k-150k,desktop,returning,East,62,True,103,1,1,False,True,True,76,2,0,7.999208261785436,27,-1
user_001315,30,30k-50k,mobile,returning,West,87,True,78,6,0,True,True,True,65,2,0,8.387170730008938,13,4
user_001316,41,30k-50k,mobile,new,South,50,True,146,2,0,True,False,True,148,2,0,6.019977971299936,-2,0
user_001317,75,50k-75k,desktop,returning,South,32,True,93,4,0,False,True,True,98,5,1,10.0,-5,-1
user_001318,49,100k-150k,mobile,returning,South,85,True,62,2,0,True,True,True,39,3,1,9.131616463621656,23,-1
user_001319,69,50k-75k,mobile,returning,Midwest,20,True,114,1,0,True,True,True,73,1,0,6.926516182896149,41,0
user_001320,28,100k-150k,mobile,returning,East,97,True,49,5,0,True,True,True,20,7,0,7.83541884367318,29,-2
user_001321,63,75k-100k,desktop,returning,South,30,True,98,7,0,False,True,True,78,5,0,7.370109215911064,20,2
user_001322,59,<30k,desktop,new,South,3,False,0,0,0,False,False,False,0,0,0,,0,0
user_001323,58,75k-100k,mobile,new,East,25,True,161,1,0,False,False,True,127,2,0,6.135674375845758,34,-1
user_001324,40,100k-150k,desktop,returning,Midwest,78,True,89,3,0,False,False,True,79,3,1,7.00434899522281,10,0
user_001325,32,30k-50k,mobile,returning,East,68,True,136,2,0,True,True,True,78,1,0,9.62315157005935,58,1
user_001326,51,75k-100k,mobile,new,East,28,True,150,8,2,True,True,True,115,5,0,3.9875281889897174,35,3
user_001327,18,50k-75k,mobile,returning,West,57,False,0,0,0,True,True,False,0,0,0,,0,0
user_001328,31,<30k,desktop,returning,Midwest,63,True,92,4,0,False,True,True,77,2,0,8.426461832730194,15,2
user_001329,22,30k-50k,desktop,returning,West,79,True,112,1,0,True,True,True,77,2,0,7.57481100824386,35,-1
user_001330,27,<30k,mobile,new,Midwest,56,False,0,0,0,False,False,False,0,0,0,,0,0
user_001331,58,<30k,desktop,new,Midwest,0,True,187,4,1,False,False,True,222,4,0,5.737858530797106,-35,0
user_001332,73,30k-50k,mobile,new,West,32,True,120,5,0,True,True,True,64,5,0,7.666891116361985,56,0
user_001333,46,30k-50k,mobile,returning,Midwest,52,True,69,7,0,False,True,False,0,0,0,,69,7
user_001334,28,50k-75k,desktop,returning,South,53,True,98,1,0,False,False,True,88,2,0,7.29922995648146,10,-1
user_001335,47,30k-50k,desktop,returning,East,45,True,109,1,0,False,False,True,73,1,0,7.126265182895391,36,0
user_001336,74,100k-150k,mobile,returning,East,53,True,125,2,0,False,False,True,112,1,0,7.310609001887061,13,1
user_001337,37,100k-150k,desktop,new,South,40,True,115,5,0,False,False,True,114,4,0,10.0,1,1
user_001338,24,100k-150k,desktop,returning,West,81,True,73,8,0,False,True,True,44,9,0,7.853240396235777,29,-1
user_001339,47,30k-50k,desktop,new,East,49,True,130,2,0,True,True,False,0,0,0,,130,2
user_001340,22,50k-75k,mobile,new,Midwest,92,True,74,2,2,False,True,True,58,3,0,9.846411291182125,16,-1
user_001341,26,50k-75k,mobile,returning,East,76,True,74,1,0,False,True,True,84,1,0,7.939515249777472,-10,0
user_001342,34,30k-50k,mobile,returning,South,48,True,95,8,0,True,True,True,46,9,1,9.215668385686584,49,-1
user_001343,59,30k-50k,desktop,new,Midwest,30,True,119,3,1,False,True,True,104,4,0,8.288947952026996,15,-1
user_001344,27,30k-50k,desktop,returning,West,74,False,0,0,0,True,True,True,52,1,0,6.297115766967801,-52,-1
user_001345,34,30k-50k,mobile,returning,East,87,True,31,1,0,True,True,True,35,2,0,8.50155067538586,-4,-1
user_001346,28,<30k,desktop,new,Midwest,93,True,59,3,0,True,True,True,60,4,0,9.106864747543563,-1,-1
user_001347,51,50k-75k,desktop,new,Midwest,34,True,162,4,0,True,True,True,157,5,0,10.0,5,-1
user_001348,43,50k-75k,mobile,new,East,33,True,125,3,0,False,True,True,94,3,1,8.039753746005118,31,0
user_001349,58,75k-100k,mobile,returning,South,37,True,87,3,0,False,True,True,20,4,0,9.597452279678286,67,-1
user_001350,38,50k-75k,desktop,new,West,40,False,0,0,0,False,False,True,128,3,0,7.418603233265157,-128,-3
user_001351,18,100k-150k,mobile,returning,Midwest,96,True,99,4,0,True,True,True,70,2,0,8.618848518322949,29,2
user_001352,39,50k-75k,mobile,new,South,55,True,143,2,0,True,True,True,118,1,0,6.2388145236065915,25,1
user_001353,30,75k-100k,mobile,returning,East,43,True,70,5,0,False,False,True,52,4,0,6.621576558035572,18,1
user_001354,80,75k-100k,desktop,returning,West,46,True,82,1,1,False,False,True,51,1,0,7.900476295988404,31,0
user_001355,52,100k-150k,mobile,returning,South,54,False,0,0,0,False,True,True,84,1,0,7.525419633215977,-84,-1
user_001356,36,<30k,desktop,returning,Midwest,33,True,74,3,0,False,True,True,54,1,0,7.2731916078880845,20,2
user_001357,29,100k-150k,desktop,new,Midwest,79,True,112,1,0,False,False,True,121,1,0,7.550761706501239,-9,0
user_001358,65,30k-50k,mobile,returning,Midwest,30,True,78,2,0,False,True,True,49,1,0,8.762154201381813,29,1
user_001359,68,100k-150k,desktop,new,Midwest,15,True,144,4,1,False,False,True,126,5,0,7.075795705455187,18,-1
user_001360,40,75k-100k,mobile,returning,West,49,True,141,4,0,True,True,True,118,1,0,8.151196891072859,23,3
user_001361,44,50k-75k,mobile,returning,East,49,True,30,3,0,False,True,True,20,1,0,7.449232410428935,10,2
user_001362,35,100k-150k,desktop,returning,Midwest,55,True,71,1,0,False,True,True,45,2,0,7.257526346233644,26,-1
user_001363,56,30k-50k,desktop,returning,East,8,True,135,5,0,False,True,True,82,2,0,8.888514820698669,53,3
user_001364,55,<30k,desktop,returning,South,46,False,0,0,0,False,False,False,0,0,0,,0,0
user_001365,49,75k-100k,desktop,returning,Midwest,45,True,125,1,0,False,False,True,138,1,0,7.750483737505763,-13,0
user_001366,44,75k-100k,desktop,returning,West,47,True,33,1,0,False,False,False,0,0,0,,33,1
user_001367,36,50k-75k,desktop,returning,Midwest,45,True,88,4,0,True,False,True,86,5,0,5.483213583118889,2,-1
user_001368,27,75k-100k,desktop,new,Midwest,69,True,106,5,0,False,False,True,148,4,0,7.047850814544312,-42,1
user_001369,52,<30k,tablet,returning,West,35,False,0,0,0,False,False,False,0,0,0,,0,0
user_001370,21,75k-100k,desktop,new,South,51,True,183,4,0,True,True,True,197,2,0,10.0,-14,2
user_001371,56,50k-75k,mobile,returning,South,23,True,145,3,1,True,True,True,131,5,0,7.343840313925515,14,-2
user_001372,56,75k-100k,desktop,new,Midwest,21,True,161,4,0,False,False,True,163,1,0,5.894641113104009,-2,3
user_001373,59,<30k,desktop,new,East,30,False,0,0,0,False,False,True,165,1,0,7.681945587230354,-165,-1
user_001374,40,75k-100k,desktop,new,East,49,True,133,3,0,False,False,True,171,2,0,5.467567669559239,-38,1
user_001375,34,50k-75k,desktop,returning,Midwest,66,True,142,3,0,False,True,True,114,2,0,7.924578421463989,28,1
user_001376,69,<30k,desktop,new,West,3,True,141,7,1,False,False,True,147,7,0,4.414967627574106,-6,0
user_001377,55,30k-50k,desktop,returning,East,68,True,74,3,0,True,True,True,62,2,0,7.593162945312631,12,1
user_001378,53,75k-100k,desktop,new,Midwest,42,True,147,1,0,False,False,True,148,1,0,8.844961777902013,-1,0
user_001379,40,100k-150k,desktop,new,West,43,True,117,2,0,False,False,True,141,1,0,7.140777137292955,-24,1
user_001380,45,30k-50k,desktop,new,South,57,True,97,3,0,False,True,True,104,4,0,9.925216920552527,-7,-1
user_001381,55,75k-100k,mobile,returning,East,24,True,160,5,0,False,False,True,182,4,0,5.24224852802678,-22,1
user_001382,41,50k-75k,desktop,new,East,48,True,91,3,0,False,False,True,72,3,0,6.934018218750777,19,0
user_001383,54,<30k,desktop,new,Midwest,29,True,139,3,0,True,False,True,181,1,0,8.945946818846702,-42,2
user_001384,30,50k-75k,mobile,returning,East,72,True,61,3,0,True,True,True,45,5,1,9.022365801185426,16,-2
user_001385,60,>150k,mobile,new,Midwest,38,True,104,7,0,False,True,True,93,3,0,8.70523024022339,11,4
user_001386,32,50k-75k,desktop,new,South,75,True,150,3,0,False,True,True,100,1,0,7.254862795359649,50,2
user_001387,37,<30k,mobile,returning,East,39,True,87,2,0,True,True,True,44,2,0,8.583609197198673,43,0
user_001388,47,50k-75k,desktop,returning,East,69,True,60,2,0,False,True,True,40,3,0,9.348184144869723,20,-1
user_001389,39,<30k,mobile,returning,South,42,True,106,2,1,False,False,True,112,1,0,5.502563741034704,-6,1
user_001390,37,30k-50k,mobile,returning,South,65,True,135,3,1,True,True,True,114,5,0,8.790139631715201,21,-2
user_001391,49,50k-75k,desktop,new,East,57,False,0,0,0,False,False,True,133,1,0,7.4403437297541535,-133,-1
user_001392,55,50k-75k,desktop,returning,Midwest,56,True,64,1,0,False,True,True,45,1,0,7.764800788195827,19,0
user_001393,62,75k-100k,mobile,new,East,23,True,131,5,0,True,False,True,128,5,0,7.891480144671771,3,0
user_001394,53,30k-50k,mobile,returning,South,24,True,163,4,0,True,False,True,147,3,0,7.171354717503636,16,1
user_001395,61,50k-75k,mobile,returning,Midwest,30,True,129,7,2,False,False,True,137,6,0,7.17571170614116,-8,1
user_001396,65,30k-50k,mobile,returning,East,40,True,69,5,0,True,False,True,77,5,0,5.541900556307424,-8,0
user_001397,49,30k-50k,desktop,new,East,44,True,120,3,0,False,False,True,114,2,0,7.304376924405309,6,1
user_001398,18,30k-50k,desktop,returning,East,100,True,30,1,0,True,True,True,20,1,1,7.873961106933042,10,0
user_001399,43,30k-50k,desktop,returning,South,59,True,101,3,0,True,True,True,69,1,0,8.180175993605722,32,2
user_001400,71,75k-100k,desktop,returning,South,7,True,105,5,0,False,True,True,99,3,0,5.665025875926108,6,2
user_001401,18,75k-100k,tablet,new,Midwest,67,True,124,2,0,False,False,True,114,1,0,6.540120370179277,10,1
user_001402,80,75k-100k,desktop,returning,East,29,True,109,3,0,False,False,True,141,1,0,6.2437601867967665,-32,2
user_001403,36,50k-75k,mobile,returning,East,73,True,30,4,0,True,True,True,20,1,0,7.899525963324554,10,3
user_001404,41,50k-75k,mobile,returning,East,96,True,121,5,0,False,True,True,57,3,0,8.28289398763145,64,2
user_001405,47,<30k,desktop,new,West,59,False,0,0,0,False,False,True,132,1,0,8.334955615462977,-132,-1
user_001406,35,75k-100k,mobile,returning,Midwest,64,True,109,2,1,False,True,True,96,1,1,8.68876750743424,13,1
user_001407,31,>150k,desktop,returning,West,80,True,122,1,0,False,True,True,128,1,0,8.820282805783757,-6,0
user_001408,32,30k-50k,desktop,new,West,70,False,0,0,0,False,True,True,26,1,0,9.604741301118494,-26,-1
user_001409,18,30k-50k,desktop,returning,West,57,False,0,0,0,False,True,True,85,1,0,7.965263941594354,-85,-1
user_001410,55,<30k,desktop,returning,Midwest,62,False,0,0,0,True,True,True,105,1,0,8.508557129296248,-105,-1
user_001411,74,100k-150k,mobile,returning,East,50,True,64,3,1,False,True,True,56,6,0,7.472376019019757,8,-3
user_001412,42,75k-100k,desktop,returning,South,35,True,126,5,0,True,True,True,120,5,0,8.085694224698376,6,0
user_001413,47,<30k,mobile,returning,South,22,True,98,5,1,True,True,True,78,3,0,6.675051433594844,20,2
user_001414,58,50k-75k,mobile,returning,South,26,False,0,0,0,True,True,True,126,1,0,7.3063851258051145,-126,-1
user_001415,43,50k-75k,desktop,returning,West,71,True,113,1,0,True,True,True,97,1,0,8.4308846996605,16,0
user_001416,74,75k-100k,mobile,new,West,44,False,0,0,0,True,True,True,81,3,0,9.120280890326713,-81,-3
user_001417,57,30k-50k,desktop,returning,Midwest,29,True,121,7,1,False,True,True,69,4,0,7.271505751452528,52,3
user_001418,46,50k-75k,desktop,new,East,43,True,117,4,0,False,True,True,52,2,0,8.434034119243618,65,2
user_001419,35,30k-50k,mobile,returning,East,42,True,130,2,0,False,True,True,89,1,0,7.227813855621425,41,1
user_001420,60,75k-100k,mobile,returning,East,56,True,91,4,0,False,True,True,53,3,0,7.758209720103952,38,1
user_001421,38,100k-150k,mobile,new,East,53,True,80,1,0,False,False,True,111,1,0,8.344054006562013,-31,0
user_001422,31,30k-50k,desktop,returning,East,88,True,46,1,0,False,True,True,20,1,0,9.21700135736058,26,0
user_001423,54,30k-50k,desktop,new,West,58,True,97,4,2,False,True,True,109,5,0,7.332950202808917,-12,-1
user_001424,62,75k-100k,mobile,returning,Midwest,36,True,57,3,0,True,False,True,33,7,0,6.95210156361624,24,-4
user_001425,80,50k-75k,mobile,returning,East,55,False,0,0,0,False,True,True,87,1,1,5.948801939081374,-87,-1
user_001426,44,100k-150k,desktop,returning,South,33,True,77,6,0,False,True,True,32,2,0,8.393555088469787,45,4
user_001427,57,100k-150k,desktop,returning,West,46,False,0,0,0,False,False,True,115,2,0,7.591554851216931,-115,-2
user_001428,31,30k-50k,mobile,new,East,91,False,0,0,0,False,True,True,103,2,0,8.461244345098532,-103,-2
user_001429,64,50k-75k,mobile,returning,East,47,True,140,1,1,True,True,True,122,1,0,7.796477190160202,18,0
user_001430,33,30k-50k,desktop,returning,East,79,True,35,1,1,True,True,True,89,1,0,9.689052004610266,-54,0
user_001431,70,30k-50k,desktop,returning,South,22,True,98,2,0,True,True,True,97,1,0,7.535436732196234,1,1
user_001432,39,50k-75k,mobile,returning,South,16,True,168,3,1,False,True,True,104,1,0,7.6935729842435086,64,2
user_001433,53,75k-100k,desktop,returning,South,50,False,0,0,0,False,False,True,96,1,0,7.168142734354987,-96,-1
user_001434,41,75k-100k,desktop,new,East,54,True,109,2,0,False,False,True,126,5,0,6.523495376228234,-17,-3
user_001435,51,<30k,desktop,returning,West,62,True,88,5,0,True,False,True,59,5,0,8.629890747912066,29,0
user_001436,45,50k-75k,desktop,returning,West,32,True,153,3,1,False,True,True,130,1,0,8.592904918525857,23,2
user_001437,35,50k-75k,desktop,returning,Midwest,53,True,67,1,0,False,True,True,78,1,0,8.450419760636363,-11,0
user_001438,33,<30k,desktop,new,West,94,True,107,2,0,True,True,True,77,7,1,7.508381364829958,30,-5
user_001439,18,100k-150k,mobile,new,East,100,False,0,0,0,True,True,True,105,1,0,9.324495149078194,-105,-1
user_001440,79,50k-75k,desktop,returning,East,8,True,129,4,1,True,True,True,146,2,0,8.528718036018676,-17,2
user_001441,44,100k-150k,tablet,new,Midwest,56,True,150,2,0,False,False,True,126,1,0,6.176612989285194,24,1
user_001442,18,50k-75k,mobile,returning,East,78,False,0,0,0,False,True,True,99,1,0,6.782609112233306,-99,-1
user_001443,45,30k-50k,mobile,new,East,28,False,0,0,0,False,True,True,107,1,0,7.845491788318908,-107,-1
user_001444,33,30k-50k,desktop,returning,West,79,True,80,3,2,True,True,True,30,4,0,7.9231555552412045,50,-1
user_001445,46,50k-75k,mobile,returning,East,61,True,69,3,1,True,False,True,65,1,1,6.273620799905848,4,2
user_001446,56,50k-75k,mobile,returning,South,22,True,128,6,2,False,False,True,164,6,1,8.06299774068396,-36,0
user_001447,29,50k-75k,desktop,returning,West,95,True,61,6,0,True,False,True,45,3,0,6.728442453665108,16,3
user_001448,35,30k-50k,mobile,returning,West,39,True,46,3,0,True,True,True,35,3,0,7.523880811620106,11,0
user_001449,27,50k-75k,mobile,returning,Midwest,47,True,54,7,0,False,True,True,53,11,0,7.333418037996816,1,-4
user_001450,38,50k-75k,desktop,new,West,69,True,67,2,0,True,True,True,45,2,0,7.851728383042781,22,0
user_001451,43,50k-75k,desktop,returning,East,75,True,104,3,0,True,True,True,83,1,0,9.141270018207473,21,2
user_001452,18,100k-150k,tablet,returning,South,82,True,78,1,0,True,True,True,50,2,0,5.93845026378754,28,-1
user_001453,36,50k-75k,desktop,returning,West,55,False,0,0,0,True,True,True,95,1,0,7.829383601393036,-95,-1
user_001454,48,<30k,mobile,returning,South,47,True,114,3,0,False,True,True,97,1,0,8.639331931013656,17,2
user_001455,35,<30k,mobile,new,East,40,True,132,3,0,False,False,True,115,4,0,8.355143544513604,17,-1
user_001456,18,30k-50k,mobile,returning,East,67,True,109,4,0,True,True,True,94,4,0,9.039356768709451,15,0
user_001457,56,>150k,mobile,returning,Midwest,46,True,75,3,0,True,True,True,69,3,0,8.939447269582876,6,0
user_001458,32,50k-75k,desktop,new,Midwest,57,True,137,2,0,False,True,True,110,1,0,9.647456234054841,27,1
user_001459,27,50k-75k,desktop,new,Midwest,72,True,138,2,0,True,True,True,113,1,0,9.406159293863482,25,1
user_001460,59,50k-75k,desktop,returning,East,11,True,179,3,0,False,False,True,194,2,0,10.0,-15,1
user_001461,60,100k-150k,desktop,new,East,43,True,121,3,0,False,False,True,110,3,0,5.688045805336796,11,0
user_001462,46,50k-75k,mobile,returning,South,38,True,68,2,0,True,True,False,0,0,0,,68,2
user_001463,33,30k-50k,mobile,new,East,65,True,116,3,0,False,False,True,110,3,0,6.970044546443199,6,0
user_001464,56,<30k,mobile,returning,South,40,True,58,4,0,False,True,True,25,3,0,7.069557185891474,33,1
user_001465,56,75k-100k,desktop,new,East,60,True,87,4,0,False,False,True,74,6,1,10.0,13,-2
user_001466,22,100k-150k,mobile,returning,East,67,True,105,1,0,True,True,True,95,1,0,9.445594621772088,10,0
user_001467,31,75k-100k,desktop,returning,South,61,True,73,4,0,True,False,True,72,1,0,6.814137407768871,1,3
user_001468,59,<30k,mobile,returning,East,38,False,0,0,0,False,False,True,92,1,0,7.624027260880368,-92,-1
user_001469,39,<30k,mobile,new,East,21,True,205,4,0,False,True,True,175,2,0,6.648086992447345,30,2
user_001470,35,50k-75k,desktop,returning,West,82,True,99,3,0,True,True,True,92,2,0,8.924906104170173,7,1
user_001471,36,30k-50k,mobile,returning,East,28,True,157,4,0,True,True,True,112,1,0,10.0,45,3
user_001472,62,<30k,desktop,new,West,45,True,174,5,0,True,False,False,0,0,0,,174,5
user_001473,29,100k-150k,desktop,new,Midwest,92,True,164,3,0,False,True,True,107,5,0,7.084621234590879,57,-2
user_001474,50,100k-150k,mobile,returning,South,62,True,144,2,0,False,True,True,99,1,0,7.018627241148259,45,1
user_001475,66,75k-100k,mobile,returning,West,35,True,88,2,0,True,True,False,0,0,0,,88,2
user_001476,43,50k-75k,mobile,returning,South,37,True,89,4,0,False,False,True,37,6,0,5.840339554826678,52,-2
user_001477,31,30k-50k,desktop,new,Midwest,55,True,140,5,0,False,True,True,122,2,0,9.430313719908257,18,3
user_001478,48,100k-150k,mobile,returning,West,19,True,159,5,1,True,True,True,134,1,0,6.818507188184147,25,4
user_001479,47,30k-50k,mobile,returning,Midwest,67,True,57,4,0,True,False,True,37,1,0,7.46963809372445,20,3
user_001480,32,50k-75k,mobile,new,West,69,False,0,0,0,False,True,True,78,1,0,9.13144706541201,-78,-1
user_001481,61,50k-75k,desktop,returning,West,52,False,0,0,0,True,True,True,79,1,0,9.829709966874614,-79,-1
user_001482,61,50k-75k,mobile,new,West,32,True,139,4,0,False,True,True,101,1,0,7.839406060160386,38,3
user_001483,72,<30k,mobile,returning,South,13,True,117,4,0,True,False,False,0,0,0,,117,4
user_001484,18,50k-75k,mobile,returning,Midwest,66,True,49,2,2,True,True,True,67,1,1,6.1356404363731585,-18,1
user_001485,18,50k-75k,mobile,new,South,95,True,83,2,0,False,False,True,66,1,0,7.009473618189422,17,1
user_001486,44,30k-50k,mobile,returning,South,52,True,83,2,0,True,True,True,99,1,0,7.386788918145032,-16,1
user_001487,56,50k-75k,desktop,returning,Midwest,17,True,138,3,0,False,True,True,80,1,0,7.078947134143962,58,2
user_001488,58,50k-75k,desktop,returning,West,54,False,0,0,0,True,False,True,120,2,0,8.152911578668851,-120,-2
user_001489,56,30k-50k,mobile,new,East,4,True,188,2,0,True,False,True,144,1,0,7.162031632054556,44,1
user_001490,41,30k-50k,desktop,new,West,5,True,157,4,0,False,True,True,96,1,0,8.78947003088144,61,3
user_001491,41,30k-50k,mobile,new,Midwest,68,True,136,1,0,False,False,True,127,1,0,7.368719578499182,9,0
user_001492,37,75k-100k,desktop,new,South,53,True,98,1,0,False,True,True,84,2,0,6.9228500290259545,14,-1
user_001493,67,30k-50k,mobile,new,Midwest,27,True,162,3,0,False,False,True,163,6,0,5.027084014630479,-1,-3
user_001494,60,75k-100k,desktop,returning,West,23,True,108,2,0,False,False,True,100,2,0,7.159572393954645,8,0
user_001495,58,<30k,mobile,returning,Midwest,3,True,128,2,0,False,True,True,110,1,0,6.756902145847032,18,1
user_001496,33,75k-100k,mobile,new,South,60,True,127,2,0,True,True,True,81,2,0,9.48090409390668,46,0
user_001497,49,50k-75k,desktop,new,East,30,True,107,5,0,False,True,True,103,10,0,5.937809677863589,4,-5
user_001498,41,100k-150k,mobile,returning,South,64,True,42,3,0,False,True,True,20,4,0,8.078239641309219,22,-1
user_001499,34,75k-100k,desktop,returning,West,97,True,111,3,0,True,True,False,0,0,0,,111,3
user_001500,47,30k-50k,mobile,returning,East,50,False,0,0,0,False,False,True,130,1,0,9.45486074863772,-130,-1
user_001501,50,50k-75k,desktop,returning,East,52,True,129,2,0,True,True,True,86,5,0,8.647534278384391,43,-3
user_001502,38,50k-75k,desktop,new,West,60,True,164,3,0,True,True,True,86,3,0,9.240813505241393,78,0
user_001503,80,30k-50k,desktop,new,East,42,True,177,5,0,False,False,True,181,7,0,8.943169531936663,-4,-2
user_001504,35,100k-150k,desktop,returning,South,68,True,133,1,0,True,True,True,122,1,0,8.447355021501298,11,0
user_001505,55,<30k,desktop,returning,South,55,True,70,4,1,False,True,True,50,4,0,7.1656113594263555,20,0
user_001506,57,>150k,desktop,new,South,34,False,0,0,0,False,True,False,0,0,0,,0,0
user_001507,23,>150k,desktop,returning,East,65,True,74,1,1,False,True,True,65,1,0,6.396185099591993,9,0
user_001508,67,75k-100k,desktop,returning,West,44,True,155,4,1,False,True,True,153,3,0,6.895843732796879,2,1
user_001509,58,50k-75k,desktop,returning,Midwest,26,True,206,2,0,False,False,True,191,1,0,6.393455357388642,15,1
user_001510,40,30k-50k,tablet,new,West,66,True,145,4,1,False,True,True,107,2,0,9.279163166300059,38,2
user_001511,60,75k-100k,desktop,returning,South,14,True,144,3,1,False,False,True,143,5,0,7.109770319145815,1,-2
user_001512,46,<30k,mobile,returning,East,79,True,74,1,0,False,True,True,64,1,0,7.277971128390919,10,0
user_001513,44,75k-100k,tablet,new,Midwest,61,True,91,3,0,False,False,True,95,4,0,6.710090032589679,-4,-1
user_001514,46,<30k,desktop,new,West,67,False,0,0,0,False,True,True,96,1,0,9.850937819262175,-96,-1
user_001515,24,100k-150k,desktop,returning,West,90,False,0,0,0,True,True,True,118,1,0,8.117808473471305,-118,-1
user_001516,32,100k-150k,mobile,new,East,74,True,62,3,0,True,True,True,47,4,1,6.362969286651972,15,-1
user_001517,51,50k-75k,mobile,new,East,75,True,98,4,1,True,True,True,71,5,0,7.905983580935418,27,-1
user_001518,47,50k-75k,desktop,returning,South,39,True,46,4,0,False,True,True,62,5,0,8.201704136825489,-16,-1
user_001519,38,100k-150k,desktop,new,East,68,False,0,0,0,True,True,True,84,2,1,9.195110464465975,-84,-2
user_001520,59,100k-150k,desktop,returning,West,77,True,55,3,1,True,True,True,47,4,0,7.198978630522173,8,-1
user_001521,47,100k-150k,mobile,new,East,47,True,178,4,0,False,True,True,141,4,0,9.91654516997858,37,0
user_001522,54,100k-150k,mobile,returning,West,70,True,52,2,0,True,True,True,21,1,0,9.113738836662447,31,1
user_001523,40,<30k,desktop,returning,South,29,True,108,2,0,True,False,False,0,0,0,,108,2
user_001524,68,<30k,mobile,new,South,41,True,79,3,1,False,True,True,91,4,0,6.366211327627483,-12,-1
user_001525,35,50k-75k,mobile,returning,South,40,True,122,7,0,True,True,True,102,6,0,10.0,20,1
user_001526,29,50k-75k,desktop,returning,Midwest,52,True,62,4,0,True,True,True,61,2,0,5.171675964924232,1,2
user_001527,75,30k-50k,mobile,returning,East,37,True,129,1,0,False,False,True,138,1,0,8.078027864755695,-9,0
user_001528,57,50k-75k,mobile,new,East,47,True,79,2,1,True,True,True,89,1,1,8.648917752545428,-10,1
user_001529,80,75k-100k,mobile,returning,Midwest,16,True,106,5,0,False,False,True,129,4,0,6.119144704778159,-23,1
user_001530,36,50k-75k,desktop,returning,West,65,True,57,3,0,True,True,True,88,2,0,8.945962030935894,-31,1
user_001531,25,<30k,tablet,returning,West,66,False,0,0,0,True,True,True,84,1,0,7.872929719708155,-84,-1
user_001532,62,50k-75k,desktop,returning,Midwest,5,True,93,2,0,False,False,True,96,2,0,6.219847527252874,-3,0
user_001533,27,30k-50k,desktop,returning,Midwest,49,True,98,2,0,False,True,True,72,4,0,9.871799776421764,26,-2
user_001534,64,<30k,desktop,returning,East,23,False,0,0,0,True,False,True,139,1,0,5.852892868846671,-139,-1
user_001535,24,<30k,desktop,returning,South,47,False,0,0,0,True,True,True,74,1,0,6.215405939372153,-74,-1
user_001536,61,50k-75k,mobile,new,Midwest,28,True,194,1,0,False,False,True,158,1,0,6.513278127790083,36,0
user_001537,50,<30k,desktop,returning,South,43,True,98,2,0,True,True,True,72,2,0,8.784912138621541,26,0
user_001538,40,100k-150k,mobile,returning,West,68,True,152,9,0,True,True,True,102,7,0,6.431880246646333,50,2
user_001539,34,30k-50k,mobile,returning,West,87,True,30,3,0,True,True,True,20,1,0,6.9461229860111136,10,2
user_001540,26,100k-150k,desktop,returning,Midwest,99,True,30,4,0,True,True,True,20,3,0,7.867256759130661,10,1
user_001541,49,100k-150k,mobile,returning,West,52,True,73,7,0,False,True,True,60,7,0,7.374443125922806,13,0
user_001542,42,75k-100k,desktop,new,West,80,True,115,1,0,True,False,True,110,1,0,7.800081610423485,5,0
user_001543,67,100k-150k,mobile,returning,East,45,True,51,2,0,True,True,False,0,0,0,,51,2
user_001544,23,50k-75k,mobile,new,West,86,True,114,2,0,False,True,True,109,2,0,9.173736762026255,5,0
user_001545,59,<30k,desktop,returning,South,20,True,114,3,0,True,False,False,0,0,0,,114,3
user_001546,40,100k-150k,desktop,returning,East,44,True,125,3,0,False,False,True,148,1,0,6.575283502362332,-23,2
user_001547,44,<30k,tablet,returning,Midwest,67,True,119,5,1,False,True,True,95,5,0,5.434951544387733,24,0
user_001548,33,<30k,desktop,returning,East,71,False,0,0,0,True,True,True,110,1,0,8.190043058762933,-110,-1
user_001549,38,30k-50k,mobile,returning,South,61,True,86,4,1,False,True,True,82,3,0,9.179924587008074,4,1
user_001550,46,50k-75k,desktop,new,West,64,True,125,1,0,True,True,True,107,1,0,8.535807852812297,18,0
user_001551,46,>150k,mobile,returning,West,49,True,67,6,1,True,True,True,49,7,1,6.401712685634683,18,-1
user_001552,43,30k-50k,mobile,new,West,88,False,0,0,0,False,True,True,74,1,0,7.882069474708605,-74,-1
user_001553,48,<30k,mobile,new,Midwest,29,True,181,3,0,True,False,True,204,3,1,7.722047345414317,-23,0
user_001554,63,<30k,mobile,returning,Midwest,19,True,163,4,0,False,False,False,0,0,0,,163,4
user_001555,34,75k-100k,desktop,returning,West,100,True,54,3,0,True,True,True,20,4,0,9.728953649910492,34,-1
user_001556,69,<30k,mobile,new,Midwest,51,False,0,0,0,True,True,False,0,0,0,,0,0
user_001557,64,<30k,desktop,returning,East,33,False,0,0,0,True,False,False,0,0,0,,0,0
user_001558,40,75k-100k,desktop,returning,East,56,True,98,3,1,True,True,True,82,1,1,7.187020973362881,16,2
user_001559,34,30k-50k,mobile,returning,East,58,True,70,3,0,True,True,True,52,2,1,7.437055150263125,18,1
user_001560,18,100k-150k,desktop,returning,Midwest,71,True,146,4,0,False,True,True,123,1,0,6.9246396534305745,23,3
user_001561,18,100k-150k,mobile,returning,East,82,False,0,0,0,True,True,True,85,1,0,5.7097967518678665,-85,-1
user_001562,38,50k-75k,mobile,returning,West,82,True,51,2,0,False,False,True,32,1,0,7.735324599790801,19,1
user_001563,21,75k-100k,desktop,returning,East,48,True,90,1,0,False,True,False,0,0,0,,90,1
user_001564,41,75k-100k,desktop,returning,South,42,True,72,2,0,False,False,True,81,3,0,6.640172488520142,-9,-1
user_001565,59,75k-100k,mobile,new,South,41,True,144,4,0,True,True,True,103,2,0,8.495438066933216,41,2
user_001566,28,30k-50k,mobile,returning,West,62,True,97,5,0,True,True,False,0,0,0,,97,5
user_001567,46,30k-50k,mobile,returning,West,55,False,0,0,0,False,True,True,118,1,0,7.339509435072337,-118,-1
user_001568,46,>150k,mobile,new,Midwest,62,True,187,3,0,True,True,True,157,1,0,9.600043155632621,30,2
user_001569,62,75k-100k,mobile,returning,West,58,True,106,3,0,False,True,True,90,2,0,5.065397817467111,16,1
user_001570,59,>150k,mobile,new,East,60,True,141,1,0,False,True,True,127,1,0,5.9243966531990475,14,0
user_001571,43,30k-50k,mobile,returning,East,67,True,85,3,0,True,True,True,71,2,0,9.540335405175766,14,1
user_001572,37,75k-100k,desktop,returning,East,61,True,120,1,0,True,False,True,135,1,0,6.113866995326921,-15,0
user_001573,51,50k-75k,mobile,returning,East,42,True,77,1,0,False,False,True,63,1,0,7.644210543383793,14,0
user_001574,43,>150k,mobile,returning,East,57,True,89,1,0,False,True,True,81,3,0,9.016471905657987,8,-2
user_001575,62,100k-150k,mobile,returning,East,67,True,95,5,1,True,False,True,79,1,0,5.221446880654024,16,4
user_001576,18,75k-100k,desktop,returning,West,69,True,44,4,0,False,True,True,20,5,0,6.944465165829517,24,-1
user_001577,44,30k-50k,desktop,returning,East,62,True,111,1,0,True,True,True,81,1,0,8.584899685853324,30,0
user_001578,18,75k-100k,desktop,returning,East,50,True,105,2,0,False,True,True,108,1,0,8.447274436602184,-3,1
user_001579,31,100k-150k,desktop,new,West,92,True,112,3,0,False,True,True,93,2,0,8.717234996213142,19,1
user_001580,62,75k-100k,mobile,returning,West,27,True,153,6,0,True,True,True,143,5,0,8.351167863907774,10,1
user_001581,58,50k-75k,tablet,returning,East,20,True,166,1,0,False,False,True,194,1,0,6.993999462018507,-28,0
user_001582,49,100k-150k,mobile,returning,East,92,True,69,4,0,False,True,True,28,2,0,6.24987036093867,41,2
user_001583,20,50k-75k,mobile,returning,West,85,False,0,0,0,True,True,True,106,1,0,8.6239565528259,-106,-1
user_001584,23,>150k,mobile,new,West,88,True,91,1,0,True,True,True,102,1,0,8.38318282382275,-11,0
user_001585,48,50k-75k,desktop,returning,Midwest,36,True,91,4,0,False,False,True,72,8,0,7.416934821761366,19,-4
user_001586,58,30k-50k,desktop,new,East,29,True,129,1,1,False,False,True,122,1,0,6.134908031222949,7,0
user_001587,42,<30k,desktop,new,Midwest,48,True,92,3,0,True,False,True,93,1,0,7.9475951045017466,-1,2
user_001588,71,50k-75k,desktop,returning,East,45,False,0,0,0,True,False,True,107,2,0,5.44520206902624,-107,-2
user_001589,36,<30k,desktop,returning,West,68,True,44,3,0,False,False,False,0,0,0,,44,3
user_001590,37,<30k,desktop,returning,South,51,True,90,1,0,False,True,True,107,1,1,8.110839873734221,-17,0
user_001591,18,75k-100k,desktop,returning,South,69,True,82,5,0,True,True,True,93,3,0,7.965598466140909,-11,2
user_001592,53,>150k,desktop,new,East,74,True,81,1,0,False,True,True,58,1,0,10.0,23,0
user_001593,43,75k-100k,desktop,new,South,46,True,158,6,1,False,False,True,134,5,0,4.761190837061154,24,1
user_001594,46,<30k,tablet,returning,South,49,True,96,3,0,True,True,True,59,1,0,7.6145372045149475,37,2
user_001595,78,75k-100k,desktop,new,Midwest,31,True,164,5,0,True,False,True,185,4,1,6.413767767320006,-21,1
user_001596,39,50k-75k,desktop,new,East,43,True,151,2,1,True,True,True,139,2,0,6.93042576313781,12,0
user_001597,28,>150k,mobile,new,Midwest,85,True,61,4,0,False,False,True,32,8,1,8.734641977659019,29,-4
user_001598,37,75k-100k,desktop,new,East,53,True,91,2,0,False,True,True,70,1,1,6.522854947926617,21,1
user_001599,20,50k-75k,desktop,new,East,84,True,75,1,0,False,True,True,25,2,0,8.242180487625932,50,-1
user_001600,38,75k-100k,desktop,new,South,77,False,0,0,0,False,True,True,72,2,0,7.075346333434394,-72,-2
user_001601,18,100k-150k,mobile,new,East,76,True,64,2,0,True,True,True,37,1,0,8.69884819495248,27,1
user_001602,58,75k-100k,desktop,returning,South,15,True,106,3,0,False,True,True,48,3,0,7.916922240832008,58,0
user_001603,42,50k-75k,desktop,returning,South,65,True,80,2,0,True,True,True,66,1,0,10.0,14,1
user_001604,80,30k-50k,mobile,new,East,45,False,0,0,0,True,False,True,107,1,0,8.490687961865163,-107,-1
user_001605,18,>150k,desktop,new,East,69,True,115,2,0,True,True,True,80,2,0,8.067925038607163,35,0
user_001606,40,75k-100k,desktop,returning,South,49,False,0,0,0,False,False,True,140,1,0,9.29670097035662,-140,-1
user_001607,18,75k-100k,mobile,new,West,77,True,71,2,0,False,True,True,20,2,0,6.488440920134468,51,0
user_001608,22,30k-50k,desktop,returning,West,95,True,81,1,0,False,True,True,72,2,1,9.80428123594413,9,-1
user_001609,28,30k-50k,mobile,new,West,85,True,97,2,0,True,True,True,84,1,0,8.067873343452964,13,1
user_001610,32,50k-75k,desktop,new,West,97,True,49,6,0,False,True,True,20,6,0,7.913123805764717,29,0
user_001611,29,75k-100k,mobile,returning,East,84,True,30,3,0,True,True,False,0,0,0,,30,3
user_001612,43,<30k,desktop,new,East,73,True,114,4,0,True,True,True,67,1,1,8.303964028265922,47,3
user_001613,74,75k-100k,desktop,returning,Midwest,35,True,104,2,1,False,False,True,120,2,0,5.971379902087707,-16,0
user_001614,34,100k-150k,mobile,returning,South,82,True,71,3,0,False,True,True,65,1,0,7.349274570794627,6,2
user_001615,23,100k-150k,mobile,returning,South,100,False,0,0,0,True,True,True,89,1,0,6.853570021756384,-89,-1
user_001616,48,30k-50k,mobile,returning,East,37,True,96,5,0,True,False,True,102,5,0,6.692311496109602,-6,0
user_001617,32,75k-100k,desktop,returning,East,62,True,67,1,0,True,False,True,65,1,0,8.076032399284724,2,0
user_001618,45,50k-75k,mobile,returning,Midwest,69,False,0,0,0,True,True,True,84,1,0,10.0,-84,-1
user_001619,42,<30k,desktop,new,South,31,True,123,4,0,False,False,True,96,6,0,7.424652022180961,27,-2
user_001620,47,<30k,desktop,returning,East,50,True,176,4,1,True,True,True,121,3,0,7.300171184756369,55,1
user_001621,47,75k-100k,desktop,new,East,47,True,130,2,0,False,False,True,104,3,0,5.57292836908655,26,-1
user_001622,18,50k-75k,tablet,returning,Midwest,69,False,0,0,0,True,True,True,99,1,0,8.758147267002022,-99,-1
user_001623,53,<30k,desktop,returning,West,69,True,95,1,0,True,False,True,78,1,0,6.9952872288412555,17,0
user_001624,77,50k-75k,mobile,returning,Midwest,44,False,0,0,0,False,True,True,145,1,1,6.984254220013344,-145,-1
user_001625,54,<30k,desktop,new,West,53,False,0,0,0,True,True,True,74,3,0,7.963312658789007,-74,-3
user_001626,53,50k-75k,mobile,returning,South,50,True,118,3,0,False,True,False,0,0,0,,118,3
user_001627,48,50k-75k,desktop,new,East,13,True,166,4,0,False,False,True,139,3,0,7.7421865890393535,27,1
user_001628,24,100k-150k,desktop,new,West,81,True,116,3,0,False,True,False,0,0,0,,116,3
user_001629,46,75k-100k,desktop,returning,Midwest,63,False,0,0,0,True,True,True,91,1,0,9.729780029223807,-91,-1
user_001630,36,30k-50k,desktop,returning,Midwest,26,True,134,1,0,True,True,True,123,1,0,7.725851188293597,11,0
user_001631,32,50k-75k,tablet,returning,South,78,True,30,4,1,False,True,True,22,4,0,9.326487771413994,8,0
user_001632,48,50k-75k,desktop,returning,South,62,True,59,1,0,True,True,True,34,1,0,7.525634718120598,25,0
user_001633,75,50k-75k,desktop,returning,East,9,True,143,5,0,False,False,True,136,9,0,7.666325255704365,7,-4
user_001634,29,50k-75k,mobile,returning,East,73,True,30,4,0,False,True,True,21,4,0,7.715516705626528,9,0
user_001635,44,<30k,mobile,returning,West,51,False,0,0,0,False,True,True,107,1,0,6.655706964917462,-107,-1
user_001636,49,30k-50k,mobile,new,South,59,True,166,6,0,False,False,True,185,11,0,5.010620012511053,-19,-5
user_001637,57,30k-50k,mobile,returning,South,16,True,141,7,0,False,False,True,121,4,0,6.750778675319625,20,3
user_001638,35,50k-75k,mobile,returning,West,71,True,93,1,0,True,True,True,65,1,0,8.058897596514887,28,0
user_001639,47,75k-100k,mobile,returning,West,62,True,94,1,0,True,True,True,46,2,1,5.792240973546046,48,-1
user_001640,41,>150k,desktop,returning,East,45,True,30,7,0,True,True,True,44,4,0,7.942397110171704,-14,3
user_001641,54,30k-50k,tablet,new,Midwest,78,True,102,3,0,True,False,True,90,4,0,7.68124287716421,12,-1
user_001642,31,75k-100k,mobile,returning,East,60,False,0,0,0,True,True,True,101,2,1,7.519657217105079,-101,-2
user_001643,60,<30k,mobile,returning,West,35,False,0,0,0,True,True,True,96,1,0,6.7823950588500255,-96,-1
user_001644,51,75k-100k,mobile,returning,East,33,True,121,1,0,True,True,True,96,1,0,7.935396770531325,25,0
user_001645,26,50k-75k,desktop,returning,Midwest,56,False,0,0,0,True,True,True,98,1,1,7.520608738936229,-98,-1
user_001646,52,75k-100k,desktop,new,West,51,True,128,7,1,False,True,True,102,5,1,9.37856747609028,26,2
user_001647,40,30k-50k,desktop,returning,Midwest,44,True,62,5,0,True,False,True,73,3,0,8.08874649547727,-11,2
user_001648,51,50k-75k,desktop,returning,Midwest,30,True,82,8,0,False,False,True,74,3,0,8.795820072066304,8,5
user_001649,43,30k-50k,desktop,new,Midwest,36,True,180,5,0,False,False,True,194,5,0,8.712919137269258,-14,0
user_001650,18,75k-100k,mobile,returning,Midwest,80,True,78,1,0,False,True,True,73,1,0,8.450491607256064,5,0
user_001651,24,50k-75k,desktop,returning,Midwest,60,False,0,0,0,False,False,True,118,2,0,7.121563294428441,-118,-2
user_001652,35,30k-50k,mobile,new,Midwest,53,True,77,1,0,False,True,True,102,1,0,8.800168057911824,-25,0
user_001653,38,>150k,desktop,returning,Midwest,63,True,102,2,0,True,True,True,56,2,0,7.80452666820784,46,0
user_001654,35,30k-50k,mobile,returning,East,66,True,98,5,0,True,True,True,110,3,0,9.601541588883492,-12,2
user_001655,18,100k-150k,mobile,new,East,69,False,0,0,0,True,True,False,0,0,0,,0,0
user_001656,31,75k-100k,mobile,returning,South,43,True,66,4,0,False,True,False,0,0,0,,66,4
user_001657,54,75k-100k,desktop,returning,South,70,True,130,1,0,False,True,True,131,1,0,7.214019576052563,-1,0
user_001658,34,100k-150k,desktop,new,East,84,True,144,1,0,True,True,True,145,1,0,10.0,-1,0
user_001659,46,>150k,mobile,returning,East,82,True,47,4,1,False,False,True,59,3,0,5.611489841701202,-12,1
user_001660,52,30k-50k,mobile,returning,East,50,True,68,3,0,False,True,True,41,4,0,8.143339264231756,27,-1
user_001661,43,50k-75k,desktop,returning,East,67,True,52,2,0,True,True,True,30,2,0,9.646841534361352,22,0
user_001662,58,100k-150k,mobile,new,South,48,True,127,4,0,False,True,True,72,2,0,7.129383389701145,55,2
user_001663,63,100k-150k,mobile,returning,East,57,True,36,1,0,False,True,True,60,2,1,9.22121310331799,-24,-1
user_001664,51,30k-50k,desktop,returning,West,78,True,63,2,0,False,True,False,0,0,0,,63,2
user_001665,18,100k-150k,mobile,new,East,91,True,80,3,0,True,False,True,58,1,0,7.192595189674117,22,2
user_001666,41,<30k,desktop,returning,East,48,False,0,0,0,True,True,True,86,1,0,6.937539642971204,-86,-1
user_001667,34,50k-75k,desktop,new,South,61,True,95,3,0,False,False,True,74,3,0,6.850404153238607,21,0
user_001668,43,50k-75k,desktop,returning,Midwest,42,True,103,2,0,True,True,True,74,2,0,7.582650645136807,29,0
user_001669,38,100k-150k,mobile,returning,West,90,True,76,1,0,True,True,True,41,2,0,9.042942860369621,35,-1
user_001670,39,75k-100k,mobile,new,West,48,True,115,1,0,True,False,True,124,1,0,6.74910425584191,-9,0
user_001671,23,50k-75k,desktop,returning,Midwest,91,True,71,3,0,False,True,True,78,5,1,10.0,-7,-2
user_001672,48,50k-75k,mobile,returning,West,57,True,86,4,0,True,True,True,91,1,0,8.824159544562697,-5,3
user_001673,22,100k-150k,mobile,new,East,95,True,120,6,0,False,True,True,74,6,0,8.848572623195201,46,0
user_001674,33,75k-100k,desktop,new,West,90,True,94,6,0,False,True,True,68,4,0,9.298465853633049,26,2
user_001675,39,100k-150k,mobile,returning,South,74,True,30,3,1,False,True,True,21,5,0,6.637529334016357,9,-2
user_001676,67,30k-50k,desktop,returning,West,62,True,81,2,0,True,True,True,46,2,1,6.828553909215506,35,0
user_001677,52,30k-50k,mobile,new,Midwest,35,True,150,5,0,False,False,True,133,7,1,7.665476839263887,17,-2
user_001678,69,30k-50k,mobile,returning,South,18,True,196,3,0,False,False,True,217,3,0,5.159393903354212,-21,0
user_001679,18,50k-75k,desktop,new,East,66,True,126,1,0,False,True,True,81,1,0,6.824313785397307,45,0
user_001680,28,100k-150k,mobile,new,Midwest,88,True,60,7,1,True,True,True,102,4,0,6.670812516096387,-42,3
user_001681,39,50k-75k,desktop,new,Midwest,69,True,133,3,0,True,False,True,130,2,1,10.0,3,1
user_001682,56,100k-150k,desktop,returning,Midwest,69,True,62,1,0,True,True,True,66,1,0,10.0,-4,0
user_001683,50,100k-150k,mobile,new,West,86,True,78,3,0,False,True,True,43,3,0,10.0,35,0
user_001684,39,75k-100k,desktop,returning,East,63,True,63,2,0,False,True,True,41,1,0,9.90030402327087,22,1
user_001685,28,100k-150k,desktop,new,Midwest,81,True,150,3,0,False,True,True,122,4,0,8.966507423291553,28,-1
user_001686,58,50k-75k,mobile,new,South,34,False,0,0,0,True,True,True,106,1,0,9.533444628424586,-106,-1
user_001687,52,75k-100k,mobile,returning,Midwest,48,True,112,3,0,False,True,True,79,1,0,6.93597400483139,33,2
user_001688,44,50k-75k,tablet,returning,West,73,True,90,2,0,True,True,True,58,4,0,7.389821820779317,32,-2
user_001689,68,50k-75k,desktop,new,East,26,True,129,6,1,True,False,False,0,0,0,,129,6
user_001690,71,75k-100k,desktop,returning,East,44,True,110,4,0,False,True,True,106,3,0,7.187425535880832,4,1
user_001691,43,100k-150k,desktop,returning,Midwest,53,True,37,1,0,False,False,True,48,1,0,5.113340958943205,-11,0
user_001692,61,50k-75k,mobile,new,West,53,True,141,3,0,False,False,True,163,1,0,7.207614371760765,-22,2
user_001693,52,>150k,mobile,returning,South,47,True,127,2,0,False,True,True,130,1,0,8.824399554786144,-3,1
user_001694,42,75k-100k,mobile,returning,South,39,True,76,3,0,False,False,True,77,2,0,6.676348868620437,-1,1
user_001695,38,50k-75k,desktop,new,South,43,True,125,4,0,False,True,True,133,4,0,7.834314985211789,-8,0
user_001696,48,30k-50k,desktop,returning,East,46,True,63,2,0,False,False,True,85,2,0,7.8070984656006726,-22,0
user_001697,33,>150k,mobile,returning,Midwest,100,True,30,3,0,True,True,True,20,2,0,8.077331067203717,10,1
user_001698,43,100k-150k,desktop,returning,Midwest,55,True,100,3,0,True,True,True,82,2,0,7.444542642162381,18,1
user_001699,54,50k-75k,mobile,returning,South,39,True,35,5,0,True,True,True,20,3,0,7.734287008683858,15,2
user_001700,47,75k-100k,mobile,returning,West,81,True,70,1,0,False,True,True,50,1,0,8.292469720587048,20,0
user_001701,44,30k-50k,desktop,returning,West,53,True,87,3,0,True,True,True,71,2,0,7.429673664186505,16,1
user_001702,39,50k-75k,desktop,returning,East,73,True,72,6,0,True,True,True,72,5,0,8.714609893810332,0,1
user_001703,39,75k-100k,mobile,returning,Midwest,62,True,98,5,0,False,True,True,60,3,0,9.914868503040767,38,2
user_001704,62,50k-75k,desktop,returning,East,17,True,101,2,0,False,True,True,94,1,0,8.413403484531512,7,1
user_001705,55,50k-75k,mobile,new,South,34,True,116,5,0,False,False,True,118,4,0,8.649544171263091,-2,1
user_001706,45,<30k,desktop,returning,East,35,True,58,4,0,False,True,True,69,2,1,7.555894900637295,-11,2
user_001707,63,50k-75k,mobile,returning,East,52,False,0,0,0,False,True,True,99,1,0,7.511094888245718,-99,-1
user_001708,51,30k-50k,mobile,returning,South,14,False,0,0,0,True,True,True,131,1,0,6.68197978491881,-131,-1
user_001709,52,<30k,mobile,returning,West,61,True,83,5,0,True,False,True,71,2,0,7.97473325893455,12,3
user_001710,49,100k-150k,desktop,returning,Midwest,60,True,78,1,1,False,False,True,109,2,0,6.116063621341036,-31,-1
user_001711,50,75k-100k,mobile,returning,South,65,False,0,0,0,True,True,True,73,1,0,8.561605642619714,-73,-1
user_001712,58,75k-100k,tablet,new,Midwest,9,True,145,2,1,True,True,True,145,1,0,4.116239944161458,0,1
user_001713,39,75k-100k,mobile,new,Midwest,35,True,91,3,0,False,False,True,94,2,1,6.544272364389792,-3,1
user_001714,36,100k-150k,mobile,returning,South,39,True,73,3,0,True,True,True,85,1,0,8.142940610697298,-12,2
user_001715,34,75k-100k,desktop,returning,South,75,True,89,3,0,True,True,True,32,1,0,8.76673043746073,57,2
user_001716,39,<30k,mobile,new,Midwest,36,False,0,0,0,False,False,False,0,0,0,,0,0
user_001717,20,100k-150k,mobile,returning,Midwest,49,False,0,0,0,False,True,True,102,1,0,8.380350969222517,-102,-1
user_001718,20,<30k,mobile,returning,South,27,True,148,4,1,True,True,True,104,5,0,5.185444136788006,44,-1
user_001719,52,75k-100k,desktop,new,East,69,True,91,2,0,True,True,True,89,1,0,7.353688270418271,2,1
user_001720,60,<30k,desktop,new,East,26,True,151,3,0,False,False,True,153,3,0,8.337274772597178,-2,0
user_001721,40,50k-75k,mobile,new,South,26,True,151,4,0,True,False,True,146,3,0,8.561096471564355,5,1
user_001722,59,30k-50k,desktop,returning,East,29,True,129,3,0,False,False,True,99,3,0,8.1390507546303,30,0
user_001723,50,50k-75k,desktop,returning,South,43,True,133,2,1,True,True,True,88,1,0,5.055973737213382,45,1
user_001724,30,<30k,mobile,returning,East,43,True,63,6,0,True,False,False,0,0,0,,63,6
user_001725,29,75k-100k,mobile,returning,South,74,True,73,2,0,True,True,True,65,3,0,8.433888866062738,8,-1
user_001726,30,100k-150k,mobile,new,West,97,True,137,1,1,True,True,True,114,1,0,8.407393470844736,23,0
user_001727,53,<30k,mobile,new,Midwest,45,True,113,4,0,False,True,False,0,0,0,,113,4
user_001728,41,30k-50k,mobile,returning,West,64,True,133,1,1,False,True,True,128,1,0,5.4815556598966095,5,0
user_001729,19,100k-150k,mobile,returning,Midwest,92,True,41,4,0,False,True,False,0,0,0,,41,4
user_001730,28,50k-75k,desktop,new,West,78,True,138,1,0,False,True,True,81,1,0,7.710667822616776,57,0
user_001731,29,75k-100k,mobile,returning,West,81,True,44,5,0,False,True,True,30,3,0,8.008742493861481,14,2
user_001732,39,<30k,mobile,returning,West,52,True,79,4,0,False,True,True,78,4,0,6.835191197532178,1,0
user_001733,30,<30k,desktop,returning,South,88,True,93,2,0,True,True,True,80,2,0,8.213503185477318,13,0
user_001734,42,50k-75k,desktop,returning,Midwest,50,True,65,3,0,True,False,True,67,5,0,7.186472857062741,-2,-2
user_001735,42,50k-75k,mobile,returning,West,62,True,121,5,1,True,True,True,84,6,0,7.761936461953315,37,-1
user_001736,30,100k-150k,desktop,new,Midwest,71,True,90,2,0,False,True,True,82,1,0,8.807674612893234,8,1
user_001737,59,100k-150k,mobile,returning,West,55,True,91,3,1,False,False,True,63,4,1,5.26975354361335,28,-1
user_001738,48,50k-75k,tablet,returning,West,56,True,71,3,0,False,True,True,56,2,0,6.058446730345823,15,1
user_001739,39,50k-75k,mobile,new,Midwest,49,False,0,0,0,False,True,True,75,1,0,8.822585862197045,-75,-1
user_001740,39,<30k,desktop,returning,Midwest,57,True,76,2,0,False,True,True,68,1,0,6.612726348817901,8,1
user_001741,49,75k-100k,mobile,new,Midwest,44,True,146,1,0,True,False,True,143,1,0,7.8379384104749565,3,0
user_001742,40,30k-50k,desktop,returning,West,80,True,107,1,1,True,False,True,115,4,1,6.100736974674941,-8,-3
user_001743,34,100k-150k,desktop,returning,East,75,True,99,1,0,True,True,True,93,1,0,8.521566296421742,6,0
user_001744,42,50k-75k,desktop,returning,Midwest,17,True,121,1,0,True,False,True,104,1,0,8.835936324837197,17,0
user_001745,62,<30k,desktop,returning,East,48,False,0,0,0,False,True,True,68,1,0,8.886665576125122,-68,-1
user_001746,52,75k-100k,mobile,returning,Midwest,15,True,147,4,0,False,False,True,115,2,0,8.039944028423042,32,2
user_001747,49,<30k,desktop,returning,East,57,False,0,0,0,False,False,True,105,1,0,7.477047144073024,-105,-1
user_001748,41,30k-50k,desktop,returning,East,35,True,53,2,0,True,True,True,58,1,0,7.7860985033053565,-5,1
user_001749,42,<30k,mobile,returning,East,49,True,131,3,0,False,False,True,116,3,0,6.450464393713139,15,0
user_001750,45,75k-100k,desktop,returning,East,60,True,30,3,0,True,True,True,28,3,0,7.703902863470388,2,0
user_001751,44,100k-150k,mobile,new,Midwest,56,False,0,0,0,False,True,True,95,1,0,7.770929978495998,-95,-1
user_001752,45,30k-50k,desktop,returning,East,70,True,99,1,0,False,False,True,105,1,0,5.087481245173622,-6,0
user_001753,51,50k-75k,desktop,returning,South,17,True,145,2,0,True,False,True,161,1,0,7.711807226346521,-16,1
user_001754,42,30k-50k,mobile,returning,South,58,True,103,4,1,False,True,True,106,5,0,7.51510752140669,-3,-1
user_001755,43,<30k,desktop,new,Midwest,29,True,179,4,0,False,False,True,212,7,0,7.636718079409779,-33,-3
user_001756,42,>150k,mobile,returning,East,63,True,81,5,0,False,False,True,94,4,0,5.8988561992094315,-13,1
user_001757,51,75k-100k,mobile,returning,West,48,True,131,4,0,False,False,True,115,6,1,6.225730163539202,16,-2
user_001758,31,30k-50k,desktop,new,West,88,True,124,1,0,True,True,True,96,1,0,6.752971775090559,28,0
user_001759,21,75k-100k,desktop,new,South,87,True,123,2,0,True,True,True,89,1,0,9.551178231124638,34,1
user_001760,29,50k-75k,desktop,new,East,44,True,154,1,0,True,False,True,142,1,1,7.2528411920768985,12,0
user_001761,65,75k-100k,desktop,returning,East,28,True,120,4,0,True,False,True,130,5,1,9.305384983336726,-10,-1
user_001762,55,50k-75k,desktop,new,East,44,True,107,4,0,True,False,False,0,0,0,,107,4
user_001763,26,75k-100k,mobile,returning,South,46,True,71,2,0,True,True,True,34,2,0,6.077443449673799,37,0
user_001764,55,<30k,desktop,returning,East,60,True,78,4,0,False,False,True,82,3,0,7.815953597391226,-4,1
user_001765,67,50k-75k,mobile,returning,South,36,True,72,3,0,True,True,True,54,3,0,9.594662038920815,18,0
user_001766,60,<30k,desktop,returning,Midwest,15,True,192,10,0,False,False,False,0,0,0,,192,10
user_001767,43,100k-150k,desktop,returning,Midwest,80,True,53,1,0,False,True,True,55,3,0,7.405427789241168,-2,-2
user_001768,54,50k-75k,mobile,returning,South,45,True,99,1,0,False,True,True,55,1,0,8.905155102031292,44,0
user_001769,63,30k-50k,desktop,returning,Midwest,60,True,106,4,0,False,False,True,89,4,0,6.80629132199076,17,0
user_001770,22,100k-150k,desktop,new,South,72,False,0,0,0,True,True,False,0,0,0,,0,0
user_001771,44,100k-150k,mobile,returning,East,62,True,116,3,0,True,True,True,84,1,0,10.0,32,2
user_001772,41,<30k,desktop,new,East,32,True,107,5,0,True,False,False,0,0,0,,107,5
user_001773,59,75k-100k,mobile,returning,South,38,True,69,4,0,True,True,True,78,6,0,6.375896237771147,-9,-2
user_001774,65,<30k,mobile,returning,Midwest,37,True,62,5,0,False,True,True,31,5,0,8.813047904429805,31,0
user_001775,59,50k-75k,mobile,returning,Midwest,29,True,177,2,1,True,False,True,167,1,0,6.053792192751437,10,1
user_001776,28,30k-50k,mobile,returning,South,65,True,111,1,0,True,True,True,75,1,0,8.157272804335415,36,0
user_001777,63,30k-50k,desktop,returning,South,21,False,0,0,0,True,False,True,131,1,0,8.716049778716062,-131,-1
user_001778,41,50k-75k,mobile,new,East,55,True,108,2,1,False,True,True,62,1,0,6.262040173617974,46,1
user_001779,42,30k-50k,tablet,new,South,44,True,108,3,1,False,False,True,119,4,2,5.376484613672626,-11,-1
user_001780,43,100k-150k,mobile,returning,East,89,True,87,3,0,False,True,True,39,6,0,9.798576954719145,48,-3
user_001781,54,30k-50k,mobile,returning,South,50,True,61,2,0,True,True,True,58,1,0,6.893081224172623,3,1
user_001782,18,30k-50k,mobile,returning,Midwest,58,True,109,5,0,False,True,True,71,4,0,7.964433611591365,38,1
user_001783,37,>150k,desktop,returning,Midwest,55,True,75,2,0,False,False,True,55,2,0,8.694231946237071,20,0
user_001784,60,50k-75k,mobile,new,South,2,True,137,6,0,False,False,True,142,10,0,6.602846780695229,-5,-4
user_001785,23,<30k,mobile,returning,Midwest,41,True,153,3,0,True,True,True,113,3,0,7.642566569363613,40,0
user_001786,35,100k-150k,tablet,returning,South,78,True,40,2,0,True,True,True,56,3,0,7.408973068883494,-16,-1
user_001787,31,50k-75k,desktop,returning,West,73,True,101,5,1,False,False,True,119,3,0,9.077502771148676,-18,2
user_001788,59,30k-50k,desktop,new,West,22,True,146,3,0,True,False,True,154,5,1,6.977752002728748,-8,-2
user_001789,18,50k-75k,mobile,new,West,80,True,103,1,0,False,True,True,73,2,0,6.615391977737605,30,-1
user_001790,62,100k-150k,desktop,new,Midwest,25,True,140,6,0,False,False,True,94,2,0,7.254031850081842,46,4
user_001791,32,30k-50k,desktop,returning,South,46,True,53,2,0,True,True,True,42,1,0,8.588310183839916,11,1
user_001792,44,50k-75k,desktop,returning,West,43,True,65,5,1,False,False,True,82,2,0,4.512044000316676,-17,3
user_001793,64,<30k,mobile,new,Midwest,0,True,149,4,1,True,True,True,99,1,0,7.654355315570317,50,3
user_001794,38,100k-150k,mobile,returning,East,45,True,106,2,0,False,False,True,64,2,1,7.906259358499814,42,0
user_001795,80,<30k,desktop,new,East,21,True,212,1,0,True,False,False,0,0,0,,212,1
user_001796,31,50k-75k,mobile,new,Midwest,75,True,126,3,0,False,True,True,75,3,0,6.4889136876304665,51,0
user_001797,67,30k-50k,desktop,returning,Midwest,49,True,53,3,0,True,False,True,71,1,1,7.846079229167462,-18,2
user_001798,38,75k-100k,mobile,new,East,55,True,112,2,0,False,False,True,89,3,0,6.488534557019391,23,-1
user_001799,62,<30k,mobile,new,West,36,True,152,1,0,False,True,True,135,1,1,6.517630112131521,17,0
user_001800,51,75k-100k,mobile,returning,East,55,True,105,5,0,True,True,False,0,0,0,,105,5
user_001801,21,100k-150k,desktop,returning,West,100,False,0,0,0,False,True,True,133,1,0,7.7603144706429905,-133,-1
user_001802,33,50k-75k,desktop,new,West,69,True,77,4,0,True,True,True,67,4,0,9.151956718408051,10,0
user_001803,51,>150k,mobile,new,East,77,True,57,4,0,False,True,True,69,1,0,8.720986120427504,-12,3
user_001804,57,30k-50k,desktop,returning,Midwest,35,True,54,2,0,True,True,True,41,1,0,9.014372395255341,13,1
user_001805,61,100k-150k,desktop,returning,Midwest,43,True,81,3,0,False,False,True,55,2,0,8.80189784245171,26,1
user_001806,38,30k-50k,desktop,new,East,33,True,82,2,0,True,True,True,73,1,0,6.820926872868724,9,1
user_001807,38,50k-75k,tablet,returning,West,53,False,0,0,0,True,True,True,131,1,0,6.668333516018093,-131,-1
user_001808,33,30k-50k,desktop,returning,West,96,False,0,0,0,False,True,True,95,1,0,8.111964138704092,-95,-1
user_001809,36,100k-150k,desktop,returning,South,73,True,95,1,0,True,True,True,68,1,0,7.177311229760716,27,0
user_001810,65,30k-50k,desktop,new,West,41,True,155,3,0,False,False,True,204,1,0,5.643183108070148,-49,2
user_001811,65,75k-100k,desktop,returning,West,51,True,110,2,1,True,True,True,91,8,0,7.584231445360288,19,-6
user_001812,49,<30k,mobile,new,Midwest,46,True,166,2,0,True,True,True,147,2,0,7.105261330682153,19,0
user_001813,54,>150k,mobile,returning,South,55,True,109,4,0,True,True,True,106,3,0,5.773458918532019,3,1
user_001814,18,100k-150k,desktop,returning,West,100,True,30,1,1,False,False,True,21,1,0,5.974626285196544,9,0
user_001815,39,75k-100k,desktop,returning,West,64,True,138,2,0,False,True,True,125,2,0,8.935060615697724,13,0
user_001816,44,<30k,mobile,returning,Midwest,37,False,0,0,0,False,False,False,0,0,0,,0,0
user_001817,40,30k-50k,desktop,returning,South,65,True,113,2,0,False,True,True,89,2,0,9.252505086221499,24,0
user_001818,36,75k-100k,desktop,returning,West,64,True,113,1,0,True,True,True,92,1,0,9.491949369872595,21,0
user_001819,39,30k-50k,mobile,returning,East,52,True,132,1,1,True,False,False,0,0,0,,132,1
user_001820,34,<30k,desktop,new,East,65,True,97,5,0,False,True,True,97,4,0,9.453783903808533,0,1
user_001821,60,<30k,tablet,returning,East,37,True,41,4,0,True,True,True,83,3,0,8.532492576425144,-42,1
user_001822,47,75k-100k,desktop,returning,West,70,False,0,0,0,True,True,True,64,1,0,9.85236583608661,-64,-1
user_001823,54,30k-50k,desktop,returning,South,37,True,96,1,0,False,False,True,122,1,0,5.74494306551008,-26,0
user_001824,55,100k-150k,mobile,new,South,54,True,176,1,0,False,True,True,131,1,0,7.243254648619351,45,0
user_001825,54,<30k,mobile,returning,West,77,True,51,2,0,True,True,True,61,1,0,9.30637666799833,-10,1
user_001826,39,<30k,mobile,returning,West,70,True,137,1,0,True,True,True,83,1,0,9.244818105019817,54,0
user_001827,53,<30k,desktop,new,West,43,False,0,0,0,True,False,True,124,1,0,7.94104904484792,-124,-1
user_001828,71,100k-150k,desktop,new,East,55,True,126,2,0,False,False,True,115,1,0,8.171455492956605,11,1
user_001829,49,>150k,mobile,new,Midwest,64,True,122,4,0,True,True,True,90,3,0,8.946689930950022,32,1
user_001830,30,75k-100k,tablet,returning,South,55,True,113,1,0,False,True,True,75,1,0,7.98722827968875,38,0
user_001831,57,50k-75k,desktop,returning,West,32,True,110,6,1,False,True,True,52,4,1,8.727758907735662,58,2
user_001832,46,<30k,mobile,returning,Midwest,33,True,80,1,0,True,False,True,75,1,0,5.912472332306014,5,0
user_001833,30,50k-75k,desktop,returning,East,71,True,111,1,0,True,True,True,79,1,0,8.606473761031326,32,0
user_001834,39,50k-75k,desktop,new,West,71,True,127,4,0,True,True,True,111,3,0,9.080216903825564,16,1
user_001835,56,100k-150k,mobile,returning,West,49,True,99,3,1,False,True,True,87,3,0,9.110968622320684,12,0
user_001836,50,50k-75k,desktop,returning,South,44,True,69,1,1,False,True,True,67,3,0,9.366015288528557,2,-2
user_001837,53,>150k,mobile,returning,South,41,True,104,3,0,False,True,True,91,2,0,7.0838403428142405,13,1
user_001838,66,<30k,desktop,new,West,7,True,158,8,0,True,False,True,142,8,0,6.4881494198830225,16,0
user_001839,51,100k-150k,tablet,returning,West,98,True,30,2,0,True,True,True,40,1,0,7.234023149884561,-10,1
user_001840,49,50k-75k,mobile,returning,East,73,True,125,1,0,False,True,True,90,2,0,6.6335047263079705,35,-1
user_001841,23,100k-150k,desktop,new,South,84,True,100,1,0,True,True,True,97,2,0,8.957810772865098,3,-1
user_001842,37,75k-100k,mobile,returning,East,54,True,100,4,0,False,False,True,101,2,0,8.467975596868058,-1,2
user_001843,31,50k-75k,tablet,returning,West,61,True,60,3,0,False,False,False,0,0,0,,60,3
user_001844,40,75k-100k,desktop,returning,East,69,True,118,2,1,True,True,True,48,1,0,10.0,70,1
user_001845,72,<30k,desktop,returning,South,34,False,0,0,0,False,False,True,173,1,0,7.680775620342427,-173,-1
user_001846,38,100k-150k,mobile,new,South,72,True,72,2,0,False,True,False,0,0,0,,72,2
user_001847,59,50k-75k,mobile,new,South,26,True,189,3,0,False,False,True,200,3,0,8.207132375759171,-11,0
user_001848,72,30k-50k,desktop,new,South,47,False,0,0,0,False,False,True,117,1,1,7.63318659004969,-117,-1
user_001849,60,<30k,mobile,new,East,54,True,118,1,0,False,True,True,107,1,0,8.920045535284212,11,0
user_001850,27,75k-100k,desktop,new,West,86,True,49,5,0,False,True,True,66,3,0,7.9299983245673324,-17,2
user_001851,22,30k-50k,desktop,returning,Midwest,56,True,105,1,0,True,True,True,78,2,0,8.496782754714793,27,-1
user_001852,33,>150k,desktop,new,South,95,True,51,2,0,True,True,True,20,3,0,9.5526506898281,31,-1
user_001853,56,50k-75k,mobile,new,Midwest,21,True,148,6,0,False,False,True,161,6,1,8.269558165714315,-13,0
user_001854,55,>150k,mobile,returning,South,71,True,30,4,0,True,True,True,55,2,0,8.116648400685538,-25,2
user_001855,53,30k-50k,desktop,returning,South,41,True,80,5,0,False,False,True,109,10,0,8.19478393500123,-29,-5
user_001856,22,30k-50k,tablet,returning,East,81,True,72,3,0,False,True,False,0,0,0,,72,3
user_001857,53,30k-50k,mobile,new,East,70,True,129,4,0,False,False,True,107,4,0,7.3724140185553475,22,0
user_001858,30,<30k,desktop,returning,South,62,True,113,4,0,True,True,True,98,2,0,9.552605227500448,15,2
user_001859,39,50k-75k,desktop,new,West,51,False,0,0,0,False,True,True,79,1,0,6.55962559905343,-79,-1
user_001860,20,50k-75k,desktop,new,Midwest,76,True,65,1,0,False,True,False,0,0,0,,65,1
user_001861,66,<30k,mobile,returning,West,13,False,0,0,0,True,False,True,154,1,0,7.340771201905224,-154,-1
user_001862,51,50k-75k,mobile,new,Midwest,53,True,125,3,0,False,True,True,75,3,0,7.841576671360723,50,0
user_001863,63,50k-75k,mobile,returning,South,47,True,105,2,0,True,False,True,116,1,1,7.482339688867108,-11,1
user_001864,53,<30k,desktop,returning,West,45,True,61,3,0,True,False,True,70,3,0,6.816548681532305,-9,0
user_001865,57,50k-75k,mobile,new,Midwest,52,True,133,3,0,False,False,True,119,1,0,5.7948603106086995,14,2
user_001866,46,50k-75k,mobile,returning,West,69,False,0,0,0,True,True,True,99,1,0,8.758068788114564,-99,-1
user_001867,60,30k-50k,mobile,returning,West,27,False,0,0,0,False,False,False,0,0,0,,0,0
user_001868,47,30k-50k,desktop,new,South,58,True,98,2,0,True,True,True,46,1,0,6.339549594723856,52,1
user_001869,32,50k-75k,mobile,returning,East,100,True,69,1,0,True,False,True,92,1,0,8.978160223201373,-23,0
user_001870,43,50k-75k,desktop,new,East,28,True,131,2,1,True,True,True,76,2,0,8.12452299363552,55,0
user_001871,19,75k-100k,desktop,new,West,85,True,129,4,0,False,True,True,99,3,0,7.96285003020826,30,1
user_001872,52,75k-100k,tablet,new,West,59,True,112,3,1,False,True,True,114,2,0,7.6276357978590275,-2,1
user_001873,61,75k-100k,desktop,new,South,40,True,84,3,0,True,False,True,75,3,0,9.520353871251176,9,0
user_001874,54,75k-100k,desktop,returning,Midwest,17,True,96,5,0,True,True,True,50,4,0,9.127795501744451,46,1
user_001875,39,50k-75k,desktop,returning,East,53,True,108,3,0,False,False,True,107,2,0,6.651185132546453,1,1
user_001876,31,75k-100k,mobile,new,East,74,True,111,1,0,False,True,True,91,1,1,8.762197838331081,20,0
user_001877,29,100k-150k,mobile,returning,Midwest,55,True,50,3,0,True,True,True,25,1,0,6.649301912928907,25,2
user_001878,49,75k-100k,desktop,returning,East,49,True,54,3,1,False,True,True,30,1,0,8.12009571874512,24,2
user_001879,33,30k-50k,mobile,new,South,79,True,122,1,0,True,True,True,114,1,0,7.700156401592561,8,0
user_001880,44,<30k,mobile,returning,East,44,True,68,2,0,True,True,True,47,2,0,8.485714920117593,21,0
user_001881,41,30k-50k,desktop,returning,Midwest,33,True,105,9,0,False,True,True,93,8,0,8.168458806813952,12,1
user_001882,41,100k-150k,desktop,new,Midwest,66,True,101,2,0,True,True,True,56,1,0,6.160453451303493,45,1
user_001883,68,50k-75k,tablet,new,Midwest,44,True,95,2,0,True,False,True,106,1,0,7.549899032649498,-11,1
user_001884,25,50k-75k,mobile,returning,West,75,True,101,4,0,False,True,True,76,2,0,7.231650334903757,25,2
user_001885,48,<30k,tablet,returning,South,19,True,157,2,0,True,False,True,188,1,0,6.940416351554664,-31,1
user_001886,46,30k-50k,desktop,returning,West,60,True,106,1,0,False,True,True,70,1,0,9.061060605172727,36,0
user_001887,45,100k-150k,tablet,new,West,54,True,173,3,0,False,True,True,148,2,0,6.869962848698867,25,1
user_001888,64,75k-100k,mobile,returning,East,16,True,123,5,0,False,False,True,92,4,0,7.329744204514006,31,1
user_001889,58,50k-75k,desktop,new,South,36,False,0,0,0,False,True,True,84,1,0,6.7757910916575295,-84,-1
user_001890,53,30k-50k,mobile,returning,West,69,True,98,1,0,True,False,True,131,1,0,6.641942642643817,-33,0
user_001891,37,<30k,desktop,returning,East,42,True,83,3,0,False,False,True,81,2,1,6.924949290089464,2,1
user_001892,56,75k-100k,mobile,returning,East,27,True,132,4,1,False,False,True,128,4,0,7.017277402953905,4,0
user_001893,47,<30k,mobile,returning,East,44,True,56,5,0,False,False,True,49,6,0,5.685432684253978,7,-1
user_001894,55,<30k,desktop,returning,South,8,False,0,0,0,True,True,True,116,1,0,9.2719499176092,-116,-1
user_001895,40,50k-75k,desktop,returning,West,83,True,70,3,0,True,True,True,44,2,0,8.530690251347444,26,1
user_001896,57,>150k,mobile,returning,South,50,True,137,2,0,True,False,True,178,4,0,7.490903839006822,-41,-2
user_001897,21,100k-150k,mobile,returning,West,98,False,0,0,0,True,True,True,91,1,0,7.158212232089442,-91,-1
user_001898,57,75k-100k,desktop,returning,East,40,True,58,4,0,False,True,True,36,3,0,6.771714967794776,22,1
user_001899,47,30k-50k,tablet,new,West,45,False,0,0,0,False,True,True,126,1,0,6.667052979612438,-126,-1
user_001900,43,75k-100k,mobile,returning,East,32,True,68,2,0,False,False,True,71,1,0,6.300225248723302,-3,1
user_001901,57,75k-100k,desktop,returning,Midwest,10,True,124,4,0,False,False,True,128,8,0,6.330960749239974,-4,-4
user_001902,18,>150k,mobile,returning,Midwest,76,True,83,4,0,True,True,True,56,2,0,8.776406748374251,27,2
user_001903,43,30k-50k,mobile,returning,Midwest,48,True,140,5,0,True,True,True,78,4,0,7.94092939118217,62,1
user_001904,28,<30k,mobile,returning,South,71,False,0,0,0,True,True,True,69,1,0,8.159704638525088,-69,-1
user_001905,32,100k-150k,desktop,new,South,73,True,113,2,0,True,True,True,84,3,0,8.270737846172132,29,-1
user_001906,52,30k-50k,desktop,returning,East,40,True,100,1,0,True,True,True,77,1,0,8.881796295378802,23,0
user_001907,38,>150k,desktop,new,West,69,True,144,8,0,False,False,True,136,9,0,8.604794574793846,8,-1
user_001908,30,50k-75k,desktop,returning,Midwest,46,False,0,0,0,False,True,True,68,1,0,7.379022629682162,-68,-1
user_001909,38,75k-100k,mobile,new,East,46,True,179,2,0,True,True,True,153,1,0,8.161567886149705,26,1
user_001910,32,100k-150k,desktop,new,West,100,True,160,5,0,False,True,True,157,2,0,8.083078280146447,3,3
user_001911,36,50k-75k,mobile,new,South,53,True,157,4,0,False,True,True,103,2,0,7.517017718169112,54,2
user_001912,53,30k-50k,mobile,new,South,75,True,112,4,0,False,False,True,121,4,0,7.786078599183717,-9,0
user_001913,52,75k-100k,desktop,returning,West,43,True,93,4,0,False,False,False,0,0,0,,93,4
user_001914,50,50k-75k,tablet,returning,South,40,True,113,5,0,True,True,True,111,3,0,8.735631639657763,2,2
user_001915,40,30k-50k,tablet,new,East,70,False,0,0,0,False,True,True,66,1,0,8.260979789129626,-66,-1
user_001916,28,50k-75k,tablet,returning,Midwest,90,True,52,2,0,False,True,True,20,2,0,7.643769556654335,32,0
user_001917,27,<30k,desktop,new,West,76,True,102,4,0,False,True,True,30,5,0,8.712276209149955,72,-1
user_001918,48,30k-50k,desktop,new,East,33,True,96,3,0,False,False,True,99,3,1,5.458092399529402,-3,0
user_001919,42,75k-100k,desktop,new,West,48,True,124,1,0,False,True,True,90,1,1,8.469721213993115,34,0
user_001920,69,100k-150k,mobile,new,West,74,True,91,2,0,True,True,True,40,2,0,8.117581054330945,51,0
user_001921,59,75k-100k,desktop,returning,West,26,True,138,4,0,False,False,True,136,4,0,7.425937666391933,2,0
user_001922,48,75k-100k,desktop,returning,Midwest,59,True,80,1,0,True,True,False,0,0,0,,80,1
user_001923,64,75k-100k,mobile,returning,South,21,True,126,1,0,True,False,True,145,1,0,5.20390520292798,-19,0
user_001924,19,75k-100k,mobile,returning,West,95,False,0,0,0,True,True,True,107,1,0,8.42551190727868,-107,-1
user_001925,55,<30k,desktop,returning,West,58,True,69,1,1,False,False,True,98,1,0,7.871728726122852,-29,0
user_001926,45,30k-50k,mobile,new,South,46,True,113,1,0,True,False,True,119,1,0,8.24283393190371,-6,0
user_001927,36,100k-150k,desktop,returning,East,92,True,37,2,0,True,True,True,25,1,0,10.0,12,1
user_001928,18,50k-75k,desktop,new,East,60,True,91,3,0,False,True,True,111,4,0,8.007089371377088,-20,-1
user_001929,31,100k-150k,desktop,returning,South,65,True,82,1,0,False,True,True,93,1,0,8.271732265461786,-11,0
user_001930,50,100k-150k,desktop,new,West,59,False,0,0,0,True,False,True,128,1,0,7.500875127639265,-128,-1
user_001931,28,75k-100k,desktop,returning,West,68,True,84,2,0,True,True,True,36,3,0,7.814562766087754,48,-1
user_001932,37,50k-75k,desktop,returning,Midwest,44,True,77,1,1,False,False,True,75,1,0,6.865169968547632,2,0
user_001933,57,<30k,desktop,returning,West,44,False,0,0,0,True,False,True,100,2,0,9.750209097161951,-100,-2
user_001934,29,50k-75k,desktop,returning,Midwest,38,True,61,4,0,False,True,True,28,1,0,8.417172305745833,33,3
user_001935,27,30k-50k,mobile,returning,South,59,False,0,0,0,False,True,True,78,1,0,6.377761326726956,-78,-1
user_001936,66,30k-50k,desktop,new,West,47,False,0,0,0,False,False,True,134,1,0,7.07411829249628,-134,-1
user_001937,18,30k-50k,desktop,returning,Midwest,54,False,0,0,0,False,False,False,0,0,0,,0,0
user_001938,36,100k-150k,desktop,new,West,76,True,128,2,0,True,True,True,120,2,0,10.0,8,0
user_001939,32,30k-50k,desktop,new,South,77,True,62,2,1,False,False,True,49,3,0,7.723840410797065,13,-1
user_001940,57,75k-100k,desktop,returning,West,45,True,122,2,1,False,False,True,121,1,0,7.07448045890629,1,1
user_001941,68,75k-100k,mobile,returning,East,44,False,0,0,0,False,False,True,168,2,0,7.412546766352771,-168,-2
user_001942,48,50k-75k,desktop,returning,Midwest,41,True,103,1,0,False,False,True,123,2,0,7.9585188932425694,-20,-1
user_001943,57,100k-150k,mobile,returning,East,64,True,68,4,0,True,True,False,0,0,0,,68,4
user_001944,18,<30k,desktop,new,South,47,True,66,3,0,False,False,True,63,3,0,4.7136370654945186,3,0
user_001945,46,30k-50k,mobile,returning,Midwest,41,True,98,1,0,True,True,True,83,1,0,8.650519831571467,15,0
user_001946,51,75k-100k,mobile,returning,West,63,True,96,5,0,True,False,True,118,5,0,7.062855744210959,-22,0
user_001947,34,100k-150k,desktop,returning,East,68,True,142,1,0,False,True,True,99,1,0,9.32134762315284,43,0
user_001948,52,75k-100k,mobile,new,East,28,True,174,3,0,False,False,True,194,4,1,7.290587175145201,-20,-1
user_001949,24,100k-150k,desktop,returning,Midwest,79,True,100,3,1,True,True,True,120,1,0,7.23705313266684,-20,2
user_001950,38,100k-150k,mobile,new,South,43,True,115,4,0,False,True,True,82,6,0,8.355980913989441,33,-2
user_001951,59,<30k,mobile,new,West,41,True,132,1,0,False,True,True,130,1,0,9.396936228453884,2,0
user_001952,50,50k-75k,desktop,new,East,34,True,135,1,0,False,False,True,135,1,0,6.366486711610455,0,0
user_001953,53,50k-75k,desktop,returning,East,52,True,161,3,0,False,True,True,145,4,0,6.270147411424467,16,-1
user_001954,38,30k-50k,mobile,returning,Midwest,27,True,165,3,0,False,True,True,141,1,0,8.099168537577917,24,2
user_001955,43,50k-75k,mobile,new,South,68,True,162,6,1,False,True,True,143,5,0,9.633046629773235,19,1
user_001956,66,75k-100k,desktop,new,East,38,True,111,1,0,True,False,True,117,1,0,7.678403702881094,-6,0
user_001957,32,<30k,tablet,returning,East,51,True,107,3,0,False,True,True,101,2,0,7.656276696658794,6,1
user_001958,43,75k-100k,tablet,returning,South,64,True,77,1,0,False,False,True,76,2,0,5.951300201544485,1,-1
user_001959,40,75k-100k,mobile,returning,West,61,True,114,3,0,False,False,True,113,5,0,4.729219430390906,1,-2
user_001960,80,100k-150k,desktop,new,East,42,True,100,3,0,False,False,False,0,0,0,,100,3
user_001961,52,30k-50k,desktop,new,West,19,True,209,7,0,True,True,True,198,5,0,7.478490622608785,11,2
user_001962,32,<30k,desktop,new,Midwest,50,True,109,4,1,True,True,True,108,1,1,8.081197618597313,1,3
user_001963,60,50k-75k,mobile,returning,East,15,True,167,4,0,True,False,True,190,4,0,6.63807099164706,-23,0
user_001964,48,100k-150k,mobile,new,East,81,False,0,0,0,True,False,True,114,1,0,5.744712522182717,-114,-1
user_001965,45,50k-75k,mobile,returning,East,37,True,105,2,1,False,True,True,96,1,0,9.313525730881516,9,1
user_001966,28,30k-50k,mobile,returning,East,60,True,80,5,0,False,True,True,36,6,0,7.7525070860309615,44,-1
user_001967,49,100k-150k,desktop,returning,West,73,True,64,4,0,True,True,True,63,3,0,8.740681135186538,1,1
user_001968,29,50k-75k,mobile,returning,South,57,True,106,5,0,True,True,True,59,5,0,9.760334128093358,47,0
user_001969,35,50k-75k,desktop,returning,South,41,True,98,3,0,False,False,True,96,4,0,7.603632677902495,2,-1
user_001970,23,>150k,mobile,returning,Midwest,83,True,54,3,0,False,True,True,50,1,0,9.43063258750034,4,2
user_001971,25,75k-100k,desktop,returning,East,53,True,145,2,0,True,True,True,114,2,0,7.465500645956273,31,0
user_001972,32,>150k,desktop,returning,East,81,True,56,3,0,False,True,True,46,3,0,9.073665235402448,10,0
user_001973,39,50k-75k,desktop,returning,West,68,True,119,2,0,False,True,True,111,2,0,10.0,8,0
user_001974,64,<30k,desktop,returning,Midwest,24,True,87,1,0,False,False,True,76,1,0,6.346044627477626,11,0
user_001975,44,75k-100k,desktop,returning,South,62,True,93,3,0,True,False,True,69,2,0,6.175731357321314,24,1
user_001976,40,50k-75k,desktop,new,East,56,True,93,1,0,False,False,True,94,1,0,6.304293601799737,-1,0
user_001977,58,50k-75k,desktop,returning,East,0,True,157,2,0,True,False,True,190,3,0,8.180980174097165,-33,-1
user_001978,18,75k-100k,desktop,returning,South,71,True,30,1,0,True,True,True,31,1,0,8.108751045938076,-1,0
user_001979,37,75k-100k,desktop,returning,West,47,True,86,2,0,False,False,True,84,2,0,7.633613369719913,2,0
user_001980,31,30k-50k,desktop,new,South,48,False,0,0,0,False,True,True,90,2,0,6.627496262909648,-90,-2
user_001981,62,50k-75k,mobile,returning,West,42,True,103,2,0,True,True,True,49,5,0,7.158781763987496,54,-3
user_001982,37,75k-100k,mobile,returning,Midwest,52,True,141,1,0,False,False,True,117,1,0,5.9119270536955275,24,0
user_001983,25,<30k,mobile,returning,Midwest,64,True,85,1,0,False,True,True,70,1,1,8.132632620737478,15,0
user_001984,52,50k-75k,desktop,returning,East,38,True,120,2,0,True,False,True,113,3,0,7.523039756045211,7,-1
user_001985,55,30k-50k,desktop,new,South,41,True,88,1,0,False,True,True,77,1,0,7.525528150663477,11,0
user_001986,45,100k-150k,mobile,returning,West,88,True,90,1,0,True,True,True,60,1,0,6.598635967334983,30,0
user_001987,56,<30k,mobile,returning,South,26,True,137,2,1,True,False,True,153,2,0,6.488603763340408,-16,0
user_001988,42,50k-75k,mobile,returning,West,67,True,60,4,0,True,True,True,81,4,0,9.821684720954279,-21,0
user_001989,39,<30k,desktop,returning,South,29,False,0,0,0,False,False,True,106,2,0,7.374713060347187,-106,-2
user_001990,46,50k-75k,desktop,returning,West,65,True,65,4,0,True,False,True,57,3,0,6.691163049668428,8,1
user_001991,60,100k-150k,desktop,returning,South,48,True,103,1,0,False,True,True,38,1,0,10.0,65,0
user_001992,36,>150k,desktop,returning,West,63,True,145,2,0,True,True,True,87,3,0,9.274740275036304,58,-1
user_001993,46,30k-50k,mobile,returning,West,55,True,92,4,0,True,True,True,56,2,0,7.631363314792228,36,2
user_001994,73,50k-75k,mobile,returning,South,15,True,99,3,0,False,False,True,121,2,0,4.044761426270661,-22,1
user_001995,48,>150k,desktop,returning,Midwest,40,True,105,1,1,False,True,True,125,1,0,8.305808487669243,-20,0
user_001996,46,>150k,desktop,returning,East,57,True,31,1,0,True,True,True,28,1,0,4.724984590893857,3,0
user_001997,35,30k-50k,mobile,returning,East,63,True,92,1,0,False,False,True,109,1,0,7.962676825974121,-17,0
user_001998,61,30k-50k,tablet,returning,Midwest,60,True,123,1,0,True,False,True,127,1,1,7.849741312689814,-4,0
user_001999,47,100k-150k,desktop,returning,South,40,True,157,2,0,False,False,True,167,1,0,7.131837868130471,-10,1
